,reg,vaccin,jour,n_dose1,n_dose2,n_cum_dose1,n_cum_dose2,datetime,timestamp
0,1,1,2020-12-27,0,0,0,0,2020-12-27,1609023600.0
1,1,1,2020-12-28,0,0,0,0,2020-12-28,1609110000.0
2,1,1,2020-12-29,0,0,0,0,2020-12-29,1609196400.0
3,1,1,2020-12-30,0,0,0,0,2020-12-30,1609282800.0
4,1,1,2020-12-31,0,0,0,0,2020-12-31,1609369200.0
5,1,1,2021-01-01,1,0,1,0,2021-01-01,1609455600.0
6,1,1,2021-01-02,0,0,1,0,2021-01-02,1609542000.0
7,1,1,2021-01-03,0,0,1,0,2021-01-03,1609628400.0
8,1,1,2021-01-04,1,0,2,0,2021-01-04,1609714800.0
9,1,1,2021-01-05,0,0,2,0,2021-01-05,1609801200.0
10,1,1,2021-01-06,1,0,3,0,2021-01-06,1609887600.0
11,1,1,2021-01-07,0,0,3,0,2021-01-07,1609974000.0
12,1,1,2021-01-08,49,0,52,0,2021-01-08,1610060400.0
13,1,1,2021-01-09,18,0,70,0,2021-01-09,1610146800.0
14,1,1,2021-01-10,0,0,70,0,2021-01-10,1610233200.0
15,1,1,2021-01-11,55,0,125,0,2021-01-11,1610319600.0
16,1,1,2021-01-12,44,0,169,0,2021-01-12,1610406000.0
17,1,1,2021-01-13,45,0,214,0,2021-01-13,1610492400.0
18,1,1,2021-01-14,60,0,274,0,2021-01-14,1610578800.0
19,1,1,2021-01-15,76,0,350,0,2021-01-15,1610665200.0
20,1,1,2021-01-16,0,0,350,0,2021-01-16,1610751600.0
21,1,1,2021-01-17,0,0,350,0,2021-01-17,1610838000.0
22,1,1,2021-01-18,75,0,425,0,2021-01-18,1610924400.0
23,1,1,2021-01-19,143,0,568,0,2021-01-19,1611010800.0
24,1,1,2021-01-20,134,0,702,0,2021-01-20,1611097200.0
25,1,1,2021-01-21,149,0,851,0,2021-01-21,1611183600.0
26,1,1,2021-01-22,132,0,983,0,2021-01-22,1611270000.0
27,1,1,2021-01-23,1,0,984,0,2021-01-23,1611356400.0
28,1,1,2021-01-24,0,0,984,0,2021-01-24,1611442800.0
29,1,1,2021-01-25,203,0,1187,0,2021-01-25,1611529200.0
30,1,1,2021-01-26,210,0,1397,0,2021-01-26,1611615600.0
31,1,1,2021-01-27,233,0,1630,0,2021-01-27,1611702000.0
32,1,1,2021-01-28,238,2,1868,2,2021-01-28,1611788400.0
33,1,1,2021-01-29,197,0,2065,2,2021-01-29,1611874800.0
34,1,1,2021-01-30,17,0,2082,2,2021-01-30,1611961200.0
35,1,1,2021-01-31,1,0,2083,2,2021-01-31,1612047600.0
36,1,1,2021-02-01,222,3,2305,5,2021-02-01,1612134000.0
37,1,1,2021-02-02,241,24,2546,29,2021-02-02,1612220400.0
38,1,1,2021-02-03,213,1,2759,30,2021-02-03,1612306800.0
39,1,1,2021-02-04,299,19,3058,49,2021-02-04,1612393200.0
40,1,1,2021-02-05,252,32,3310,81,2021-02-05,1612479600.0
41,1,1,2021-02-06,49,1,3359,82,2021-02-06,1612566000.0
42,1,1,2021-02-07,0,0,3359,82,2021-02-07,1612652400.0
43,1,1,2021-02-08,222,20,3581,102,2021-02-08,1612738800.0
44,1,1,2021-02-09,289,27,3870,129,2021-02-09,1612825200.0
45,1,1,2021-02-10,220,28,4090,157,2021-02-10,1612911600.0
46,1,1,2021-02-11,293,108,4383,265,2021-02-11,1612998000.0
47,1,1,2021-02-12,284,23,4667,288,2021-02-12,1613084400.0
48,1,1,2021-02-13,49,7,4716,295,2021-02-13,1613170800.0
49,1,1,2021-02-14,19,36,4735,331,2021-02-14,1613257200.0
50,1,1,2021-02-15,71,43,4806,374,2021-02-15,1613343600.0
51,1,1,2021-02-16,16,0,4822,374,2021-02-16,1613430000.0
52,1,1,2021-02-17,17,0,4839,374,2021-02-17,1613516400.0
53,1,1,2021-02-18,219,16,5058,390,2021-02-18,1613602800.0
54,1,1,2021-02-19,229,19,5287,409,2021-02-19,1613689200.0
55,1,1,2021-02-20,47,0,5334,409,2021-02-20,1613775600.0
56,1,1,2021-02-21,1,0,5335,409,2021-02-21,1613862000.0
57,1,1,2021-02-22,156,54,5491,463,2021-02-22,1613948400.0
58,1,1,2021-02-23,189,70,5680,533,2021-02-23,1614034800.0
59,1,1,2021-02-24,307,119,5987,652,2021-02-24,1614121200.0
60,1,1,2021-02-25,370,75,6357,727,2021-02-25,1614207600.0
61,1,1,2021-02-26,208,81,6565,808,2021-02-26,1614294000.0
62,1,1,2021-02-27,63,0,6628,808,2021-02-27,1614380400.0
63,1,1,2021-02-28,1,0,6629,808,2021-02-28,1614466800.0
64,1,1,2021-03-01,136,80,6765,888,2021-03-01,1614553200.0
65,1,1,2021-03-02,240,127,7005,1015,2021-03-02,1614639600.0
66,1,1,2021-03-03,211,118,7216,1133,2021-03-03,1614726000.0
67,1,1,2021-03-04,303,80,7519,1213,2021-03-04,1614812400.0
68,1,1,2021-03-05,308,141,7827,1354,2021-03-05,1614898800.0
69,1,1,2021-03-06,90,1,7917,1355,2021-03-06,1614985200.0
70,1,1,2021-03-07,1,0,7918,1355,2021-03-07,1615071600.0
71,1,1,2021-03-08,273,130,8191,1485,2021-03-08,1615158000.0
72,1,1,2021-03-09,348,149,8539,1634,2021-03-09,1615244400.0
73,1,1,2021-03-10,318,153,8857,1787,2021-03-10,1615330800.0
74,1,1,2021-03-11,84,43,8941,1830,2021-03-11,1615417200.0
75,1,1,2021-03-12,369,204,9310,2034,2021-03-12,1615503600.0
76,1,1,2021-03-13,119,1,9429,2035,2021-03-13,1615590000.0
77,1,1,2021-03-14,0,23,9429,2058,2021-03-14,1615676400.0
78,1,1,2021-03-15,406,37,9835,2095,2021-03-15,1615762800.0
79,1,1,2021-03-16,448,73,10283,2168,2021-03-16,1615849200.0
80,1,1,2021-03-17,420,78,10703,2246,2021-03-17,1615935600.0
81,1,1,2021-03-18,539,99,11242,2345,2021-03-18,1616022000.0
82,1,1,2021-03-19,523,92,11765,2437,2021-03-19,1616108400.0
83,1,1,2021-03-20,173,43,11938,2480,2021-03-20,1616194800.0
84,1,1,2021-03-21,0,0,11938,2480,2021-03-21,1616281200.0
85,1,1,2021-03-22,325,79,12263,2559,2021-03-22,1616367600.0
86,1,1,2021-03-23,442,150,12705,2709,2021-03-23,1616454000.0
87,1,1,2021-03-24,416,103,13121,2812,2021-03-24,1616540400.0
88,1,1,2021-03-25,534,170,13655,2982,2021-03-25,1616626800.0
89,1,1,2021-03-26,516,116,14171,3098,2021-03-26,1616713200.0
90,1,1,2021-03-27,197,42,14368,3140,2021-03-27,1616799600.0
91,1,1,2021-03-28,0,0,14368,3140,2021-03-28,1616886000.0
92,1,1,2021-03-29,325,78,14693,3218,2021-03-29,1616972400.0
93,1,1,2021-03-30,429,154,15122,3372,2021-03-30,1617058800.0
94,1,1,2021-03-31,453,118,15575,3490,2021-03-31,1617145200.0
95,1,1,2021-04-01,466,191,16041,3681,2021-04-01,1617231600.0
96,1,1,2021-04-02,23,35,16064,3716,2021-04-02,1617318000.0
97,1,1,2021-04-03,42,1,16106,3717,2021-04-03,1617404400.0
98,1,1,2021-04-04,0,18,16106,3735,2021-04-04,1617490800.0
99,1,1,2021-04-05,1,0,16107,3735,2021-04-05,1617577200.0
100,1,1,2021-04-06,367,179,16474,3914,2021-04-06,1617663600.0
101,1,1,2021-04-07,469,111,16943,4025,2021-04-07,1617750000.0
102,1,1,2021-04-08,411,152,17354,4177,2021-04-08,1617836400.0
103,1,1,2021-04-09,437,197,17791,4374,2021-04-09,1617922800.0
104,1,1,2021-04-10,73,4,17864,4378,2021-04-10,1618009200.0
105,1,1,2021-04-11,1,25,17865,4403,2021-04-11,1618095600.0
106,1,1,2021-04-12,254,250,18119,4653,2021-04-12,1618185600.0
107,1,1,2021-04-13,512,309,18631,4962,2021-04-13,1618272000.0
108,1,1,2021-04-14,397,217,19028,5179,2021-04-14,1618358400.0
109,1,1,2021-04-15,427,307,19455,5486,2021-04-15,1618444800.0
110,1,1,2021-04-16,495,260,19950,5746,2021-04-16,1618531200.0
111,1,1,2021-04-17,163,2,20113,5748,2021-04-17,1618617600.0
112,1,1,2021-04-18,3,14,20116,5762,2021-04-18,1618704000.0
113,1,1,2021-04-19,377,234,20493,5996,2021-04-19,1618790400.0
114,1,1,2021-04-20,664,322,21157,6318,2021-04-20,1618876800.0
115,1,1,2021-04-21,577,305,21734,6623,2021-04-21,1618963200.0
116,1,1,2021-04-22,714,320,22448,6943,2021-04-22,1619049600.0
117,1,1,2021-04-23,790,232,23238,7175,2021-04-23,1619136000.0
118,1,1,2021-04-24,353,68,23591,7243,2021-04-24,1619222400.0
119,1,1,2021-04-25,591,60,24182,7303,2021-04-25,1619308800.0
120,1,1,2021-04-26,915,195,25097,7498,2021-04-26,1619395200.0
121,1,1,2021-04-27,618,211,25715,7709,2021-04-27,1619481600.0
122,1,1,2021-04-28,789,248,26504,7957,2021-04-28,1619568000.0
123,1,1,2021-04-29,1148,152,27652,8109,2021-04-29,1619654400.0
124,1,1,2021-04-30,1184,149,28836,8258,2021-04-30,1619740800.0
125,1,1,2021-05-01,593,37,29429,8295,2021-05-01,1619827200.0
126,1,1,2021-05-02,343,13,29772,8308,2021-05-02,1619913600.0
127,1,1,2021-05-03,908,155,30680,8463,2021-05-03,1620000000.0
128,1,1,2021-05-04,876,182,31556,8645,2021-05-04,1620086400.0
129,1,1,2021-05-05,981,223,32537,8868,2021-05-05,1620172800.0
130,1,1,2021-05-06,1063,129,33600,8997,2021-05-06,1620259200.0
131,1,1,2021-05-07,1191,229,34791,9226,2021-05-07,1620345600.0
132,1,1,2021-05-08,315,21,35106,9247,2021-05-08,1620432000.0
133,1,1,2021-05-09,178,3,35284,9250,2021-05-09,1620518400.0
134,1,1,2021-05-10,819,182,36103,9432,2021-05-10,1620604800.0
135,1,1,2021-05-11,885,278,36988,9710,2021-05-11,1620691200.0
136,1,1,2021-05-12,835,283,37823,9993,2021-05-12,1620777600.0
137,1,1,2021-05-13,199,75,38022,10068,2021-05-13,1620864000.0
138,1,1,2021-05-14,829,243,38851,10311,2021-05-14,1620950400.0
139,1,1,2021-05-15,445,7,39296,10318,2021-05-15,1621036800.0
140,1,1,2021-05-16,180,30,39476,10348,2021-05-16,1621123200.0
141,1,1,2021-05-17,699,242,40175,10590,2021-05-17,1621206000.0
142,1,1,2021-05-18,690,354,40865,10944,2021-05-18,1621292400.0
143,1,1,2021-05-19,660,497,41525,11441,2021-05-19,1621378800.0
144,1,1,2021-05-20,751,335,42276,11776,2021-05-20,1621465200.0
145,1,1,2021-05-21,787,384,43063,12160,2021-05-21,1621551600.0
146,1,1,2021-05-22,459,206,43522,12366,2021-05-22,1621638000.0
147,1,1,2021-05-23,201,109,43723,12475,2021-05-23,1621724400.0
148,1,1,2021-05-24,185,165,43908,12640,2021-05-24,1621810800.0
149,1,1,2021-05-25,511,632,44419,13272,2021-05-25,1621897200.0
150,1,1,2021-05-26,555,481,44974,13753,2021-05-26,1621983600.0
151,1,1,2021-05-27,128,181,45102,13934,2021-05-27,1622070000.0
152,1,1,2021-05-28,478,452,45580,14386,2021-05-28,1622156400.0
153,1,1,2021-05-29,183,122,45763,14508,2021-05-29,1622242800.0
154,1,1,2021-05-30,71,111,45834,14619,2021-05-30,1622329200.0
155,1,1,2021-05-31,400,516,46234,15135,2021-05-31,1622415600.0
156,1,1,2021-06-01,505,650,46739,15785,2021-06-01,1622502000.0
157,1,1,2021-06-02,514,649,47253,16434,2021-06-02,1622588400.0
158,1,1,2021-06-03,418,429,47671,16863,2021-06-03,1622674800.0
159,1,1,2021-06-04,598,720,48269,17583,2021-06-04,1622761200.0
160,1,1,2021-06-05,290,550,48559,18133,2021-06-05,1622847600.0
161,1,1,2021-06-06,121,521,48680,18654,2021-06-06,1622934000.0
162,1,1,2021-06-07,383,736,49063,19390,2021-06-07,1623020400.0
163,1,1,2021-06-08,468,798,49531,20188,2021-06-08,1623106800.0
164,1,1,2021-06-09,343,805,49874,20993,2021-06-09,1623193200.0
165,1,1,2021-06-10,348,726,50222,21719,2021-06-10,1623279600.0
166,1,1,2021-06-11,423,1136,50645,22855,2021-06-11,1623366000.0
167,1,1,2021-06-12,240,622,50885,23477,2021-06-12,1623452400.0
168,1,1,2021-06-13,128,306,51013,23783,2021-06-13,1623538800.0
169,1,1,2021-06-14,334,3758,51347,27541,2021-06-14,1623625200.0
170,1,1,2021-06-15,419,1933,51766,29474,2021-06-15,1623711600.0
171,1,1,2021-06-16,436,1439,52202,30913,2021-06-16,1623798000.0
172,1,1,2021-06-17,345,886,52547,31799,2021-06-17,1623884400.0
173,1,1,2021-06-18,383,900,52930,32699,2021-06-18,1623970800.0
174,1,1,2021-06-19,223,451,53153,33150,2021-06-19,1624057200.0
175,1,1,2021-06-20,108,223,53261,33373,2021-06-20,1624143600.0
176,1,1,2021-06-21,308,642,53569,34015,2021-06-21,1624230000.0
177,1,1,2021-06-22,280,768,53849,34783,2021-06-22,1624316400.0
178,1,1,2021-06-23,296,811,54145,35594,2021-06-23,1624402800.0
179,1,1,2021-06-24,327,620,54472,36214,2021-06-24,1624489200.0
180,1,1,2021-06-25,341,705,54813,36919,2021-06-25,1624575600.0
181,1,1,2021-06-26,261,450,55074,37369,2021-06-26,1624662000.0
182,1,1,2021-06-27,105,158,55179,37527,2021-06-27,1624748400.0
183,1,1,2021-06-28,258,649,55437,38176,2021-06-28,1624834800.0
184,1,1,2021-06-29,327,652,55764,38828,2021-06-29,1624921200.0
185,1,1,2021-06-30,376,807,56140,39635,2021-06-30,1625007600.0
186,1,1,2021-07-01,287,541,56427,40176,2021-07-01,1625094000.0
187,1,1,2021-07-02,380,610,56807,40786,2021-07-02,1625180400.0
188,1,1,2021-07-03,236,417,57043,41203,2021-07-03,1625266800.0
189,1,1,2021-07-04,110,228,57153,41431,2021-07-04,1625353200.0
190,1,1,2021-07-05,299,469,57452,41900,2021-07-05,1625439600.0
191,1,1,2021-07-06,329,667,57781,42567,2021-07-06,1625526000.0
192,1,2,2020-12-27,0,0,0,0,2020-12-27,1609023600.0
193,1,2,2020-12-28,0,0,0,0,2020-12-28,1609110000.0
194,1,2,2020-12-29,0,0,0,0,2020-12-29,1609196400.0
195,1,2,2020-12-30,0,0,0,0,2020-12-30,1609282800.0
196,1,2,2020-12-31,0,0,0,0,2020-12-31,1609369200.0
197,1,2,2021-01-01,0,0,0,0,2021-01-01,1609455600.0
198,1,2,2021-01-02,0,0,0,0,2021-01-02,1609542000.0
199,1,2,2021-01-03,0,0,0,0,2021-01-03,1609628400.0
200,1,2,2021-01-04,0,0,0,0,2021-01-04,1609714800.0
201,1,2,2021-01-05,0,0,0,0,2021-01-05,1609801200.0
202,1,2,2021-01-06,0,0,0,0,2021-01-06,1609887600.0
203,1,2,2021-01-07,0,0,0,0,2021-01-07,1609974000.0
204,1,2,2021-01-08,0,0,0,0,2021-01-08,1610060400.0
205,1,2,2021-01-09,0,0,0,0,2021-01-09,1610146800.0
206,1,2,2021-01-10,0,0,0,0,2021-01-10,1610233200.0
207,1,2,2021-01-11,0,0,0,0,2021-01-11,1610319600.0
208,1,2,2021-01-12,0,0,0,0,2021-01-12,1610406000.0
209,1,2,2021-01-13,0,0,0,0,2021-01-13,1610492400.0
210,1,2,2021-01-14,0,0,0,0,2021-01-14,1610578800.0
211,1,2,2021-01-15,0,0,0,0,2021-01-15,1610665200.0
212,1,2,2021-01-16,0,0,0,0,2021-01-16,1610751600.0
213,1,2,2021-01-17,0,0,0,0,2021-01-17,1610838000.0
214,1,2,2021-01-18,0,0,0,0,2021-01-18,1610924400.0
215,1,2,2021-01-19,0,0,0,0,2021-01-19,1611010800.0
216,1,2,2021-01-20,0,0,0,0,2021-01-20,1611097200.0
217,1,2,2021-01-21,0,0,0,0,2021-01-21,1611183600.0
218,1,2,2021-01-22,0,0,0,0,2021-01-22,1611270000.0
219,1,2,2021-01-23,0,0,0,0,2021-01-23,1611356400.0
220,1,2,2021-01-24,0,0,0,0,2021-01-24,1611442800.0
221,1,2,2021-01-25,0,0,0,0,2021-01-25,1611529200.0
222,1,2,2021-01-26,0,0,0,0,2021-01-26,1611615600.0
223,1,2,2021-01-27,0,0,0,0,2021-01-27,1611702000.0
224,1,2,2021-01-28,0,0,0,0,2021-01-28,1611788400.0
225,1,2,2021-01-29,0,0,0,0,2021-01-29,1611874800.0
226,1,2,2021-01-30,0,0,0,0,2021-01-30,1611961200.0
227,1,2,2021-01-31,0,0,0,0,2021-01-31,1612047600.0
228,1,2,2021-02-01,0,0,0,0,2021-02-01,1612134000.0
229,1,2,2021-02-02,0,0,0,0,2021-02-02,1612220400.0
230,1,2,2021-02-03,0,0,0,0,2021-02-03,1612306800.0
231,1,2,2021-02-04,0,0,0,0,2021-02-04,1612393200.0
232,1,2,2021-02-05,0,0,0,0,2021-02-05,1612479600.0
233,1,2,2021-02-06,0,0,0,0,2021-02-06,1612566000.0
234,1,2,2021-02-07,0,0,0,0,2021-02-07,1612652400.0
235,1,2,2021-02-08,0,0,0,0,2021-02-08,1612738800.0
236,1,2,2021-02-09,0,0,0,0,2021-02-09,1612825200.0
237,1,2,2021-02-10,1,0,1,0,2021-02-10,1612911600.0
238,1,2,2021-02-11,0,0,1,0,2021-02-11,1612998000.0
239,1,2,2021-02-12,0,0,1,0,2021-02-12,1613084400.0
240,1,2,2021-02-13,0,0,1,0,2021-02-13,1613170800.0
241,1,2,2021-02-14,0,0,1,0,2021-02-14,1613257200.0
242,1,2,2021-02-15,0,0,1,0,2021-02-15,1613343600.0
243,1,2,2021-02-16,0,0,1,0,2021-02-16,1613430000.0
244,1,2,2021-02-17,0,0,1,0,2021-02-17,1613516400.0
245,1,2,2021-02-18,0,0,1,0,2021-02-18,1613602800.0
246,1,2,2021-02-19,0,0,1,0,2021-02-19,1613689200.0
247,1,2,2021-02-20,0,0,1,0,2021-02-20,1613775600.0
248,1,2,2021-02-21,0,0,1,0,2021-02-21,1613862000.0
249,1,2,2021-02-22,0,0,1,0,2021-02-22,1613948400.0
250,1,2,2021-02-23,0,0,1,0,2021-02-23,1614034800.0
251,1,2,2021-02-24,0,0,1,0,2021-02-24,1614121200.0
252,1,2,2021-02-25,0,0,1,0,2021-02-25,1614207600.0
253,1,2,2021-02-26,0,0,1,0,2021-02-26,1614294000.0
254,1,2,2021-02-27,0,0,1,0,2021-02-27,1614380400.0
255,1,2,2021-02-28,0,0,1,0,2021-02-28,1614466800.0
256,1,2,2021-03-01,0,0,1,0,2021-03-01,1614553200.0
257,1,2,2021-03-02,0,0,1,0,2021-03-02,1614639600.0
258,1,2,2021-03-03,0,0,1,0,2021-03-03,1614726000.0
259,1,2,2021-03-04,0,0,1,0,2021-03-04,1614812400.0
260,1,2,2021-03-05,0,0,1,0,2021-03-05,1614898800.0
261,1,2,2021-03-06,0,0,1,0,2021-03-06,1614985200.0
262,1,2,2021-03-07,0,0,1,0,2021-03-07,1615071600.0
263,1,2,2021-03-08,0,0,1,0,2021-03-08,1615158000.0
264,1,2,2021-03-09,0,0,1,0,2021-03-09,1615244400.0
265,1,2,2021-03-10,0,0,1,0,2021-03-10,1615330800.0
266,1,2,2021-03-11,0,0,1,0,2021-03-11,1615417200.0
267,1,2,2021-03-12,0,1,1,1,2021-03-12,1615503600.0
268,1,2,2021-03-13,0,0,1,1,2021-03-13,1615590000.0
269,1,2,2021-03-14,0,0,1,1,2021-03-14,1615676400.0
270,1,2,2021-03-15,0,0,1,1,2021-03-15,1615762800.0
271,1,2,2021-03-16,0,0,1,1,2021-03-16,1615849200.0
272,1,2,2021-03-17,0,0,1,1,2021-03-17,1615935600.0
273,1,2,2021-03-18,0,0,1,1,2021-03-18,1616022000.0
274,1,2,2021-03-19,0,0,1,1,2021-03-19,1616108400.0
275,1,2,2021-03-20,0,0,1,1,2021-03-20,1616194800.0
276,1,2,2021-03-21,0,0,1,1,2021-03-21,1616281200.0
277,1,2,2021-03-22,0,0,1,1,2021-03-22,1616367600.0
278,1,2,2021-03-23,0,0,1,1,2021-03-23,1616454000.0
279,1,2,2021-03-24,0,0,1,1,2021-03-24,1616540400.0
280,1,2,2021-03-25,0,0,1,1,2021-03-25,1616626800.0
281,1,2,2021-03-26,2,0,3,1,2021-03-26,1616713200.0
282,1,2,2021-03-27,0,0,3,1,2021-03-27,1616799600.0
283,1,2,2021-03-28,0,0,3,1,2021-03-28,1616886000.0
284,1,2,2021-03-29,0,0,3,1,2021-03-29,1616972400.0
285,1,2,2021-03-30,0,0,3,1,2021-03-30,1617058800.0
286,1,2,2021-03-31,0,0,3,1,2021-03-31,1617145200.0
287,1,2,2021-04-01,0,0,3,1,2021-04-01,1617231600.0
288,1,2,2021-04-02,0,0,3,1,2021-04-02,1617318000.0
289,1,2,2021-04-03,0,1,3,2,2021-04-03,1617404400.0
290,1,2,2021-04-04,0,0,3,2,2021-04-04,1617490800.0
291,1,2,2021-04-05,0,0,3,2,2021-04-05,1617577200.0
292,1,2,2021-04-06,0,0,3,2,2021-04-06,1617663600.0
293,1,2,2021-04-07,0,0,3,2,2021-04-07,1617750000.0
294,1,2,2021-04-08,0,0,3,2,2021-04-08,1617836400.0
295,1,2,2021-04-09,0,0,3,2,2021-04-09,1617922800.0
296,1,2,2021-04-10,0,0,3,2,2021-04-10,1618009200.0
297,1,2,2021-04-11,0,0,3,2,2021-04-11,1618095600.0
298,1,2,2021-04-12,0,0,3,2,2021-04-12,1618185600.0
299,1,2,2021-04-13,0,0,3,2,2021-04-13,1618272000.0
300,1,2,2021-04-14,1,0,4,2,2021-04-14,1618358400.0
301,1,2,2021-04-15,0,0,4,2,2021-04-15,1618444800.0
302,1,2,2021-04-16,0,0,4,2,2021-04-16,1618531200.0
303,1,2,2021-04-17,0,0,4,2,2021-04-17,1618617600.0
304,1,2,2021-04-18,1,0,5,2,2021-04-18,1618704000.0
305,1,2,2021-04-19,0,0,5,2,2021-04-19,1618790400.0
306,1,2,2021-04-20,0,0,5,2,2021-04-20,1618876800.0
307,1,2,2021-04-21,0,0,5,2,2021-04-21,1618963200.0
308,1,2,2021-04-22,0,0,5,2,2021-04-22,1619049600.0
309,1,2,2021-04-23,2,0,7,2,2021-04-23,1619136000.0
310,1,2,2021-04-24,0,0,7,2,2021-04-24,1619222400.0
311,1,2,2021-04-25,0,0,7,2,2021-04-25,1619308800.0
312,1,2,2021-04-26,0,0,7,2,2021-04-26,1619395200.0
313,1,2,2021-04-27,0,0,7,2,2021-04-27,1619481600.0
314,1,2,2021-04-28,0,0,7,2,2021-04-28,1619568000.0
315,1,2,2021-04-29,0,0,7,2,2021-04-29,1619654400.0
316,1,2,2021-04-30,0,0,7,2,2021-04-30,1619740800.0
317,1,2,2021-05-01,0,0,7,2,2021-05-01,1619827200.0
318,1,2,2021-05-02,0,0,7,2,2021-05-02,1619913600.0
319,1,2,2021-05-03,0,0,7,2,2021-05-03,1620000000.0
320,1,2,2021-05-04,0,0,7,2,2021-05-04,1620086400.0
321,1,2,2021-05-05,0,0,7,2,2021-05-05,1620172800.0
322,1,2,2021-05-06,0,0,7,2,2021-05-06,1620259200.0
323,1,2,2021-05-07,1,0,8,2,2021-05-07,1620345600.0
324,1,2,2021-05-08,0,0,8,2,2021-05-08,1620432000.0
325,1,2,2021-05-09,0,0,8,2,2021-05-09,1620518400.0
326,1,2,2021-05-10,0,0,8,2,2021-05-10,1620604800.0
327,1,2,2021-05-11,0,0,8,2,2021-05-11,1620691200.0
328,1,2,2021-05-12,0,0,8,2,2021-05-12,1620777600.0
329,1,2,2021-05-13,12,0,20,2,2021-05-13,1620864000.0
330,1,2,2021-05-14,0,0,20,2,2021-05-14,1620950400.0
331,1,2,2021-05-15,12,0,32,2,2021-05-15,1621036800.0
332,1,2,2021-05-16,0,0,32,2,2021-05-16,1621123200.0
333,1,2,2021-05-17,0,0,32,2,2021-05-17,1621206000.0
334,1,2,2021-05-18,0,0,32,2,2021-05-18,1621292400.0
335,1,2,2021-05-19,11,0,43,2,2021-05-19,1621378800.0
336,1,2,2021-05-20,0,0,43,2,2021-05-20,1621465200.0
337,1,2,2021-05-21,0,0,43,2,2021-05-21,1621551600.0
338,1,2,2021-05-22,13,0,56,2,2021-05-22,1621638000.0
339,1,2,2021-05-23,0,0,56,2,2021-05-23,1621724400.0
340,1,2,2021-05-24,11,0,67,2,2021-05-24,1621810800.0
341,1,2,2021-05-25,0,0,67,2,2021-05-25,1621897200.0
342,1,2,2021-05-26,12,0,79,2,2021-05-26,1621983600.0
343,1,2,2021-05-27,0,0,79,2,2021-05-27,1622070000.0
344,1,2,2021-05-28,2,0,81,2,2021-05-28,1622156400.0
345,1,2,2021-05-29,30,0,111,2,2021-05-29,1622242800.0
346,1,2,2021-05-30,0,0,111,2,2021-05-30,1622329200.0
347,1,2,2021-05-31,8,0,119,2,2021-05-31,1622415600.0
348,1,2,2021-06-01,22,3,141,5,2021-06-01,1622502000.0
349,1,2,2021-06-02,32,8,173,13,2021-06-02,1622588400.0
350,1,2,2021-06-03,59,6,232,19,2021-06-03,1622674800.0
351,1,2,2021-06-04,93,3,325,22,2021-06-04,1622761200.0
352,1,2,2021-06-05,25,1,350,23,2021-06-05,1622847600.0
353,1,2,2021-06-06,1,0,351,23,2021-06-06,1622934000.0
354,1,2,2021-06-07,21,1,372,24,2021-06-07,1623020400.0
355,1,2,2021-06-08,16,0,388,24,2021-06-08,1623106800.0
356,1,2,2021-06-09,53,1,441,25,2021-06-09,1623193200.0
357,1,2,2021-06-10,113,10,554,35,2021-06-10,1623279600.0
358,1,2,2021-06-11,24,9,578,44,2021-06-11,1623366000.0
359,1,2,2021-06-12,50,15,628,59,2021-06-12,1623452400.0
360,1,2,2021-06-13,0,0,628,59,2021-06-13,1623538800.0
361,1,2,2021-06-14,16,4,644,63,2021-06-14,1623625200.0
362,1,2,2021-06-15,21,1,665,64,2021-06-15,1623711600.0
363,1,2,2021-06-16,2,10,667,74,2021-06-16,1623798000.0
364,1,2,2021-06-17,65,9,732,83,2021-06-17,1623884400.0
365,1,2,2021-06-18,64,4,796,87,2021-06-18,1623970800.0
366,1,2,2021-06-19,57,19,853,106,2021-06-19,1624057200.0
367,1,2,2021-06-20,0,1,853,107,2021-06-20,1624143600.0
368,1,2,2021-06-21,7,10,860,117,2021-06-21,1624230000.0
369,1,2,2021-06-22,30,1,890,118,2021-06-22,1624316400.0
370,1,2,2021-06-23,43,12,933,130,2021-06-23,1624402800.0
371,1,2,2021-06-24,50,20,983,150,2021-06-24,1624489200.0
372,1,2,2021-06-25,90,18,1073,168,2021-06-25,1624575600.0
373,1,2,2021-06-26,28,16,1101,184,2021-06-26,1624662000.0
374,1,2,2021-06-27,1,10,1102,194,2021-06-27,1624748400.0
375,1,2,2021-06-28,26,19,1128,213,2021-06-28,1624834800.0
376,1,2,2021-06-29,28,12,1156,225,2021-06-29,1624921200.0
377,1,2,2021-06-30,22,49,1178,274,2021-06-30,1625007600.0
378,1,2,2021-07-01,42,36,1220,310,2021-07-01,1625094000.0
379,1,2,2021-07-02,33,12,1253,322,2021-07-02,1625180400.0
380,1,2,2021-07-03,30,19,1283,341,2021-07-03,1625266800.0
381,1,2,2021-07-04,0,0,1283,341,2021-07-04,1625353200.0
382,1,2,2021-07-05,9,9,1292,350,2021-07-05,1625439600.0
383,1,2,2021-07-06,5,26,1297,376,2021-07-06,1625526000.0
384,1,3,2020-12-27,0,0,0,0,2020-12-27,1609023600.0
385,1,3,2020-12-28,0,0,0,0,2020-12-28,1609110000.0
386,1,3,2020-12-29,0,0,0,0,2020-12-29,1609196400.0
387,1,3,2020-12-30,0,0,0,0,2020-12-30,1609282800.0
388,1,3,2020-12-31,0,0,0,0,2020-12-31,1609369200.0
389,1,3,2021-01-01,0,0,0,0,2021-01-01,1609455600.0
390,1,3,2021-01-02,0,0,0,0,2021-01-02,1609542000.0
391,1,3,2021-01-03,0,0,0,0,2021-01-03,1609628400.0
392,1,3,2021-01-04,0,0,0,0,2021-01-04,1609714800.0
393,1,3,2021-01-05,0,0,0,0,2021-01-05,1609801200.0
394,1,3,2021-01-06,0,0,0,0,2021-01-06,1609887600.0
395,1,3,2021-01-07,0,0,0,0,2021-01-07,1609974000.0
396,1,3,2021-01-08,0,0,0,0,2021-01-08,1610060400.0
397,1,3,2021-01-09,0,0,0,0,2021-01-09,1610146800.0
398,1,3,2021-01-10,0,0,0,0,2021-01-10,1610233200.0
399,1,3,2021-01-11,0,0,0,0,2021-01-11,1610319600.0
400,1,3,2021-01-12,0,0,0,0,2021-01-12,1610406000.0
401,1,3,2021-01-13,0,0,0,0,2021-01-13,1610492400.0
402,1,3,2021-01-14,0,0,0,0,2021-01-14,1610578800.0
403,1,3,2021-01-15,0,0,0,0,2021-01-15,1610665200.0
404,1,3,2021-01-16,0,0,0,0,2021-01-16,1610751600.0
405,1,3,2021-01-17,0,0,0,0,2021-01-17,1610838000.0
406,1,3,2021-01-18,0,0,0,0,2021-01-18,1610924400.0
407,1,3,2021-01-19,0,0,0,0,2021-01-19,1611010800.0
408,1,3,2021-01-20,0,0,0,0,2021-01-20,1611097200.0
409,1,3,2021-01-21,0,0,0,0,2021-01-21,1611183600.0
410,1,3,2021-01-22,0,0,0,0,2021-01-22,1611270000.0
411,1,3,2021-01-23,0,0,0,0,2021-01-23,1611356400.0
412,1,3,2021-01-24,0,0,0,0,2021-01-24,1611442800.0
413,1,3,2021-01-25,0,0,0,0,2021-01-25,1611529200.0
414,1,3,2021-01-26,0,0,0,0,2021-01-26,1611615600.0
415,1,3,2021-01-27,0,0,0,0,2021-01-27,1611702000.0
416,1,3,2021-01-28,0,0,0,0,2021-01-28,1611788400.0
417,1,3,2021-01-29,0,0,0,0,2021-01-29,1611874800.0
418,1,3,2021-01-30,0,0,0,0,2021-01-30,1611961200.0
419,1,3,2021-01-31,0,0,0,0,2021-01-31,1612047600.0
420,1,3,2021-02-01,0,0,0,0,2021-02-01,1612134000.0
421,1,3,2021-02-02,0,0,0,0,2021-02-02,1612220400.0
422,1,3,2021-02-03,0,0,0,0,2021-02-03,1612306800.0
423,1,3,2021-02-04,0,0,0,0,2021-02-04,1612393200.0
424,1,3,2021-02-05,0,0,0,0,2021-02-05,1612479600.0
425,1,3,2021-02-06,0,0,0,0,2021-02-06,1612566000.0
426,1,3,2021-02-07,0,0,0,0,2021-02-07,1612652400.0
427,1,3,2021-02-08,0,0,0,0,2021-02-08,1612738800.0
428,1,3,2021-02-09,0,0,0,0,2021-02-09,1612825200.0
429,1,3,2021-02-10,0,0,0,0,2021-02-10,1612911600.0
430,1,3,2021-02-11,0,0,0,0,2021-02-11,1612998000.0
431,1,3,2021-02-12,0,0,0,0,2021-02-12,1613084400.0
432,1,3,2021-02-13,1,0,1,0,2021-02-13,1613170800.0
433,1,3,2021-02-14,0,0,1,0,2021-02-14,1613257200.0
434,1,3,2021-02-15,0,0,1,0,2021-02-15,1613343600.0
435,1,3,2021-02-16,0,0,1,0,2021-02-16,1613430000.0
436,1,3,2021-02-17,0,0,1,0,2021-02-17,1613516400.0
437,1,3,2021-02-18,0,0,1,0,2021-02-18,1613602800.0
438,1,3,2021-02-19,0,0,1,0,2021-02-19,1613689200.0
439,1,3,2021-02-20,0,0,1,0,2021-02-20,1613775600.0
440,1,3,2021-02-21,0,0,1,0,2021-02-21,1613862000.0
441,1,3,2021-02-22,1,0,2,0,2021-02-22,1613948400.0
442,1,3,2021-02-23,0,0,2,0,2021-02-23,1614034800.0
443,1,3,2021-02-24,0,0,2,0,2021-02-24,1614121200.0
444,1,3,2021-02-25,0,0,2,0,2021-02-25,1614207600.0
445,1,3,2021-02-26,0,0,2,0,2021-02-26,1614294000.0
446,1,3,2021-02-27,0,0,2,0,2021-02-27,1614380400.0
447,1,3,2021-02-28,0,0,2,0,2021-02-28,1614466800.0
448,1,3,2021-03-01,4,0,6,0,2021-03-01,1614553200.0
449,1,3,2021-03-02,0,0,6,0,2021-03-02,1614639600.0
450,1,3,2021-03-03,0,0,6,0,2021-03-03,1614726000.0
451,1,3,2021-03-04,0,0,6,0,2021-03-04,1614812400.0
452,1,3,2021-03-05,22,0,28,0,2021-03-05,1614898800.0
453,1,3,2021-03-06,496,0,524,0,2021-03-06,1614985200.0
454,1,3,2021-03-07,0,0,524,0,2021-03-07,1615071600.0
455,1,3,2021-03-08,5,0,529,0,2021-03-08,1615158000.0
456,1,3,2021-03-09,10,0,539,0,2021-03-09,1615244400.0
457,1,3,2021-03-10,50,0,589,0,2021-03-10,1615330800.0
458,1,3,2021-03-11,36,0,625,0,2021-03-11,1615417200.0
459,1,3,2021-03-12,37,0,662,0,2021-03-12,1615503600.0
460,1,3,2021-03-13,13,0,675,0,2021-03-13,1615590000.0
461,1,3,2021-03-14,13,0,688,0,2021-03-14,1615676400.0
462,1,3,2021-03-15,1,0,689,0,2021-03-15,1615762800.0
463,1,3,2021-03-16,1,0,690,0,2021-03-16,1615849200.0
464,1,3,2021-03-17,0,0,690,0,2021-03-17,1615935600.0
465,1,3,2021-03-18,1,0,691,0,2021-03-18,1616022000.0
466,1,3,2021-03-19,0,0,691,0,2021-03-19,1616108400.0
467,1,3,2021-03-20,1,0,692,0,2021-03-20,1616194800.0
468,1,3,2021-03-21,8,0,700,0,2021-03-21,1616281200.0
469,1,3,2021-03-22,10,0,710,0,2021-03-22,1616367600.0
470,1,3,2021-03-23,41,0,751,0,2021-03-23,1616454000.0
471,1,3,2021-03-24,40,0,791,0,2021-03-24,1616540400.0
472,1,3,2021-03-25,196,0,987,0,2021-03-25,1616626800.0
473,1,3,2021-03-26,117,0,1104,0,2021-03-26,1616713200.0
474,1,3,2021-03-27,71,0,1175,0,2021-03-27,1616799600.0
475,1,3,2021-03-28,7,0,1182,0,2021-03-28,1616886000.0
476,1,3,2021-03-29,34,0,1216,0,2021-03-29,1616972400.0
477,1,3,2021-03-30,187,0,1403,0,2021-03-30,1617058800.0
478,1,3,2021-03-31,73,0,1476,0,2021-03-31,1617145200.0
479,1,3,2021-04-01,156,0,1632,0,2021-04-01,1617231600.0
480,1,3,2021-04-02,15,0,1647,0,2021-04-02,1617318000.0
481,1,3,2021-04-03,1,0,1648,0,2021-04-03,1617404400.0
482,1,3,2021-04-04,4,0,1652,0,2021-04-04,1617490800.0
483,1,3,2021-04-05,10,0,1662,0,2021-04-05,1617577200.0
484,1,3,2021-04-06,69,0,1731,0,2021-04-06,1617663600.0
485,1,3,2021-04-07,99,0,1830,0,2021-04-07,1617750000.0
486,1,3,2021-04-08,72,0,1902,0,2021-04-08,1617836400.0
487,1,3,2021-04-09,44,0,1946,0,2021-04-09,1617922800.0
488,1,3,2021-04-10,23,0,1969,0,2021-04-10,1618009200.0
489,1,3,2021-04-11,1,0,1970,0,2021-04-11,1618095600.0
490,1,3,2021-04-12,28,0,1998,0,2021-04-12,1618185600.0
491,1,3,2021-04-13,39,0,2037,0,2021-04-13,1618272000.0
492,1,3,2021-04-14,28,0,2065,0,2021-04-14,1618358400.0
493,1,3,2021-04-15,123,0,2188,0,2021-04-15,1618444800.0
494,1,3,2021-04-16,53,0,2241,0,2021-04-16,1618531200.0
495,1,3,2021-04-17,28,0,2269,0,2021-04-17,1618617600.0
496,1,3,2021-04-18,0,0,2269,0,2021-04-18,1618704000.0
497,1,3,2021-04-19,12,0,2281,0,2021-04-19,1618790400.0
498,1,3,2021-04-20,58,3,2339,3,2021-04-20,1618876800.0
499,1,3,2021-04-21,40,0,2379,3,2021-04-21,1618963200.0
500,1,3,2021-04-22,88,0,2467,3,2021-04-22,1619049600.0
501,1,3,2021-04-23,49,0,2516,3,2021-04-23,1619136000.0
502,1,3,2021-04-24,20,0,2536,3,2021-04-24,1619222400.0
503,1,3,2021-04-25,0,0,2536,3,2021-04-25,1619308800.0
504,1,3,2021-04-26,26,0,2562,3,2021-04-26,1619395200.0
505,1,3,2021-04-27,26,0,2588,3,2021-04-27,1619481600.0
506,1,3,2021-04-28,45,0,2633,3,2021-04-28,1619568000.0
507,1,3,2021-04-29,43,17,2676,20,2021-04-29,1619654400.0
508,1,3,2021-04-30,73,3,2749,23,2021-04-30,1619740800.0
509,1,3,2021-05-01,1,0,2750,23,2021-05-01,1619827200.0
510,1,3,2021-05-02,0,0,2750,23,2021-05-02,1619913600.0
511,1,3,2021-05-03,9,3,2759,26,2021-05-03,1620000000.0
512,1,3,2021-05-04,77,1,2836,27,2021-05-04,1620086400.0
513,1,3,2021-05-05,19,1,2855,28,2021-05-05,1620172800.0
514,1,3,2021-05-06,50,14,2905,42,2021-05-06,1620259200.0
515,1,3,2021-05-07,40,5,2945,47,2021-05-07,1620345600.0
516,1,3,2021-05-08,1,0,2946,47,2021-05-08,1620432000.0
517,1,3,2021-05-09,0,0,2946,47,2021-05-09,1620518400.0
518,1,3,2021-05-10,13,6,2959,53,2021-05-10,1620604800.0
519,1,3,2021-05-11,56,3,3015,56,2021-05-11,1620691200.0
520,1,3,2021-05-12,59,12,3074,68,2021-05-12,1620777600.0
521,1,3,2021-05-13,0,0,3074,68,2021-05-13,1620864000.0
522,1,3,2021-05-14,30,14,3104,82,2021-05-14,1620950400.0
523,1,3,2021-05-15,17,2,3121,84,2021-05-15,1621036800.0
524,1,3,2021-05-16,2,0,3123,84,2021-05-16,1621123200.0
525,1,3,2021-05-17,9,1,3132,85,2021-05-17,1621206000.0
526,1,3,2021-05-18,31,5,3163,90,2021-05-18,1621292400.0
527,1,3,2021-05-19,23,7,3186,97,2021-05-19,1621378800.0
528,1,3,2021-05-20,25,11,3211,108,2021-05-20,1621465200.0
529,1,3,2021-05-21,22,6,3233,114,2021-05-21,1621551600.0
530,1,3,2021-05-22,18,5,3251,119,2021-05-22,1621638000.0
531,1,3,2021-05-23,0,0,3251,119,2021-05-23,1621724400.0
532,1,3,2021-05-24,2,9,3253,128,2021-05-24,1621810800.0
533,1,3,2021-05-25,20,22,3273,150,2021-05-25,1621897200.0
534,1,3,2021-05-26,9,2,3282,152,2021-05-26,1621983600.0
535,1,3,2021-05-27,0,0,3282,152,2021-05-27,1622070000.0
536,1,3,2021-05-28,34,53,3316,205,2021-05-28,1622156400.0
537,1,3,2021-05-29,13,12,3329,217,2021-05-29,1622242800.0
538,1,3,2021-05-30,0,0,3329,217,2021-05-30,1622329200.0
539,1,3,2021-05-31,10,12,3339,229,2021-05-31,1622415600.0
540,1,3,2021-06-01,6,46,3345,275,2021-06-01,1622502000.0
541,1,3,2021-06-02,10,25,3355,300,2021-06-02,1622588400.0
542,1,3,2021-06-03,9,112,3364,412,2021-06-03,1622674800.0
543,1,3,2021-06-04,7,55,3371,467,2021-06-04,1622761200.0
544,1,3,2021-06-05,4,81,3375,548,2021-06-05,1622847600.0
545,1,3,2021-06-06,0,1,3375,549,2021-06-06,1622934000.0
546,1,3,2021-06-07,7,25,3382,574,2021-06-07,1623020400.0
547,1,3,2021-06-08,3,70,3385,644,2021-06-08,1623106800.0
548,1,3,2021-06-09,9,41,3394,685,2021-06-09,1623193200.0
549,1,3,2021-06-10,12,92,3406,777,2021-06-10,1623279600.0
550,1,3,2021-06-11,3,65,3409,842,2021-06-11,1623366000.0
551,1,3,2021-06-12,0,15,3409,857,2021-06-12,1623452400.0
552,1,3,2021-06-13,0,5,3409,862,2021-06-13,1623538800.0
553,1,3,2021-06-14,0,27,3409,889,2021-06-14,1623625200.0
554,1,3,2021-06-15,5,53,3414,942,2021-06-15,1623711600.0
555,1,3,2021-06-16,9,14,3423,956,2021-06-16,1623798000.0
556,1,3,2021-06-17,7,97,3430,1053,2021-06-17,1623884400.0
557,1,3,2021-06-18,4,97,3434,1150,2021-06-18,1623970800.0
558,1,3,2021-06-19,14,25,3448,1175,2021-06-19,1624057200.0
559,1,3,2021-06-20,0,0,3448,1175,2021-06-20,1624143600.0
560,1,3,2021-06-21,2,10,3450,1185,2021-06-21,1624230000.0
561,1,3,2021-06-22,2,84,3452,1269,2021-06-22,1624316400.0
562,1,3,2021-06-23,9,44,3461,1313,2021-06-23,1624402800.0
563,1,3,2021-06-24,1,64,3462,1377,2021-06-24,1624489200.0
564,1,3,2021-06-25,3,19,3465,1396,2021-06-25,1624575600.0
565,1,3,2021-06-26,2,38,3467,1434,2021-06-26,1624662000.0
566,1,3,2021-06-27,0,0,3467,1434,2021-06-27,1624748400.0
567,1,3,2021-06-28,1,4,3468,1438,2021-06-28,1624834800.0
568,1,3,2021-06-29,2,78,3470,1516,2021-06-29,1624921200.0
569,1,3,2021-06-30,4,29,3474,1545,2021-06-30,1625007600.0
570,1,3,2021-07-01,0,49,3474,1594,2021-07-01,1625094000.0
571,1,3,2021-07-02,0,32,3474,1626,2021-07-02,1625180400.0
572,1,3,2021-07-03,0,7,3474,1633,2021-07-03,1625266800.0
573,1,3,2021-07-04,0,0,3474,1633,2021-07-04,1625353200.0
574,1,3,2021-07-05,6,9,3480,1642,2021-07-05,1625439600.0
575,1,3,2021-07-06,18,50,3498,1692,2021-07-06,1625526000.0
576,1,4,2020-12-27,0,0,0,0,2020-12-27,1609023600.0
577,1,4,2020-12-28,0,0,0,0,2020-12-28,1609110000.0
578,1,4,2020-12-29,0,0,0,0,2020-12-29,1609196400.0
579,1,4,2020-12-30,0,0,0,0,2020-12-30,1609282800.0
580,1,4,2020-12-31,0,0,0,0,2020-12-31,1609369200.0
581,1,4,2021-01-01,0,0,0,0,2021-01-01,1609455600.0
582,1,4,2021-01-02,0,0,0,0,2021-01-02,1609542000.0
583,1,4,2021-01-03,0,0,0,0,2021-01-03,1609628400.0
584,1,4,2021-01-04,0,0,0,0,2021-01-04,1609714800.0
585,1,4,2021-01-05,0,0,0,0,2021-01-05,1609801200.0
586,1,4,2021-01-06,0,0,0,0,2021-01-06,1609887600.0
587,1,4,2021-01-07,0,0,0,0,2021-01-07,1609974000.0
588,1,4,2021-01-08,0,0,0,0,2021-01-08,1610060400.0
589,1,4,2021-01-09,0,0,0,0,2021-01-09,1610146800.0
590,1,4,2021-01-10,0,0,0,0,2021-01-10,1610233200.0
591,1,4,2021-01-11,0,0,0,0,2021-01-11,1610319600.0
592,1,4,2021-01-12,0,0,0,0,2021-01-12,1610406000.0
593,1,4,2021-01-13,0,0,0,0,2021-01-13,1610492400.0
594,1,4,2021-01-14,0,0,0,0,2021-01-14,1610578800.0
595,1,4,2021-01-15,0,0,0,0,2021-01-15,1610665200.0
596,1,4,2021-01-16,0,0,0,0,2021-01-16,1610751600.0
597,1,4,2021-01-17,0,0,0,0,2021-01-17,1610838000.0
598,1,4,2021-01-18,0,0,0,0,2021-01-18,1610924400.0
599,1,4,2021-01-19,0,0,0,0,2021-01-19,1611010800.0
600,1,4,2021-01-20,0,0,0,0,2021-01-20,1611097200.0
601,1,4,2021-01-21,0,0,0,0,2021-01-21,1611183600.0
602,1,4,2021-01-22,0,0,0,0,2021-01-22,1611270000.0
603,1,4,2021-01-23,0,0,0,0,2021-01-23,1611356400.0
604,1,4,2021-01-24,0,0,0,0,2021-01-24,1611442800.0
605,1,4,2021-01-25,0,0,0,0,2021-01-25,1611529200.0
606,1,4,2021-01-26,0,0,0,0,2021-01-26,1611615600.0
607,1,4,2021-01-27,0,0,0,0,2021-01-27,1611702000.0
608,1,4,2021-01-28,0,0,0,0,2021-01-28,1611788400.0
609,1,4,2021-01-29,0,0,0,0,2021-01-29,1611874800.0
610,1,4,2021-01-30,0,0,0,0,2021-01-30,1611961200.0
611,1,4,2021-01-31,0,0,0,0,2021-01-31,1612047600.0
612,1,4,2021-02-01,0,0,0,0,2021-02-01,1612134000.0
613,1,4,2021-02-02,0,0,0,0,2021-02-02,1612220400.0
614,1,4,2021-02-03,0,0,0,0,2021-02-03,1612306800.0
615,1,4,2021-02-04,0,0,0,0,2021-02-04,1612393200.0
616,1,4,2021-02-05,0,0,0,0,2021-02-05,1612479600.0
617,1,4,2021-02-06,0,0,0,0,2021-02-06,1612566000.0
618,1,4,2021-02-07,0,0,0,0,2021-02-07,1612652400.0
619,1,4,2021-02-08,0,0,0,0,2021-02-08,1612738800.0
620,1,4,2021-02-09,0,0,0,0,2021-02-09,1612825200.0
621,1,4,2021-02-10,0,0,0,0,2021-02-10,1612911600.0
622,1,4,2021-02-11,0,0,0,0,2021-02-11,1612998000.0
623,1,4,2021-02-12,0,0,0,0,2021-02-12,1613084400.0
624,1,4,2021-02-13,0,0,0,0,2021-02-13,1613170800.0
625,1,4,2021-02-14,0,0,0,0,2021-02-14,1613257200.0
626,1,4,2021-02-15,0,0,0,0,2021-02-15,1613343600.0
627,1,4,2021-02-16,0,0,0,0,2021-02-16,1613430000.0
628,1,4,2021-02-17,0,0,0,0,2021-02-17,1613516400.0
629,1,4,2021-02-18,0,0,0,0,2021-02-18,1613602800.0
630,1,4,2021-02-19,0,0,0,0,2021-02-19,1613689200.0
631,1,4,2021-02-20,0,0,0,0,2021-02-20,1613775600.0
632,1,4,2021-02-21,0,0,0,0,2021-02-21,1613862000.0
633,1,4,2021-02-22,0,0,0,0,2021-02-22,1613948400.0
634,1,4,2021-02-23,0,0,0,0,2021-02-23,1614034800.0
635,1,4,2021-02-24,0,0,0,0,2021-02-24,1614121200.0
636,1,4,2021-02-25,0,0,0,0,2021-02-25,1614207600.0
637,1,4,2021-02-26,0,0,0,0,2021-02-26,1614294000.0
638,1,4,2021-02-27,0,0,0,0,2021-02-27,1614380400.0
639,1,4,2021-02-28,0,0,0,0,2021-02-28,1614466800.0
640,1,4,2021-03-01,0,0,0,0,2021-03-01,1614553200.0
641,1,4,2021-03-02,0,0,0,0,2021-03-02,1614639600.0
642,1,4,2021-03-03,0,0,0,0,2021-03-03,1614726000.0
643,1,4,2021-03-04,0,0,0,0,2021-03-04,1614812400.0
644,1,4,2021-03-05,0,0,0,0,2021-03-05,1614898800.0
645,1,4,2021-03-06,0,0,0,0,2021-03-06,1614985200.0
646,1,4,2021-03-07,0,0,0,0,2021-03-07,1615071600.0
647,1,4,2021-03-08,0,0,0,0,2021-03-08,1615158000.0
648,1,4,2021-03-09,0,0,0,0,2021-03-09,1615244400.0
649,1,4,2021-03-10,0,0,0,0,2021-03-10,1615330800.0
650,1,4,2021-03-11,0,0,0,0,2021-03-11,1615417200.0
651,1,4,2021-03-12,0,0,0,0,2021-03-12,1615503600.0
652,1,4,2021-03-13,0,0,0,0,2021-03-13,1615590000.0
653,1,4,2021-03-14,0,0,0,0,2021-03-14,1615676400.0
654,1,4,2021-03-15,0,0,0,0,2021-03-15,1615762800.0
655,1,4,2021-03-16,0,0,0,0,2021-03-16,1615849200.0
656,1,4,2021-03-17,0,0,0,0,2021-03-17,1615935600.0
657,1,4,2021-03-18,0,0,0,0,2021-03-18,1616022000.0
658,1,4,2021-03-19,0,0,0,0,2021-03-19,1616108400.0
659,1,4,2021-03-20,0,0,0,0,2021-03-20,1616194800.0
660,1,4,2021-03-21,0,0,0,0,2021-03-21,1616281200.0
661,1,4,2021-03-22,0,0,0,0,2021-03-22,1616367600.0
662,1,4,2021-03-23,0,0,0,0,2021-03-23,1616454000.0
663,1,4,2021-03-24,0,0,0,0,2021-03-24,1616540400.0
664,1,4,2021-03-25,0,0,0,0,2021-03-25,1616626800.0
665,1,4,2021-03-26,0,0,0,0,2021-03-26,1616713200.0
666,1,4,2021-03-27,0,0,0,0,2021-03-27,1616799600.0
667,1,4,2021-03-28,0,0,0,0,2021-03-28,1616886000.0
668,1,4,2021-03-29,0,0,0,0,2021-03-29,1616972400.0
669,1,4,2021-03-30,0,0,0,0,2021-03-30,1617058800.0
670,1,4,2021-03-31,0,0,0,0,2021-03-31,1617145200.0
671,1,4,2021-04-01,0,0,0,0,2021-04-01,1617231600.0
672,1,4,2021-04-02,0,0,0,0,2021-04-02,1617318000.0
673,1,4,2021-04-03,0,0,0,0,2021-04-03,1617404400.0
674,1,4,2021-04-04,0,0,0,0,2021-04-04,1617490800.0
675,1,4,2021-04-05,0,0,0,0,2021-04-05,1617577200.0
676,1,4,2021-04-06,0,0,0,0,2021-04-06,1617663600.0
677,1,4,2021-04-07,0,0,0,0,2021-04-07,1617750000.0
678,1,4,2021-04-08,0,0,0,0,2021-04-08,1617836400.0
679,1,4,2021-04-09,0,0,0,0,2021-04-09,1617922800.0
680,1,4,2021-04-10,0,0,0,0,2021-04-10,1618009200.0
681,1,4,2021-04-11,0,0,0,0,2021-04-11,1618095600.0
682,1,4,2021-04-12,0,0,0,0,2021-04-12,1618185600.0
683,1,4,2021-04-13,0,0,0,0,2021-04-13,1618272000.0
684,1,4,2021-04-14,0,0,0,0,2021-04-14,1618358400.0
685,1,4,2021-04-15,0,0,0,0,2021-04-15,1618444800.0
686,1,4,2021-04-16,0,0,0,0,2021-04-16,1618531200.0
687,1,4,2021-04-17,0,0,0,0,2021-04-17,1618617600.0
688,1,4,2021-04-18,0,0,0,0,2021-04-18,1618704000.0
689,1,4,2021-04-19,0,0,0,0,2021-04-19,1618790400.0
690,1,4,2021-04-20,0,0,0,0,2021-04-20,1618876800.0
691,1,4,2021-04-21,0,0,0,0,2021-04-21,1618963200.0
692,1,4,2021-04-22,0,0,0,0,2021-04-22,1619049600.0
693,1,4,2021-04-23,0,0,0,0,2021-04-23,1619136000.0
694,1,4,2021-04-24,0,0,0,0,2021-04-24,1619222400.0
695,1,4,2021-04-25,0,0,0,0,2021-04-25,1619308800.0
696,1,4,2021-04-26,0,0,0,0,2021-04-26,1619395200.0
697,1,4,2021-04-27,0,0,0,0,2021-04-27,1619481600.0
698,1,4,2021-04-28,0,0,0,0,2021-04-28,1619568000.0
699,1,4,2021-04-29,0,0,0,0,2021-04-29,1619654400.0
700,1,4,2021-04-30,0,0,0,0,2021-04-30,1619740800.0
701,1,4,2021-05-01,0,0,0,0,2021-05-01,1619827200.0
702,1,4,2021-05-02,0,0,0,0,2021-05-02,1619913600.0
703,1,4,2021-05-03,0,0,0,0,2021-05-03,1620000000.0
704,1,4,2021-05-04,0,0,0,0,2021-05-04,1620086400.0
705,1,4,2021-05-05,0,0,0,0,2021-05-05,1620172800.0
706,1,4,2021-05-06,0,0,0,0,2021-05-06,1620259200.0
707,1,4,2021-05-07,0,0,0,0,2021-05-07,1620345600.0
708,1,4,2021-05-08,0,0,0,0,2021-05-08,1620432000.0
709,1,4,2021-05-09,0,0,0,0,2021-05-09,1620518400.0
710,1,4,2021-05-10,0,0,0,0,2021-05-10,1620604800.0
711,1,4,2021-05-11,0,0,0,0,2021-05-11,1620691200.0
712,1,4,2021-05-12,0,0,0,0,2021-05-12,1620777600.0
713,1,4,2021-05-13,0,0,0,0,2021-05-13,1620864000.0
714,1,4,2021-05-14,0,0,0,0,2021-05-14,1620950400.0
715,1,4,2021-05-15,0,0,0,0,2021-05-15,1621036800.0
716,1,4,2021-05-16,0,0,0,0,2021-05-16,1621123200.0
717,1,4,2021-05-17,0,0,0,0,2021-05-17,1621206000.0
718,1,4,2021-05-18,0,0,0,0,2021-05-18,1621292400.0
719,1,4,2021-05-19,0,0,0,0,2021-05-19,1621378800.0
720,1,4,2021-05-20,0,0,0,0,2021-05-20,1621465200.0
721,1,4,2021-05-21,0,0,0,0,2021-05-21,1621551600.0
722,1,4,2021-05-22,0,0,0,0,2021-05-22,1621638000.0
723,1,4,2021-05-23,0,0,0,0,2021-05-23,1621724400.0
724,1,4,2021-05-24,0,0,0,0,2021-05-24,1621810800.0
725,1,4,2021-05-25,0,0,0,0,2021-05-25,1621897200.0
726,1,4,2021-05-26,0,0,0,0,2021-05-26,1621983600.0
727,1,4,2021-05-27,0,0,0,0,2021-05-27,1622070000.0
728,1,4,2021-05-28,0,0,0,0,2021-05-28,1622156400.0
729,1,4,2021-05-29,0,0,0,0,2021-05-29,1622242800.0
730,1,4,2021-05-30,0,0,0,0,2021-05-30,1622329200.0
731,1,4,2021-05-31,0,0,0,0,2021-05-31,1622415600.0
732,1,4,2021-06-01,0,0,0,0,2021-06-01,1622502000.0
733,1,4,2021-06-02,0,0,0,0,2021-06-02,1622588400.0
734,1,4,2021-06-03,0,0,0,0,2021-06-03,1622674800.0
735,1,4,2021-06-04,0,0,0,0,2021-06-04,1622761200.0
736,1,4,2021-06-05,0,0,0,0,2021-06-05,1622847600.0
737,1,4,2021-06-06,0,0,0,0,2021-06-06,1622934000.0
738,1,4,2021-06-07,0,0,0,0,2021-06-07,1623020400.0
739,1,4,2021-06-08,0,0,0,0,2021-06-08,1623106800.0
740,1,4,2021-06-09,0,0,0,0,2021-06-09,1623193200.0
741,1,4,2021-06-10,0,0,0,0,2021-06-10,1623279600.0
742,1,4,2021-06-11,0,0,0,0,2021-06-11,1623366000.0
743,1,4,2021-06-12,0,0,0,0,2021-06-12,1623452400.0
744,1,4,2021-06-13,0,0,0,0,2021-06-13,1623538800.0
745,1,4,2021-06-14,0,0,0,0,2021-06-14,1623625200.0
746,1,4,2021-06-15,0,0,0,0,2021-06-15,1623711600.0
747,1,4,2021-06-16,0,0,0,0,2021-06-16,1623798000.0
748,1,4,2021-06-17,0,0,0,0,2021-06-17,1623884400.0
749,1,4,2021-06-18,0,0,0,0,2021-06-18,1623970800.0
750,1,4,2021-06-19,0,0,0,0,2021-06-19,1624057200.0
751,1,4,2021-06-20,0,0,0,0,2021-06-20,1624143600.0
752,1,4,2021-06-21,0,0,0,0,2021-06-21,1624230000.0
753,1,4,2021-06-22,0,0,0,0,2021-06-22,1624316400.0
754,1,4,2021-06-23,0,0,0,0,2021-06-23,1624402800.0
755,1,4,2021-06-24,0,0,0,0,2021-06-24,1624489200.0
756,1,4,2021-06-25,0,0,0,0,2021-06-25,1624575600.0
757,1,4,2021-06-26,0,0,0,0,2021-06-26,1624662000.0
758,1,4,2021-06-27,0,0,0,0,2021-06-27,1624748400.0
759,1,4,2021-06-28,0,0,0,0,2021-06-28,1624834800.0
760,1,4,2021-06-29,0,0,0,0,2021-06-29,1624921200.0
761,1,4,2021-06-30,0,0,0,0,2021-06-30,1625007600.0
762,1,4,2021-07-01,0,0,0,0,2021-07-01,1625094000.0
763,1,4,2021-07-02,0,0,0,0,2021-07-02,1625180400.0
764,1,4,2021-07-03,0,0,0,0,2021-07-03,1625266800.0
765,1,4,2021-07-04,0,0,0,0,2021-07-04,1625353200.0
766,1,4,2021-07-05,0,0,0,0,2021-07-05,1625439600.0
767,1,4,2021-07-06,0,0,0,0,2021-07-06,1625526000.0
768,2,1,2020-12-27,0,0,0,0,2020-12-27,1609023600.0
769,2,1,2020-12-28,0,0,0,0,2020-12-28,1609110000.0
770,2,1,2020-12-29,0,0,0,0,2020-12-29,1609196400.0
771,2,1,2020-12-30,0,0,0,0,2020-12-30,1609282800.0
772,2,1,2020-12-31,0,0,0,0,2020-12-31,1609369200.0
773,2,1,2021-01-01,0,0,0,0,2021-01-01,1609455600.0
774,2,1,2021-01-02,0,0,0,0,2021-01-02,1609542000.0
775,2,1,2021-01-03,0,0,0,0,2021-01-03,1609628400.0
776,2,1,2021-01-04,0,0,0,0,2021-01-04,1609714800.0
777,2,1,2021-01-05,0,0,0,0,2021-01-05,1609801200.0
778,2,1,2021-01-06,5,0,5,0,2021-01-06,1609887600.0
779,2,1,2021-01-07,31,0,36,0,2021-01-07,1609974000.0
780,2,1,2021-01-08,80,0,116,0,2021-01-08,1610060400.0
781,2,1,2021-01-09,20,0,136,0,2021-01-09,1610146800.0
782,2,1,2021-01-10,0,0,136,0,2021-01-10,1610233200.0
783,2,1,2021-01-11,122,0,258,0,2021-01-11,1610319600.0
784,2,1,2021-01-12,78,0,336,0,2021-01-12,1610406000.0
785,2,1,2021-01-13,64,0,400,0,2021-01-13,1610492400.0
786,2,1,2021-01-14,88,0,488,0,2021-01-14,1610578800.0
787,2,1,2021-01-15,136,0,624,0,2021-01-15,1610665200.0
788,2,1,2021-01-16,51,0,675,0,2021-01-16,1610751600.0
789,2,1,2021-01-17,0,0,675,0,2021-01-17,1610838000.0
790,2,1,2021-01-18,157,0,832,0,2021-01-18,1610924400.0
791,2,1,2021-01-19,168,0,1000,0,2021-01-19,1611010800.0
792,2,1,2021-01-20,164,0,1164,0,2021-01-20,1611097200.0
793,2,1,2021-01-21,181,0,1345,0,2021-01-21,1611183600.0
794,2,1,2021-01-22,156,0,1501,0,2021-01-22,1611270000.0
795,2,1,2021-01-23,58,0,1559,0,2021-01-23,1611356400.0
796,2,1,2021-01-24,0,0,1559,0,2021-01-24,1611442800.0
797,2,1,2021-01-25,160,0,1719,0,2021-01-25,1611529200.0
798,2,1,2021-01-26,137,0,1856,0,2021-01-26,1611615600.0
799,2,1,2021-01-27,162,5,2018,5,2021-01-27,1611702000.0
800,2,1,2021-01-28,143,12,2161,17,2021-01-28,1611788400.0
801,2,1,2021-01-29,143,41,2304,58,2021-01-29,1611874800.0
802,2,1,2021-01-30,96,16,2400,74,2021-01-30,1611961200.0
803,2,1,2021-01-31,0,0,2400,74,2021-01-31,1612047600.0
804,2,1,2021-02-01,119,73,2519,147,2021-02-01,1612134000.0
805,2,1,2021-02-02,184,95,2703,242,2021-02-02,1612220400.0
806,2,1,2021-02-03,131,80,2834,322,2021-02-03,1612306800.0
807,2,1,2021-02-04,158,73,2992,395,2021-02-04,1612393200.0
808,2,1,2021-02-05,120,97,3112,492,2021-02-05,1612479600.0
809,2,1,2021-02-06,62,26,3174,518,2021-02-06,1612566000.0
810,2,1,2021-02-07,1,0,3175,518,2021-02-07,1612652400.0
811,2,1,2021-02-08,137,78,3312,596,2021-02-08,1612738800.0
812,2,1,2021-02-09,176,78,3488,674,2021-02-09,1612825200.0
813,2,1,2021-02-10,138,90,3626,764,2021-02-10,1612911600.0
814,2,1,2021-02-11,150,103,3776,867,2021-02-11,1612998000.0
815,2,1,2021-02-12,124,128,3900,995,2021-02-12,1613084400.0
816,2,1,2021-02-13,38,37,3938,1032,2021-02-13,1613170800.0
817,2,1,2021-02-14,0,0,3938,1032,2021-02-14,1613257200.0
818,2,1,2021-02-15,51,67,3989,1099,2021-02-15,1613343600.0
819,2,1,2021-02-16,0,1,3989,1100,2021-02-16,1613430000.0
820,2,1,2021-02-17,0,3,3989,1103,2021-02-17,1613516400.0
821,2,1,2021-02-18,68,127,4057,1230,2021-02-18,1613602800.0
822,2,1,2021-02-19,69,131,4126,1361,2021-02-19,1613689200.0
823,2,1,2021-02-20,48,69,4174,1430,2021-02-20,1613775600.0
824,2,1,2021-02-21,0,0,4174,1430,2021-02-21,1613862000.0
825,2,1,2021-02-22,102,60,4276,1490,2021-02-22,1613948400.0
826,2,1,2021-02-23,113,238,4389,1728,2021-02-23,1614034800.0
827,2,1,2021-02-24,106,223,4495,1951,2021-02-24,1614121200.0
828,2,1,2021-02-25,89,148,4584,2099,2021-02-25,1614207600.0
829,2,1,2021-02-26,126,168,4710,2267,2021-02-26,1614294000.0
830,2,1,2021-02-27,69,52,4779,2319,2021-02-27,1614380400.0
831,2,1,2021-02-28,0,0,4779,2319,2021-02-28,1614466800.0
832,2,1,2021-03-01,138,143,4917,2462,2021-03-01,1614553200.0
833,2,1,2021-03-02,142,78,5059,2540,2021-03-02,1614639600.0
834,2,1,2021-03-03,167,142,5226,2682,2021-03-03,1614726000.0
835,2,1,2021-03-04,112,133,5338,2815,2021-03-04,1614812400.0
836,2,1,2021-03-05,230,127,5568,2942,2021-03-05,1614898800.0
837,2,1,2021-03-06,71,58,5639,3000,2021-03-06,1614985200.0
838,2,1,2021-03-07,48,0,5687,3000,2021-03-07,1615071600.0
839,2,1,2021-03-08,169,129,5856,3129,2021-03-08,1615158000.0
840,2,1,2021-03-09,213,102,6069,3231,2021-03-09,1615244400.0
841,2,1,2021-03-10,221,133,6290,3364,2021-03-10,1615330800.0
842,2,1,2021-03-11,217,77,6507,3441,2021-03-11,1615417200.0
843,2,1,2021-03-12,335,49,6842,3490,2021-03-12,1615503600.0
844,2,1,2021-03-13,103,21,6945,3511,2021-03-13,1615590000.0
845,2,1,2021-03-14,0,1,6945,3512,2021-03-14,1615676400.0
846,2,1,2021-03-15,270,92,7215,3604,2021-03-15,1615762800.0
847,2,1,2021-03-16,305,52,7520,3656,2021-03-16,1615849200.0
848,2,1,2021-03-17,387,41,7907,3697,2021-03-17,1615935600.0
849,2,1,2021-03-18,425,39,8332,3736,2021-03-18,1616022000.0
850,2,1,2021-03-19,396,56,8728,3792,2021-03-19,1616108400.0
851,2,1,2021-03-20,149,47,8877,3839,2021-03-20,1616194800.0
852,2,1,2021-03-21,25,1,8902,3840,2021-03-21,1616281200.0
853,2,1,2021-03-22,338,113,9240,3953,2021-03-22,1616367600.0
854,2,1,2021-03-23,369,116,9609,4069,2021-03-23,1616454000.0
855,2,1,2021-03-24,361,97,9970,4166,2021-03-24,1616540400.0
856,2,1,2021-03-25,391,87,10361,4253,2021-03-25,1616626800.0
857,2,1,2021-03-26,580,86,10941,4339,2021-03-26,1616713200.0
858,2,1,2021-03-27,99,68,11040,4407,2021-03-27,1616799600.0
859,2,1,2021-03-28,81,2,11121,4409,2021-03-28,1616886000.0
860,2,1,2021-03-29,362,157,11483,4566,2021-03-29,1616972400.0
861,2,1,2021-03-30,409,234,11892,4800,2021-03-30,1617058800.0
862,2,1,2021-03-31,987,174,12879,4974,2021-03-31,1617145200.0
863,2,1,2021-04-01,846,163,13725,5137,2021-04-01,1617231600.0
864,2,1,2021-04-02,894,3,14619,5140,2021-04-02,1617318000.0
865,2,1,2021-04-03,750,37,15369,5177,2021-04-03,1617404400.0
866,2,1,2021-04-04,750,2,16119,5179,2021-04-04,1617490800.0
867,2,1,2021-04-05,828,9,16947,5188,2021-04-05,1617577200.0
868,2,1,2021-04-06,873,108,17820,5296,2021-04-06,1617663600.0
869,2,1,2021-04-07,1361,288,19181,5584,2021-04-07,1617750000.0
870,2,1,2021-04-08,1280,237,20461,5821,2021-04-08,1617836400.0
871,2,1,2021-04-09,1186,300,21647,6121,2021-04-09,1617922800.0
872,2,1,2021-04-10,810,141,22457,6262,2021-04-10,1618009200.0
873,2,1,2021-04-11,621,4,23078,6266,2021-04-11,1618095600.0
874,2,1,2021-04-12,840,282,23918,6548,2021-04-12,1618185600.0
875,2,1,2021-04-13,843,310,24761,6858,2021-04-13,1618272000.0
876,2,1,2021-04-14,931,314,25692,7172,2021-04-14,1618358400.0
877,2,1,2021-04-15,889,278,26581,7450,2021-04-15,1618444800.0
878,2,1,2021-04-16,980,281,27561,7731,2021-04-16,1618531200.0
879,2,1,2021-04-17,512,149,28073,7880,2021-04-17,1618617600.0
880,2,1,2021-04-18,339,49,28412,7929,2021-04-18,1618704000.0
881,2,1,2021-04-19,668,327,29080,8256,2021-04-19,1618790400.0
882,2,1,2021-04-20,857,294,29937,8550,2021-04-20,1618876800.0
883,2,1,2021-04-21,972,339,30909,8889,2021-04-21,1618963200.0
884,2,1,2021-04-22,568,290,31477,9179,2021-04-22,1619049600.0
885,2,1,2021-04-23,591,447,32068,9626,2021-04-23,1619136000.0
886,2,1,2021-04-24,351,184,32419,9810,2021-04-24,1619222400.0
887,2,1,2021-04-25,168,198,32587,10008,2021-04-25,1619308800.0
888,2,1,2021-04-26,500,530,33087,10538,2021-04-26,1619395200.0
889,2,1,2021-04-27,539,602,33626,11140,2021-04-27,1619481600.0
890,2,1,2021-04-28,439,681,34065,11821,2021-04-28,1619568000.0
891,2,1,2021-04-29,628,622,34693,12443,2021-04-29,1619654400.0
892,2,1,2021-04-30,761,665,35454,13108,2021-04-30,1619740800.0
893,2,1,2021-05-01,235,244,35689,13352,2021-05-01,1619827200.0
894,2,1,2021-05-02,223,504,35912,13856,2021-05-02,1619913600.0
895,2,1,2021-05-03,552,759,36464,14615,2021-05-03,1620000000.0
896,2,1,2021-05-04,513,659,36977,15274,2021-05-04,1620086400.0
897,2,1,2021-05-05,519,887,37496,16161,2021-05-05,1620172800.0
898,2,1,2021-05-06,529,754,38025,16915,2021-05-06,1620259200.0
899,2,1,2021-05-07,616,998,38641,17913,2021-05-07,1620345600.0
900,2,1,2021-05-08,224,516,38865,18429,2021-05-08,1620432000.0
901,2,1,2021-05-09,172,505,39037,18934,2021-05-09,1620518400.0
902,2,1,2021-05-10,503,822,39540,19756,2021-05-10,1620604800.0
903,2,1,2021-05-11,460,863,40000,20619,2021-05-11,1620691200.0
904,2,1,2021-05-12,536,869,40536,21488,2021-05-12,1620777600.0
905,2,1,2021-05-13,272,506,40808,21994,2021-05-13,1620864000.0
906,2,1,2021-05-14,371,720,41179,22714,2021-05-14,1620950400.0
907,2,1,2021-05-15,233,572,41412,23286,2021-05-15,1621036800.0
908,2,1,2021-05-16,155,437,41567,23723,2021-05-16,1621123200.0
909,2,1,2021-05-17,470,741,42037,24464,2021-05-17,1621206000.0
910,2,1,2021-05-18,444,665,42481,25129,2021-05-18,1621292400.0
911,2,1,2021-05-19,437,708,42918,25837,2021-05-19,1621378800.0
912,2,1,2021-05-20,572,469,43490,26306,2021-05-20,1621465200.0
913,2,1,2021-05-21,539,679,44029,26985,2021-05-21,1621551600.0
914,2,1,2021-05-22,185,359,44214,27344,2021-05-22,1621638000.0
915,2,1,2021-05-23,109,179,44323,27523,2021-05-23,1621724400.0
916,2,1,2021-05-24,135,234,44458,27757,2021-05-24,1621810800.0
917,2,1,2021-05-25,346,677,44804,28434,2021-05-25,1621897200.0
918,2,1,2021-05-26,359,671,45163,29105,2021-05-26,1621983600.0
919,2,1,2021-05-27,262,619,45425,29724,2021-05-27,1622070000.0
920,2,1,2021-05-28,266,766,45691,30490,2021-05-28,1622156400.0
921,2,1,2021-05-29,142,480,45833,30970,2021-05-29,1622242800.0
922,2,1,2021-05-30,16,26,45849,30996,2021-05-30,1622329200.0
923,2,1,2021-05-31,314,609,46163,31605,2021-05-31,1622415600.0
924,2,1,2021-06-01,279,504,46442,32109,2021-06-01,1622502000.0
925,2,1,2021-06-02,298,504,46740,32613,2021-06-02,1622588400.0
926,2,1,2021-06-03,243,378,46983,32991,2021-06-03,1622674800.0
927,2,1,2021-06-04,333,609,47316,33600,2021-06-04,1622761200.0
928,2,1,2021-06-05,219,291,47535,33891,2021-06-05,1622847600.0
929,2,1,2021-06-06,22,31,47557,33922,2021-06-06,1622934000.0
930,2,1,2021-06-07,248,694,47805,34616,2021-06-07,1623020400.0
931,2,1,2021-06-08,243,540,48048,35156,2021-06-08,1623106800.0
932,2,1,2021-06-09,269,632,48317,35788,2021-06-09,1623193200.0
933,2,1,2021-06-10,292,377,48609,36165,2021-06-10,1623279600.0
934,2,1,2021-06-11,327,500,48936,36665,2021-06-11,1623366000.0
935,2,1,2021-06-12,238,286,49174,36951,2021-06-12,1623452400.0
936,2,1,2021-06-13,32,28,49206,36979,2021-06-13,1623538800.0
937,2,1,2021-06-14,353,495,49559,37474,2021-06-14,1623625200.0
938,2,1,2021-06-15,371,420,49930,37894,2021-06-15,1623711600.0
939,2,1,2021-06-16,394,377,50324,38271,2021-06-16,1623798000.0
940,2,1,2021-06-17,327,497,50651,38768,2021-06-17,1623884400.0
941,2,1,2021-06-18,412,496,51063,39264,2021-06-18,1623970800.0
942,2,1,2021-06-19,217,156,51280,39420,2021-06-19,1624057200.0
943,2,1,2021-06-20,25,17,51305,39437,2021-06-20,1624143600.0
944,2,1,2021-06-21,316,561,51621,39998,2021-06-21,1624230000.0
945,2,1,2021-06-22,271,408,51892,40406,2021-06-22,1624316400.0
946,2,1,2021-06-23,393,476,52285,40882,2021-06-23,1624402800.0
947,2,1,2021-06-24,306,359,52591,41241,2021-06-24,1624489200.0
948,2,1,2021-06-25,283,349,52874,41590,2021-06-25,1624575600.0
949,2,1,2021-06-26,213,187,53087,41777,2021-06-26,1624662000.0
950,2,1,2021-06-27,12,20,53099,41797,2021-06-27,1624748400.0
951,2,1,2021-06-28,296,377,53395,42174,2021-06-28,1624834800.0
952,2,1,2021-06-29,299,359,53694,42533,2021-06-29,1624921200.0
953,2,1,2021-06-30,408,353,54102,42886,2021-06-30,1625007600.0
954,2,1,2021-07-01,324,349,54426,43235,2021-07-01,1625094000.0
955,2,1,2021-07-02,116,161,54542,43396,2021-07-02,1625180400.0
956,2,1,2021-07-03,97,105,54639,43501,2021-07-03,1625266800.0
957,2,1,2021-07-04,24,34,54663,43535,2021-07-04,1625353200.0
958,2,1,2021-07-05,471,527,55134,44062,2021-07-05,1625439600.0
959,2,1,2021-07-06,404,356,55538,44418,2021-07-06,1625526000.0
960,2,2,2020-12-27,0,0,0,0,2020-12-27,1609023600.0
961,2,2,2020-12-28,0,0,0,0,2020-12-28,1609110000.0
962,2,2,2020-12-29,0,0,0,0,2020-12-29,1609196400.0
963,2,2,2020-12-30,0,0,0,0,2020-12-30,1609282800.0
964,2,2,2020-12-31,0,0,0,0,2020-12-31,1609369200.0
965,2,2,2021-01-01,0,0,0,0,2021-01-01,1609455600.0
966,2,2,2021-01-02,0,0,0,0,2021-01-02,1609542000.0
967,2,2,2021-01-03,0,0,0,0,2021-01-03,1609628400.0
968,2,2,2021-01-04,0,0,0,0,2021-01-04,1609714800.0
969,2,2,2021-01-05,0,0,0,0,2021-01-05,1609801200.0
970,2,2,2021-01-06,0,0,0,0,2021-01-06,1609887600.0
971,2,2,2021-01-07,0,0,0,0,2021-01-07,1609974000.0
972,2,2,2021-01-08,0,0,0,0,2021-01-08,1610060400.0
973,2,2,2021-01-09,0,0,0,0,2021-01-09,1610146800.0
974,2,2,2021-01-10,0,0,0,0,2021-01-10,1610233200.0
975,2,2,2021-01-11,0,0,0,0,2021-01-11,1610319600.0
976,2,2,2021-01-12,0,0,0,0,2021-01-12,1610406000.0
977,2,2,2021-01-13,0,0,0,0,2021-01-13,1610492400.0
978,2,2,2021-01-14,0,0,0,0,2021-01-14,1610578800.0
979,2,2,2021-01-15,0,0,0,0,2021-01-15,1610665200.0
980,2,2,2021-01-16,0,0,0,0,2021-01-16,1610751600.0
981,2,2,2021-01-17,0,0,0,0,2021-01-17,1610838000.0
982,2,2,2021-01-18,0,0,0,0,2021-01-18,1610924400.0
983,2,2,2021-01-19,0,0,0,0,2021-01-19,1611010800.0
984,2,2,2021-01-20,0,0,0,0,2021-01-20,1611097200.0
985,2,2,2021-01-21,0,0,0,0,2021-01-21,1611183600.0
986,2,2,2021-01-22,0,0,0,0,2021-01-22,1611270000.0
987,2,2,2021-01-23,0,0,0,0,2021-01-23,1611356400.0
988,2,2,2021-01-24,0,0,0,0,2021-01-24,1611442800.0
989,2,2,2021-01-25,0,0,0,0,2021-01-25,1611529200.0
990,2,2,2021-01-26,0,0,0,0,2021-01-26,1611615600.0
991,2,2,2021-01-27,0,0,0,0,2021-01-27,1611702000.0
992,2,2,2021-01-28,0,0,0,0,2021-01-28,1611788400.0
993,2,2,2021-01-29,0,0,0,0,2021-01-29,1611874800.0
994,2,2,2021-01-30,0,0,0,0,2021-01-30,1611961200.0
995,2,2,2021-01-31,0,0,0,0,2021-01-31,1612047600.0
996,2,2,2021-02-01,0,0,0,0,2021-02-01,1612134000.0
997,2,2,2021-02-02,0,0,0,0,2021-02-02,1612220400.0
998,2,2,2021-02-03,0,0,0,0,2021-02-03,1612306800.0
999,2,2,2021-02-04,0,0,0,0,2021-02-04,1612393200.0
1000,2,2,2021-02-05,0,0,0,0,2021-02-05,1612479600.0
1001,2,2,2021-02-06,0,0,0,0,2021-02-06,1612566000.0
1002,2,2,2021-02-07,0,0,0,0,2021-02-07,1612652400.0
1003,2,2,2021-02-08,0,0,0,0,2021-02-08,1612738800.0
1004,2,2,2021-02-09,0,0,0,0,2021-02-09,1612825200.0
1005,2,2,2021-02-10,0,0,0,0,2021-02-10,1612911600.0
1006,2,2,2021-02-11,0,0,0,0,2021-02-11,1612998000.0
1007,2,2,2021-02-12,0,0,0,0,2021-02-12,1613084400.0
1008,2,2,2021-02-13,0,0,0,0,2021-02-13,1613170800.0
1009,2,2,2021-02-14,0,0,0,0,2021-02-14,1613257200.0
1010,2,2,2021-02-15,0,0,0,0,2021-02-15,1613343600.0
1011,2,2,2021-02-16,0,0,0,0,2021-02-16,1613430000.0
1012,2,2,2021-02-17,0,0,0,0,2021-02-17,1613516400.0
1013,2,2,2021-02-18,0,0,0,0,2021-02-18,1613602800.0
1014,2,2,2021-02-19,0,0,0,0,2021-02-19,1613689200.0
1015,2,2,2021-02-20,0,0,0,0,2021-02-20,1613775600.0
1016,2,2,2021-02-21,0,0,0,0,2021-02-21,1613862000.0
1017,2,2,2021-02-22,0,0,0,0,2021-02-22,1613948400.0
1018,2,2,2021-02-23,0,0,0,0,2021-02-23,1614034800.0
1019,2,2,2021-02-24,0,0,0,0,2021-02-24,1614121200.0
1020,2,2,2021-02-25,0,0,0,0,2021-02-25,1614207600.0
1021,2,2,2021-02-26,0,0,0,0,2021-02-26,1614294000.0
1022,2,2,2021-02-27,0,0,0,0,2021-02-27,1614380400.0
1023,2,2,2021-02-28,0,0,0,0,2021-02-28,1614466800.0
1024,2,2,2021-03-01,0,0,0,0,2021-03-01,1614553200.0
1025,2,2,2021-03-02,0,0,0,0,2021-03-02,1614639600.0
1026,2,2,2021-03-03,0,0,0,0,2021-03-03,1614726000.0
1027,2,2,2021-03-04,0,0,0,0,2021-03-04,1614812400.0
1028,2,2,2021-03-05,0,0,0,0,2021-03-05,1614898800.0
1029,2,2,2021-03-06,0,0,0,0,2021-03-06,1614985200.0
1030,2,2,2021-03-07,0,0,0,0,2021-03-07,1615071600.0
1031,2,2,2021-03-08,0,0,0,0,2021-03-08,1615158000.0
1032,2,2,2021-03-09,0,0,0,0,2021-03-09,1615244400.0
1033,2,2,2021-03-10,0,0,0,0,2021-03-10,1615330800.0
1034,2,2,2021-03-11,0,0,0,0,2021-03-11,1615417200.0
1035,2,2,2021-03-12,0,0,0,0,2021-03-12,1615503600.0
1036,2,2,2021-03-13,0,0,0,0,2021-03-13,1615590000.0
1037,2,2,2021-03-14,0,0,0,0,2021-03-14,1615676400.0
1038,2,2,2021-03-15,0,0,0,0,2021-03-15,1615762800.0
1039,2,2,2021-03-16,0,0,0,0,2021-03-16,1615849200.0
1040,2,2,2021-03-17,0,0,0,0,2021-03-17,1615935600.0
1041,2,2,2021-03-18,0,0,0,0,2021-03-18,1616022000.0
1042,2,2,2021-03-19,0,0,0,0,2021-03-19,1616108400.0
1043,2,2,2021-03-20,0,0,0,0,2021-03-20,1616194800.0
1044,2,2,2021-03-21,0,0,0,0,2021-03-21,1616281200.0
1045,2,2,2021-03-22,0,0,0,0,2021-03-22,1616367600.0
1046,2,2,2021-03-23,0,0,0,0,2021-03-23,1616454000.0
1047,2,2,2021-03-24,0,0,0,0,2021-03-24,1616540400.0
1048,2,2,2021-03-25,0,0,0,0,2021-03-25,1616626800.0
1049,2,2,2021-03-26,0,0,0,0,2021-03-26,1616713200.0
1050,2,2,2021-03-27,0,0,0,0,2021-03-27,1616799600.0
1051,2,2,2021-03-28,0,0,0,0,2021-03-28,1616886000.0
1052,2,2,2021-03-29,0,0,0,0,2021-03-29,1616972400.0
1053,2,2,2021-03-30,0,0,0,0,2021-03-30,1617058800.0
1054,2,2,2021-03-31,0,0,0,0,2021-03-31,1617145200.0
1055,2,2,2021-04-01,0,0,0,0,2021-04-01,1617231600.0
1056,2,2,2021-04-02,0,0,0,0,2021-04-02,1617318000.0
1057,2,2,2021-04-03,0,0,0,0,2021-04-03,1617404400.0
1058,2,2,2021-04-04,0,0,0,0,2021-04-04,1617490800.0
1059,2,2,2021-04-05,0,0,0,0,2021-04-05,1617577200.0
1060,2,2,2021-04-06,0,0,0,0,2021-04-06,1617663600.0
1061,2,2,2021-04-07,0,0,0,0,2021-04-07,1617750000.0
1062,2,2,2021-04-08,0,0,0,0,2021-04-08,1617836400.0
1063,2,2,2021-04-09,0,0,0,0,2021-04-09,1617922800.0
1064,2,2,2021-04-10,0,0,0,0,2021-04-10,1618009200.0
1065,2,2,2021-04-11,0,0,0,0,2021-04-11,1618095600.0
1066,2,2,2021-04-12,0,0,0,0,2021-04-12,1618185600.0
1067,2,2,2021-04-13,0,0,0,0,2021-04-13,1618272000.0
1068,2,2,2021-04-14,0,0,0,0,2021-04-14,1618358400.0
1069,2,2,2021-04-15,0,0,0,0,2021-04-15,1618444800.0
1070,2,2,2021-04-16,0,0,0,0,2021-04-16,1618531200.0
1071,2,2,2021-04-17,0,0,0,0,2021-04-17,1618617600.0
1072,2,2,2021-04-18,0,0,0,0,2021-04-18,1618704000.0
1073,2,2,2021-04-19,0,0,0,0,2021-04-19,1618790400.0
1074,2,2,2021-04-20,0,0,0,0,2021-04-20,1618876800.0
1075,2,2,2021-04-21,0,0,0,0,2021-04-21,1618963200.0
1076,2,2,2021-04-22,0,0,0,0,2021-04-22,1619049600.0
1077,2,2,2021-04-23,0,0,0,0,2021-04-23,1619136000.0
1078,2,2,2021-04-24,0,0,0,0,2021-04-24,1619222400.0
1079,2,2,2021-04-25,0,0,0,0,2021-04-25,1619308800.0
1080,2,2,2021-04-26,0,0,0,0,2021-04-26,1619395200.0
1081,2,2,2021-04-27,0,0,0,0,2021-04-27,1619481600.0
1082,2,2,2021-04-28,0,0,0,0,2021-04-28,1619568000.0
1083,2,2,2021-04-29,0,0,0,0,2021-04-29,1619654400.0
1084,2,2,2021-04-30,0,0,0,0,2021-04-30,1619740800.0
1085,2,2,2021-05-01,0,0,0,0,2021-05-01,1619827200.0
1086,2,2,2021-05-02,0,0,0,0,2021-05-02,1619913600.0
1087,2,2,2021-05-03,0,0,0,0,2021-05-03,1620000000.0
1088,2,2,2021-05-04,0,0,0,0,2021-05-04,1620086400.0
1089,2,2,2021-05-05,0,0,0,0,2021-05-05,1620172800.0
1090,2,2,2021-05-06,0,0,0,0,2021-05-06,1620259200.0
1091,2,2,2021-05-07,0,0,0,0,2021-05-07,1620345600.0
1092,2,2,2021-05-08,0,0,0,0,2021-05-08,1620432000.0
1093,2,2,2021-05-09,0,0,0,0,2021-05-09,1620518400.0
1094,2,2,2021-05-10,0,0,0,0,2021-05-10,1620604800.0
1095,2,2,2021-05-11,0,0,0,0,2021-05-11,1620691200.0
1096,2,2,2021-05-12,0,0,0,0,2021-05-12,1620777600.0
1097,2,2,2021-05-13,0,0,0,0,2021-05-13,1620864000.0
1098,2,2,2021-05-14,0,0,0,0,2021-05-14,1620950400.0
1099,2,2,2021-05-15,0,0,0,0,2021-05-15,1621036800.0
1100,2,2,2021-05-16,0,0,0,0,2021-05-16,1621123200.0
1101,2,2,2021-05-17,0,0,0,0,2021-05-17,1621206000.0
1102,2,2,2021-05-18,0,0,0,0,2021-05-18,1621292400.0
1103,2,2,2021-05-19,0,0,0,0,2021-05-19,1621378800.0
1104,2,2,2021-05-20,0,0,0,0,2021-05-20,1621465200.0
1105,2,2,2021-05-21,0,0,0,0,2021-05-21,1621551600.0
1106,2,2,2021-05-22,0,0,0,0,2021-05-22,1621638000.0
1107,2,2,2021-05-23,0,0,0,0,2021-05-23,1621724400.0
1108,2,2,2021-05-24,0,0,0,0,2021-05-24,1621810800.0
1109,2,2,2021-05-25,0,0,0,0,2021-05-25,1621897200.0
1110,2,2,2021-05-26,0,0,0,0,2021-05-26,1621983600.0
1111,2,2,2021-05-27,0,0,0,0,2021-05-27,1622070000.0
1112,2,2,2021-05-28,0,0,0,0,2021-05-28,1622156400.0
1113,2,2,2021-05-29,0,0,0,0,2021-05-29,1622242800.0
1114,2,2,2021-05-30,0,0,0,0,2021-05-30,1622329200.0
1115,2,2,2021-05-31,0,0,0,0,2021-05-31,1622415600.0
1116,2,2,2021-06-01,0,0,0,0,2021-06-01,1622502000.0
1117,2,2,2021-06-02,0,0,0,0,2021-06-02,1622588400.0
1118,2,2,2021-06-03,0,0,0,0,2021-06-03,1622674800.0
1119,2,2,2021-06-04,0,0,0,0,2021-06-04,1622761200.0
1120,2,2,2021-06-05,0,0,0,0,2021-06-05,1622847600.0
1121,2,2,2021-06-06,0,0,0,0,2021-06-06,1622934000.0
1122,2,2,2021-06-07,0,0,0,0,2021-06-07,1623020400.0
1123,2,2,2021-06-08,0,0,0,0,2021-06-08,1623106800.0
1124,2,2,2021-06-09,0,0,0,0,2021-06-09,1623193200.0
1125,2,2,2021-06-10,0,0,0,0,2021-06-10,1623279600.0
1126,2,2,2021-06-11,0,0,0,0,2021-06-11,1623366000.0
1127,2,2,2021-06-12,0,0,0,0,2021-06-12,1623452400.0
1128,2,2,2021-06-13,0,0,0,0,2021-06-13,1623538800.0
1129,2,2,2021-06-14,0,0,0,0,2021-06-14,1623625200.0
1130,2,2,2021-06-15,0,0,0,0,2021-06-15,1623711600.0
1131,2,2,2021-06-16,0,0,0,0,2021-06-16,1623798000.0
1132,2,2,2021-06-17,0,0,0,0,2021-06-17,1623884400.0
1133,2,2,2021-06-18,0,0,0,0,2021-06-18,1623970800.0
1134,2,2,2021-06-19,0,0,0,0,2021-06-19,1624057200.0
1135,2,2,2021-06-20,0,0,0,0,2021-06-20,1624143600.0
1136,2,2,2021-06-21,0,0,0,0,2021-06-21,1624230000.0
1137,2,2,2021-06-22,0,0,0,0,2021-06-22,1624316400.0
1138,2,2,2021-06-23,0,0,0,0,2021-06-23,1624402800.0
1139,2,2,2021-06-24,0,0,0,0,2021-06-24,1624489200.0
1140,2,2,2021-06-25,0,0,0,0,2021-06-25,1624575600.0
1141,2,2,2021-06-26,0,0,0,0,2021-06-26,1624662000.0
1142,2,2,2021-06-27,0,0,0,0,2021-06-27,1624748400.0
1143,2,2,2021-06-28,0,0,0,0,2021-06-28,1624834800.0
1144,2,2,2021-06-29,0,0,0,0,2021-06-29,1624921200.0
1145,2,2,2021-06-30,0,0,0,0,2021-06-30,1625007600.0
1146,2,2,2021-07-01,0,0,0,0,2021-07-01,1625094000.0
1147,2,2,2021-07-02,0,0,0,0,2021-07-02,1625180400.0
1148,2,2,2021-07-03,0,0,0,0,2021-07-03,1625266800.0
1149,2,2,2021-07-04,0,0,0,0,2021-07-04,1625353200.0
1150,2,2,2021-07-05,0,0,0,0,2021-07-05,1625439600.0
1151,2,2,2021-07-06,0,0,0,0,2021-07-06,1625526000.0
1152,2,3,2020-12-27,0,0,0,0,2020-12-27,1609023600.0
1153,2,3,2020-12-28,0,0,0,0,2020-12-28,1609110000.0
1154,2,3,2020-12-29,0,0,0,0,2020-12-29,1609196400.0
1155,2,3,2020-12-30,0,0,0,0,2020-12-30,1609282800.0
1156,2,3,2020-12-31,0,0,0,0,2020-12-31,1609369200.0
1157,2,3,2021-01-01,0,0,0,0,2021-01-01,1609455600.0
1158,2,3,2021-01-02,0,0,0,0,2021-01-02,1609542000.0
1159,2,3,2021-01-03,0,0,0,0,2021-01-03,1609628400.0
1160,2,3,2021-01-04,0,0,0,0,2021-01-04,1609714800.0
1161,2,3,2021-01-05,0,0,0,0,2021-01-05,1609801200.0
1162,2,3,2021-01-06,0,0,0,0,2021-01-06,1609887600.0
1163,2,3,2021-01-07,0,0,0,0,2021-01-07,1609974000.0
1164,2,3,2021-01-08,0,0,0,0,2021-01-08,1610060400.0
1165,2,3,2021-01-09,0,0,0,0,2021-01-09,1610146800.0
1166,2,3,2021-01-10,0,0,0,0,2021-01-10,1610233200.0
1167,2,3,2021-01-11,0,0,0,0,2021-01-11,1610319600.0
1168,2,3,2021-01-12,0,0,0,0,2021-01-12,1610406000.0
1169,2,3,2021-01-13,0,0,0,0,2021-01-13,1610492400.0
1170,2,3,2021-01-14,0,0,0,0,2021-01-14,1610578800.0
1171,2,3,2021-01-15,0,0,0,0,2021-01-15,1610665200.0
1172,2,3,2021-01-16,0,0,0,0,2021-01-16,1610751600.0
1173,2,3,2021-01-17,0,0,0,0,2021-01-17,1610838000.0
1174,2,3,2021-01-18,0,0,0,0,2021-01-18,1610924400.0
1175,2,3,2021-01-19,0,0,0,0,2021-01-19,1611010800.0
1176,2,3,2021-01-20,0,0,0,0,2021-01-20,1611097200.0
1177,2,3,2021-01-21,0,0,0,0,2021-01-21,1611183600.0
1178,2,3,2021-01-22,0,0,0,0,2021-01-22,1611270000.0
1179,2,3,2021-01-23,0,0,0,0,2021-01-23,1611356400.0
1180,2,3,2021-01-24,0,0,0,0,2021-01-24,1611442800.0
1181,2,3,2021-01-25,0,0,0,0,2021-01-25,1611529200.0
1182,2,3,2021-01-26,0,0,0,0,2021-01-26,1611615600.0
1183,2,3,2021-01-27,0,0,0,0,2021-01-27,1611702000.0
1184,2,3,2021-01-28,0,0,0,0,2021-01-28,1611788400.0
1185,2,3,2021-01-29,0,0,0,0,2021-01-29,1611874800.0
1186,2,3,2021-01-30,0,0,0,0,2021-01-30,1611961200.0
1187,2,3,2021-01-31,0,0,0,0,2021-01-31,1612047600.0
1188,2,3,2021-02-01,0,0,0,0,2021-02-01,1612134000.0
1189,2,3,2021-02-02,0,0,0,0,2021-02-02,1612220400.0
1190,2,3,2021-02-03,0,0,0,0,2021-02-03,1612306800.0
1191,2,3,2021-02-04,0,0,0,0,2021-02-04,1612393200.0
1192,2,3,2021-02-05,0,0,0,0,2021-02-05,1612479600.0
1193,2,3,2021-02-06,0,0,0,0,2021-02-06,1612566000.0
1194,2,3,2021-02-07,0,0,0,0,2021-02-07,1612652400.0
1195,2,3,2021-02-08,0,0,0,0,2021-02-08,1612738800.0
1196,2,3,2021-02-09,0,0,0,0,2021-02-09,1612825200.0
1197,2,3,2021-02-10,0,0,0,0,2021-02-10,1612911600.0
1198,2,3,2021-02-11,0,0,0,0,2021-02-11,1612998000.0
1199,2,3,2021-02-12,0,0,0,0,2021-02-12,1613084400.0
1200,2,3,2021-02-13,0,0,0,0,2021-02-13,1613170800.0
1201,2,3,2021-02-14,0,0,0,0,2021-02-14,1613257200.0
1202,2,3,2021-02-15,0,0,0,0,2021-02-15,1613343600.0
1203,2,3,2021-02-16,0,0,0,0,2021-02-16,1613430000.0
1204,2,3,2021-02-17,1,0,1,0,2021-02-17,1613516400.0
1205,2,3,2021-02-18,0,0,1,0,2021-02-18,1613602800.0
1206,2,3,2021-02-19,0,0,1,0,2021-02-19,1613689200.0
1207,2,3,2021-02-20,0,0,1,0,2021-02-20,1613775600.0
1208,2,3,2021-02-21,0,0,1,0,2021-02-21,1613862000.0
1209,2,3,2021-02-22,0,0,1,0,2021-02-22,1613948400.0
1210,2,3,2021-02-23,0,0,1,0,2021-02-23,1614034800.0
1211,2,3,2021-02-24,0,0,1,0,2021-02-24,1614121200.0
1212,2,3,2021-02-25,0,0,1,0,2021-02-25,1614207600.0
1213,2,3,2021-02-26,0,0,1,0,2021-02-26,1614294000.0
1214,2,3,2021-02-27,0,0,1,0,2021-02-27,1614380400.0
1215,2,3,2021-02-28,0,0,1,0,2021-02-28,1614466800.0
1216,2,3,2021-03-01,0,0,1,0,2021-03-01,1614553200.0
1217,2,3,2021-03-02,16,0,17,0,2021-03-02,1614639600.0
1218,2,3,2021-03-03,11,0,28,0,2021-03-03,1614726000.0
1219,2,3,2021-03-04,33,0,61,0,2021-03-04,1614812400.0
1220,2,3,2021-03-05,8,0,69,0,2021-03-05,1614898800.0
1221,2,3,2021-03-06,48,0,117,0,2021-03-06,1614985200.0
1222,2,3,2021-03-07,52,0,169,0,2021-03-07,1615071600.0
1223,2,3,2021-03-08,27,0,196,0,2021-03-08,1615158000.0
1224,2,3,2021-03-09,56,0,252,0,2021-03-09,1615244400.0
1225,2,3,2021-03-10,103,0,355,0,2021-03-10,1615330800.0
1226,2,3,2021-03-11,117,0,472,0,2021-03-11,1615417200.0
1227,2,3,2021-03-12,63,0,535,0,2021-03-12,1615503600.0
1228,2,3,2021-03-13,52,0,587,0,2021-03-13,1615590000.0
1229,2,3,2021-03-14,4,0,591,0,2021-03-14,1615676400.0
1230,2,3,2021-03-15,6,0,597,0,2021-03-15,1615762800.0
1231,2,3,2021-03-16,0,0,597,0,2021-03-16,1615849200.0
1232,2,3,2021-03-17,0,0,597,0,2021-03-17,1615935600.0
1233,2,3,2021-03-18,10,0,607,0,2021-03-18,1616022000.0
1234,2,3,2021-03-19,0,0,607,0,2021-03-19,1616108400.0
1235,2,3,2021-03-20,0,0,607,0,2021-03-20,1616194800.0
1236,2,3,2021-03-21,0,0,607,0,2021-03-21,1616281200.0
1237,2,3,2021-03-22,24,0,631,0,2021-03-22,1616367600.0
1238,2,3,2021-03-23,32,0,663,0,2021-03-23,1616454000.0
1239,2,3,2021-03-24,66,0,729,0,2021-03-24,1616540400.0
1240,2,3,2021-03-25,81,0,810,0,2021-03-25,1616626800.0
1241,2,3,2021-03-26,52,0,862,0,2021-03-26,1616713200.0
1242,2,3,2021-03-27,53,0,915,0,2021-03-27,1616799600.0
1243,2,3,2021-03-28,0,0,915,0,2021-03-28,1616886000.0
1244,2,3,2021-03-29,59,0,974,0,2021-03-29,1616972400.0
1245,2,3,2021-03-30,60,0,1034,0,2021-03-30,1617058800.0
1246,2,3,2021-03-31,156,0,1190,0,2021-03-31,1617145200.0
1247,2,3,2021-04-01,105,0,1295,0,2021-04-01,1617231600.0
1248,2,3,2021-04-02,1,0,1296,0,2021-04-02,1617318000.0
1249,2,3,2021-04-03,38,0,1334,0,2021-04-03,1617404400.0
1250,2,3,2021-04-04,0,0,1334,0,2021-04-04,1617490800.0
1251,2,3,2021-04-05,0,0,1334,0,2021-04-05,1617577200.0
1252,2,3,2021-04-06,10,0,1344,0,2021-04-06,1617663600.0
1253,2,3,2021-04-07,74,0,1418,0,2021-04-07,1617750000.0
1254,2,3,2021-04-08,26,0,1444,0,2021-04-08,1617836400.0
1255,2,3,2021-04-09,53,0,1497,0,2021-04-09,1617922800.0
1256,2,3,2021-04-10,28,2,1525,2,2021-04-10,1618009200.0
1257,2,3,2021-04-11,0,0,1525,2,2021-04-11,1618095600.0
1258,2,3,2021-04-12,28,0,1553,2,2021-04-12,1618185600.0
1259,2,3,2021-04-13,24,0,1577,2,2021-04-13,1618272000.0
1260,2,3,2021-04-14,26,0,1603,2,2021-04-14,1618358400.0
1261,2,3,2021-04-15,69,1,1672,3,2021-04-15,1618444800.0
1262,2,3,2021-04-16,11,0,1683,3,2021-04-16,1618531200.0
1263,2,3,2021-04-17,16,0,1699,3,2021-04-17,1618617600.0
1264,2,3,2021-04-18,0,0,1699,3,2021-04-18,1618704000.0
1265,2,3,2021-04-19,0,0,1699,3,2021-04-19,1618790400.0
1266,2,3,2021-04-20,12,0,1711,3,2021-04-20,1618876800.0
1267,2,3,2021-04-21,27,0,1738,3,2021-04-21,1618963200.0
1268,2,3,2021-04-22,34,3,1772,6,2021-04-22,1619049600.0
1269,2,3,2021-04-23,15,0,1787,6,2021-04-23,1619136000.0
1270,2,3,2021-04-24,9,5,1796,11,2021-04-24,1619222400.0
1271,2,3,2021-04-25,0,0,1796,11,2021-04-25,1619308800.0
1272,2,3,2021-04-26,15,0,1811,11,2021-04-26,1619395200.0
1273,2,3,2021-04-27,24,0,1835,11,2021-04-27,1619481600.0
1274,2,3,2021-04-28,10,2,1845,13,2021-04-28,1619568000.0
1275,2,3,2021-04-29,23,0,1868,13,2021-04-29,1619654400.0
1276,2,3,2021-04-30,10,1,1878,14,2021-04-30,1619740800.0
1277,2,3,2021-05-01,8,0,1886,14,2021-05-01,1619827200.0
1278,2,3,2021-05-02,3,0,1889,14,2021-05-02,1619913600.0
1279,2,3,2021-05-03,17,0,1906,14,2021-05-03,1620000000.0
1280,2,3,2021-05-04,11,1,1917,15,2021-05-04,1620086400.0
1281,2,3,2021-05-05,22,0,1939,15,2021-05-05,1620172800.0
1282,2,3,2021-05-06,17,15,1956,30,2021-05-06,1620259200.0
1283,2,3,2021-05-07,8,0,1964,30,2021-05-07,1620345600.0
1284,2,3,2021-05-08,0,0,1964,30,2021-05-08,1620432000.0
1285,2,3,2021-05-09,2,0,1966,30,2021-05-09,1620518400.0
1286,2,3,2021-05-10,6,17,1972,47,2021-05-10,1620604800.0
1287,2,3,2021-05-11,12,3,1984,50,2021-05-11,1620691200.0
1288,2,3,2021-05-12,2,11,1986,61,2021-05-12,1620777600.0
1289,2,3,2021-05-13,1,14,1987,75,2021-05-13,1620864000.0
1290,2,3,2021-05-14,12,17,1999,92,2021-05-14,1620950400.0
1291,2,3,2021-05-15,0,4,1999,96,2021-05-15,1621036800.0
1292,2,3,2021-05-16,0,0,1999,96,2021-05-16,1621123200.0
1293,2,3,2021-05-17,2,0,2001,96,2021-05-17,1621206000.0
1294,2,3,2021-05-18,2,0,2003,96,2021-05-18,1621292400.0
1295,2,3,2021-05-19,5,9,2008,105,2021-05-19,1621378800.0
1296,2,3,2021-05-20,5,8,2013,113,2021-05-20,1621465200.0
1297,2,3,2021-05-21,2,10,2015,123,2021-05-21,1621551600.0
1298,2,3,2021-05-22,0,2,2015,125,2021-05-22,1621638000.0
1299,2,3,2021-05-23,0,0,2015,125,2021-05-23,1621724400.0
1300,2,3,2021-05-24,0,0,2015,125,2021-05-24,1621810800.0
1301,2,3,2021-05-25,4,16,2019,141,2021-05-25,1621897200.0
1302,2,3,2021-05-26,5,19,2024,160,2021-05-26,1621983600.0
1303,2,3,2021-05-27,2,22,2026,182,2021-05-27,1622070000.0
1304,2,3,2021-05-28,2,40,2028,222,2021-05-28,1622156400.0
1305,2,3,2021-05-29,7,27,2035,249,2021-05-29,1622242800.0
1306,2,3,2021-05-30,0,4,2035,253,2021-05-30,1622329200.0
1307,2,3,2021-05-31,10,48,2045,301,2021-05-31,1622415600.0
1308,2,3,2021-06-01,2,19,2047,320,2021-06-01,1622502000.0
1309,2,3,2021-06-02,6,40,2053,360,2021-06-02,1622588400.0
1310,2,3,2021-06-03,3,47,2056,407,2021-06-03,1622674800.0
1311,2,3,2021-06-04,0,12,2056,419,2021-06-04,1622761200.0
1312,2,3,2021-06-05,2,37,2058,456,2021-06-05,1622847600.0
1313,2,3,2021-06-06,0,0,2058,456,2021-06-06,1622934000.0
1314,2,3,2021-06-07,9,35,2067,491,2021-06-07,1623020400.0
1315,2,3,2021-06-08,3,33,2070,524,2021-06-08,1623106800.0
1316,2,3,2021-06-09,13,44,2083,568,2021-06-09,1623193200.0
1317,2,3,2021-06-10,3,59,2086,627,2021-06-10,1623279600.0
1318,2,3,2021-06-11,1,21,2087,648,2021-06-11,1623366000.0
1319,2,3,2021-06-12,0,21,2087,669,2021-06-12,1623452400.0
1320,2,3,2021-06-13,0,0,2087,669,2021-06-13,1623538800.0
1321,2,3,2021-06-14,1,22,2088,691,2021-06-14,1623625200.0
1322,2,3,2021-06-15,0,16,2088,707,2021-06-15,1623711600.0
1323,2,3,2021-06-16,0,26,2088,733,2021-06-16,1623798000.0
1324,2,3,2021-06-17,8,51,2096,784,2021-06-17,1623884400.0
1325,2,3,2021-06-18,0,22,2096,806,2021-06-18,1623970800.0
1326,2,3,2021-06-19,0,22,2096,828,2021-06-19,1624057200.0
1327,2,3,2021-06-20,0,0,2096,828,2021-06-20,1624143600.0
1328,2,3,2021-06-21,0,2,2096,830,2021-06-21,1624230000.0
1329,2,3,2021-06-22,0,26,2096,856,2021-06-22,1624316400.0
1330,2,3,2021-06-23,0,49,2096,905,2021-06-23,1624402800.0
1331,2,3,2021-06-24,0,46,2096,951,2021-06-24,1624489200.0
1332,2,3,2021-06-25,0,3,2096,954,2021-06-25,1624575600.0
1333,2,3,2021-06-26,0,1,2096,955,2021-06-26,1624662000.0
1334,2,3,2021-06-27,0,0,2096,955,2021-06-27,1624748400.0
1335,2,3,2021-06-28,0,11,2096,966,2021-06-28,1624834800.0
1336,2,3,2021-06-29,1,28,2097,994,2021-06-29,1624921200.0
1337,2,3,2021-06-30,0,23,2097,1017,2021-06-30,1625007600.0
1338,2,3,2021-07-01,0,6,2097,1023,2021-07-01,1625094000.0
1339,2,3,2021-07-02,0,20,2097,1043,2021-07-02,1625180400.0
1340,2,3,2021-07-03,0,9,2097,1052,2021-07-03,1625266800.0
1341,2,3,2021-07-04,0,0,2097,1052,2021-07-04,1625353200.0
1342,2,3,2021-07-05,0,11,2097,1063,2021-07-05,1625439600.0
1343,2,3,2021-07-06,2,9,2099,1072,2021-07-06,1625526000.0
1344,2,4,2020-12-27,0,0,0,0,2020-12-27,1609023600.0
1345,2,4,2020-12-28,0,0,0,0,2020-12-28,1609110000.0
1346,2,4,2020-12-29,0,0,0,0,2020-12-29,1609196400.0
1347,2,4,2020-12-30,0,0,0,0,2020-12-30,1609282800.0
1348,2,4,2020-12-31,0,0,0,0,2020-12-31,1609369200.0
1349,2,4,2021-01-01,0,0,0,0,2021-01-01,1609455600.0
1350,2,4,2021-01-02,0,0,0,0,2021-01-02,1609542000.0
1351,2,4,2021-01-03,0,0,0,0,2021-01-03,1609628400.0
1352,2,4,2021-01-04,0,0,0,0,2021-01-04,1609714800.0
1353,2,4,2021-01-05,0,0,0,0,2021-01-05,1609801200.0
1354,2,4,2021-01-06,0,0,0,0,2021-01-06,1609887600.0
1355,2,4,2021-01-07,0,0,0,0,2021-01-07,1609974000.0
1356,2,4,2021-01-08,0,0,0,0,2021-01-08,1610060400.0
1357,2,4,2021-01-09,0,0,0,0,2021-01-09,1610146800.0
1358,2,4,2021-01-10,0,0,0,0,2021-01-10,1610233200.0
1359,2,4,2021-01-11,0,0,0,0,2021-01-11,1610319600.0
1360,2,4,2021-01-12,0,0,0,0,2021-01-12,1610406000.0
1361,2,4,2021-01-13,0,0,0,0,2021-01-13,1610492400.0
1362,2,4,2021-01-14,0,0,0,0,2021-01-14,1610578800.0
1363,2,4,2021-01-15,0,0,0,0,2021-01-15,1610665200.0
1364,2,4,2021-01-16,0,0,0,0,2021-01-16,1610751600.0
1365,2,4,2021-01-17,0,0,0,0,2021-01-17,1610838000.0
1366,2,4,2021-01-18,0,0,0,0,2021-01-18,1610924400.0
1367,2,4,2021-01-19,0,0,0,0,2021-01-19,1611010800.0
1368,2,4,2021-01-20,0,0,0,0,2021-01-20,1611097200.0
1369,2,4,2021-01-21,0,0,0,0,2021-01-21,1611183600.0
1370,2,4,2021-01-22,0,0,0,0,2021-01-22,1611270000.0
1371,2,4,2021-01-23,0,0,0,0,2021-01-23,1611356400.0
1372,2,4,2021-01-24,0,0,0,0,2021-01-24,1611442800.0
1373,2,4,2021-01-25,0,0,0,0,2021-01-25,1611529200.0
1374,2,4,2021-01-26,0,0,0,0,2021-01-26,1611615600.0
1375,2,4,2021-01-27,0,0,0,0,2021-01-27,1611702000.0
1376,2,4,2021-01-28,0,0,0,0,2021-01-28,1611788400.0
1377,2,4,2021-01-29,0,0,0,0,2021-01-29,1611874800.0
1378,2,4,2021-01-30,0,0,0,0,2021-01-30,1611961200.0
1379,2,4,2021-01-31,0,0,0,0,2021-01-31,1612047600.0
1380,2,4,2021-02-01,0,0,0,0,2021-02-01,1612134000.0
1381,2,4,2021-02-02,0,0,0,0,2021-02-02,1612220400.0
1382,2,4,2021-02-03,0,0,0,0,2021-02-03,1612306800.0
1383,2,4,2021-02-04,0,0,0,0,2021-02-04,1612393200.0
1384,2,4,2021-02-05,0,0,0,0,2021-02-05,1612479600.0
1385,2,4,2021-02-06,0,0,0,0,2021-02-06,1612566000.0
1386,2,4,2021-02-07,0,0,0,0,2021-02-07,1612652400.0
1387,2,4,2021-02-08,0,0,0,0,2021-02-08,1612738800.0
1388,2,4,2021-02-09,0,0,0,0,2021-02-09,1612825200.0
1389,2,4,2021-02-10,0,0,0,0,2021-02-10,1612911600.0
1390,2,4,2021-02-11,0,0,0,0,2021-02-11,1612998000.0
1391,2,4,2021-02-12,0,0,0,0,2021-02-12,1613084400.0
1392,2,4,2021-02-13,0,0,0,0,2021-02-13,1613170800.0
1393,2,4,2021-02-14,0,0,0,0,2021-02-14,1613257200.0
1394,2,4,2021-02-15,0,0,0,0,2021-02-15,1613343600.0
1395,2,4,2021-02-16,0,0,0,0,2021-02-16,1613430000.0
1396,2,4,2021-02-17,0,0,0,0,2021-02-17,1613516400.0
1397,2,4,2021-02-18,0,0,0,0,2021-02-18,1613602800.0
1398,2,4,2021-02-19,0,0,0,0,2021-02-19,1613689200.0
1399,2,4,2021-02-20,0,0,0,0,2021-02-20,1613775600.0
1400,2,4,2021-02-21,0,0,0,0,2021-02-21,1613862000.0
1401,2,4,2021-02-22,0,0,0,0,2021-02-22,1613948400.0
1402,2,4,2021-02-23,0,0,0,0,2021-02-23,1614034800.0
1403,2,4,2021-02-24,0,0,0,0,2021-02-24,1614121200.0
1404,2,4,2021-02-25,0,0,0,0,2021-02-25,1614207600.0
1405,2,4,2021-02-26,0,0,0,0,2021-02-26,1614294000.0
1406,2,4,2021-02-27,0,0,0,0,2021-02-27,1614380400.0
1407,2,4,2021-02-28,0,0,0,0,2021-02-28,1614466800.0
1408,2,4,2021-03-01,0,0,0,0,2021-03-01,1614553200.0
1409,2,4,2021-03-02,0,0,0,0,2021-03-02,1614639600.0
1410,2,4,2021-03-03,0,0,0,0,2021-03-03,1614726000.0
1411,2,4,2021-03-04,0,0,0,0,2021-03-04,1614812400.0
1412,2,4,2021-03-05,0,0,0,0,2021-03-05,1614898800.0
1413,2,4,2021-03-06,0,0,0,0,2021-03-06,1614985200.0
1414,2,4,2021-03-07,0,0,0,0,2021-03-07,1615071600.0
1415,2,4,2021-03-08,0,0,0,0,2021-03-08,1615158000.0
1416,2,4,2021-03-09,0,0,0,0,2021-03-09,1615244400.0
1417,2,4,2021-03-10,0,0,0,0,2021-03-10,1615330800.0
1418,2,4,2021-03-11,0,0,0,0,2021-03-11,1615417200.0
1419,2,4,2021-03-12,0,0,0,0,2021-03-12,1615503600.0
1420,2,4,2021-03-13,0,0,0,0,2021-03-13,1615590000.0
1421,2,4,2021-03-14,0,0,0,0,2021-03-14,1615676400.0
1422,2,4,2021-03-15,0,0,0,0,2021-03-15,1615762800.0
1423,2,4,2021-03-16,0,0,0,0,2021-03-16,1615849200.0
1424,2,4,2021-03-17,0,0,0,0,2021-03-17,1615935600.0
1425,2,4,2021-03-18,0,0,0,0,2021-03-18,1616022000.0
1426,2,4,2021-03-19,0,0,0,0,2021-03-19,1616108400.0
1427,2,4,2021-03-20,0,0,0,0,2021-03-20,1616194800.0
1428,2,4,2021-03-21,0,0,0,0,2021-03-21,1616281200.0
1429,2,4,2021-03-22,0,0,0,0,2021-03-22,1616367600.0
1430,2,4,2021-03-23,0,0,0,0,2021-03-23,1616454000.0
1431,2,4,2021-03-24,0,0,0,0,2021-03-24,1616540400.0
1432,2,4,2021-03-25,0,0,0,0,2021-03-25,1616626800.0
1433,2,4,2021-03-26,0,0,0,0,2021-03-26,1616713200.0
1434,2,4,2021-03-27,0,0,0,0,2021-03-27,1616799600.0
1435,2,4,2021-03-28,0,0,0,0,2021-03-28,1616886000.0
1436,2,4,2021-03-29,0,0,0,0,2021-03-29,1616972400.0
1437,2,4,2021-03-30,0,0,0,0,2021-03-30,1617058800.0
1438,2,4,2021-03-31,0,0,0,0,2021-03-31,1617145200.0
1439,2,4,2021-04-01,0,0,0,0,2021-04-01,1617231600.0
1440,2,4,2021-04-02,0,0,0,0,2021-04-02,1617318000.0
1441,2,4,2021-04-03,0,0,0,0,2021-04-03,1617404400.0
1442,2,4,2021-04-04,0,0,0,0,2021-04-04,1617490800.0
1443,2,4,2021-04-05,0,0,0,0,2021-04-05,1617577200.0
1444,2,4,2021-04-06,0,0,0,0,2021-04-06,1617663600.0
1445,2,4,2021-04-07,0,0,0,0,2021-04-07,1617750000.0
1446,2,4,2021-04-08,0,0,0,0,2021-04-08,1617836400.0
1447,2,4,2021-04-09,0,0,0,0,2021-04-09,1617922800.0
1448,2,4,2021-04-10,0,0,0,0,2021-04-10,1618009200.0
1449,2,4,2021-04-11,0,0,0,0,2021-04-11,1618095600.0
1450,2,4,2021-04-12,0,0,0,0,2021-04-12,1618185600.0
1451,2,4,2021-04-13,0,0,0,0,2021-04-13,1618272000.0
1452,2,4,2021-04-14,0,0,0,0,2021-04-14,1618358400.0
1453,2,4,2021-04-15,0,0,0,0,2021-04-15,1618444800.0
1454,2,4,2021-04-16,0,0,0,0,2021-04-16,1618531200.0
1455,2,4,2021-04-17,0,0,0,0,2021-04-17,1618617600.0
1456,2,4,2021-04-18,0,0,0,0,2021-04-18,1618704000.0
1457,2,4,2021-04-19,0,0,0,0,2021-04-19,1618790400.0
1458,2,4,2021-04-20,0,0,0,0,2021-04-20,1618876800.0
1459,2,4,2021-04-21,0,0,0,0,2021-04-21,1618963200.0
1460,2,4,2021-04-22,0,0,0,0,2021-04-22,1619049600.0
1461,2,4,2021-04-23,0,0,0,0,2021-04-23,1619136000.0
1462,2,4,2021-04-24,0,0,0,0,2021-04-24,1619222400.0
1463,2,4,2021-04-25,0,0,0,0,2021-04-25,1619308800.0
1464,2,4,2021-04-26,0,0,0,0,2021-04-26,1619395200.0
1465,2,4,2021-04-27,0,0,0,0,2021-04-27,1619481600.0
1466,2,4,2021-04-28,0,0,0,0,2021-04-28,1619568000.0
1467,2,4,2021-04-29,0,0,0,0,2021-04-29,1619654400.0
1468,2,4,2021-04-30,0,0,0,0,2021-04-30,1619740800.0
1469,2,4,2021-05-01,0,0,0,0,2021-05-01,1619827200.0
1470,2,4,2021-05-02,0,0,0,0,2021-05-02,1619913600.0
1471,2,4,2021-05-03,0,0,0,0,2021-05-03,1620000000.0
1472,2,4,2021-05-04,0,0,0,0,2021-05-04,1620086400.0
1473,2,4,2021-05-05,0,0,0,0,2021-05-05,1620172800.0
1474,2,4,2021-05-06,0,0,0,0,2021-05-06,1620259200.0
1475,2,4,2021-05-07,5,0,5,0,2021-05-07,1620345600.0
1476,2,4,2021-05-08,0,0,5,0,2021-05-08,1620432000.0
1477,2,4,2021-05-09,0,0,5,0,2021-05-09,1620518400.0
1478,2,4,2021-05-10,10,0,15,0,2021-05-10,1620604800.0
1479,2,4,2021-05-11,5,0,20,0,2021-05-11,1620691200.0
1480,2,4,2021-05-12,18,0,38,0,2021-05-12,1620777600.0
1481,2,4,2021-05-13,0,0,38,0,2021-05-13,1620864000.0
1482,2,4,2021-05-14,5,0,43,0,2021-05-14,1620950400.0
1483,2,4,2021-05-15,0,0,43,0,2021-05-15,1621036800.0
1484,2,4,2021-05-16,0,0,43,0,2021-05-16,1621123200.0
1485,2,4,2021-05-17,0,0,43,0,2021-05-17,1621206000.0
1486,2,4,2021-05-18,0,0,43,0,2021-05-18,1621292400.0
1487,2,4,2021-05-19,9,0,52,0,2021-05-19,1621378800.0
1488,2,4,2021-05-20,16,0,68,0,2021-05-20,1621465200.0
1489,2,4,2021-05-21,4,0,72,0,2021-05-21,1621551600.0
1490,2,4,2021-05-22,0,0,72,0,2021-05-22,1621638000.0
1491,2,4,2021-05-23,1,0,73,0,2021-05-23,1621724400.0
1492,2,4,2021-05-24,0,0,73,0,2021-05-24,1621810800.0
1493,2,4,2021-05-25,0,0,73,0,2021-05-25,1621897200.0
1494,2,4,2021-05-26,16,0,89,0,2021-05-26,1621983600.0
1495,2,4,2021-05-27,0,0,89,0,2021-05-27,1622070000.0
1496,2,4,2021-05-28,7,0,96,0,2021-05-28,1622156400.0
1497,2,4,2021-05-29,3,0,99,0,2021-05-29,1622242800.0
1498,2,4,2021-05-30,0,0,99,0,2021-05-30,1622329200.0
1499,2,4,2021-05-31,18,0,117,0,2021-05-31,1622415600.0
1500,2,4,2021-06-01,14,0,131,0,2021-06-01,1622502000.0
1501,2,4,2021-06-02,15,0,146,0,2021-06-02,1622588400.0
1502,2,4,2021-06-03,0,0,146,0,2021-06-03,1622674800.0
1503,2,4,2021-06-04,16,0,162,0,2021-06-04,1622761200.0
1504,2,4,2021-06-05,35,0,197,0,2021-06-05,1622847600.0
1505,2,4,2021-06-06,0,0,197,0,2021-06-06,1622934000.0
1506,2,4,2021-06-07,1,0,198,0,2021-06-07,1623020400.0
1507,2,4,2021-06-08,7,0,205,0,2021-06-08,1623106800.0
1508,2,4,2021-06-09,14,0,219,0,2021-06-09,1623193200.0
1509,2,4,2021-06-10,7,0,226,0,2021-06-10,1623279600.0
1510,2,4,2021-06-11,6,0,232,0,2021-06-11,1623366000.0
1511,2,4,2021-06-12,5,0,237,0,2021-06-12,1623452400.0
1512,2,4,2021-06-13,0,0,237,0,2021-06-13,1623538800.0
1513,2,4,2021-06-14,9,0,246,0,2021-06-14,1623625200.0
1514,2,4,2021-06-15,36,0,282,0,2021-06-15,1623711600.0
1515,2,4,2021-06-16,17,0,299,0,2021-06-16,1623798000.0
1516,2,4,2021-06-17,11,0,310,0,2021-06-17,1623884400.0
1517,2,4,2021-06-18,8,0,318,0,2021-06-18,1623970800.0
1518,2,4,2021-06-19,8,0,326,0,2021-06-19,1624057200.0
1519,2,4,2021-06-20,0,0,326,0,2021-06-20,1624143600.0
1520,2,4,2021-06-21,1,0,327,0,2021-06-21,1624230000.0
1521,2,4,2021-06-22,17,0,344,0,2021-06-22,1624316400.0
1522,2,4,2021-06-23,13,0,357,0,2021-06-23,1624402800.0
1523,2,4,2021-06-24,6,0,363,0,2021-06-24,1624489200.0
1524,2,4,2021-06-25,23,0,386,0,2021-06-25,1624575600.0
1525,2,4,2021-06-26,2,0,388,0,2021-06-26,1624662000.0
1526,2,4,2021-06-27,3,0,391,0,2021-06-27,1624748400.0
1527,2,4,2021-06-28,21,0,412,0,2021-06-28,1624834800.0
1528,2,4,2021-06-29,17,0,429,0,2021-06-29,1624921200.0
1529,2,4,2021-06-30,18,0,447,0,2021-06-30,1625007600.0
1530,2,4,2021-07-01,9,0,456,0,2021-07-01,1625094000.0
1531,2,4,2021-07-02,5,0,461,0,2021-07-02,1625180400.0
1532,2,4,2021-07-03,0,0,461,0,2021-07-03,1625266800.0
1533,2,4,2021-07-04,0,0,461,0,2021-07-04,1625353200.0
1534,2,4,2021-07-05,9,0,470,0,2021-07-05,1625439600.0
1535,2,4,2021-07-06,16,0,486,0,2021-07-06,1625526000.0
1536,3,1,2020-12-27,0,0,0,0,2020-12-27,1609023600.0
1537,3,1,2020-12-28,0,0,0,0,2020-12-28,1609110000.0
1538,3,1,2020-12-29,0,0,0,0,2020-12-29,1609196400.0
1539,3,1,2020-12-30,0,0,0,0,2020-12-30,1609282800.0
1540,3,1,2020-12-31,0,0,0,0,2020-12-31,1609369200.0
1541,3,1,2021-01-01,0,0,0,0,2021-01-01,1609455600.0
1542,3,1,2021-01-02,2,0,2,0,2021-01-02,1609542000.0
1543,3,1,2021-01-03,0,0,2,0,2021-01-03,1609628400.0
1544,3,1,2021-01-04,0,0,2,0,2021-01-04,1609714800.0
1545,3,1,2021-01-05,0,0,2,0,2021-01-05,1609801200.0
1546,3,1,2021-01-06,0,0,2,0,2021-01-06,1609887600.0
1547,3,1,2021-01-07,0,0,2,0,2021-01-07,1609974000.0
1548,3,1,2021-01-08,0,0,2,0,2021-01-08,1610060400.0
1549,3,1,2021-01-09,0,0,2,0,2021-01-09,1610146800.0
1550,3,1,2021-01-10,0,0,2,0,2021-01-10,1610233200.0
1551,3,1,2021-01-11,0,0,2,0,2021-01-11,1610319600.0
1552,3,1,2021-01-12,0,0,2,0,2021-01-12,1610406000.0
1553,3,1,2021-01-13,30,0,32,0,2021-01-13,1610492400.0
1554,3,1,2021-01-14,46,0,78,0,2021-01-14,1610578800.0
1555,3,1,2021-01-15,35,0,113,0,2021-01-15,1610665200.0
1556,3,1,2021-01-16,18,0,131,0,2021-01-16,1610751600.0
1557,3,1,2021-01-17,0,0,131,0,2021-01-17,1610838000.0
1558,3,1,2021-01-18,63,0,194,0,2021-01-18,1610924400.0
1559,3,1,2021-01-19,149,0,343,0,2021-01-19,1611010800.0
1560,3,1,2021-01-20,133,0,476,0,2021-01-20,1611097200.0
1561,3,1,2021-01-21,118,0,594,0,2021-01-21,1611183600.0
1562,3,1,2021-01-22,76,0,670,0,2021-01-22,1611270000.0
1563,3,1,2021-01-23,0,0,670,0,2021-01-23,1611356400.0
1564,3,1,2021-01-24,0,0,670,0,2021-01-24,1611442800.0
1565,3,1,2021-01-25,56,0,726,0,2021-01-25,1611529200.0
1566,3,1,2021-01-26,100,0,826,0,2021-01-26,1611615600.0
1567,3,1,2021-01-27,109,0,935,0,2021-01-27,1611702000.0
1568,3,1,2021-01-28,96,2,1031,2,2021-01-28,1611788400.0
1569,3,1,2021-01-29,104,2,1135,4,2021-01-29,1611874800.0
1570,3,1,2021-01-30,0,0,1135,4,2021-01-30,1611961200.0
1571,3,1,2021-01-31,0,0,1135,4,2021-01-31,1612047600.0
1572,3,1,2021-02-01,54,0,1189,4,2021-02-01,1612134000.0
1573,3,1,2021-02-02,122,4,1311,8,2021-02-02,1612220400.0
1574,3,1,2021-02-03,116,7,1427,15,2021-02-03,1612306800.0
1575,3,1,2021-02-04,79,26,1506,41,2021-02-04,1612393200.0
1576,3,1,2021-02-05,65,7,1571,48,2021-02-05,1612479600.0
1577,3,1,2021-02-06,0,0,1571,48,2021-02-06,1612566000.0
1578,3,1,2021-02-07,0,0,1571,48,2021-02-07,1612652400.0
1579,3,1,2021-02-08,51,13,1622,61,2021-02-08,1612738800.0
1580,3,1,2021-02-09,92,38,1714,99,2021-02-09,1612825200.0
1581,3,1,2021-02-10,101,41,1815,140,2021-02-10,1612911600.0
1582,3,1,2021-02-11,105,93,1920,233,2021-02-11,1612998000.0
1583,3,1,2021-02-12,87,62,2007,295,2021-02-12,1613084400.0
1584,3,1,2021-02-13,0,0,2007,295,2021-02-13,1613170800.0
1585,3,1,2021-02-14,0,0,2007,295,2021-02-14,1613257200.0
1586,3,1,2021-02-15,27,65,2034,360,2021-02-15,1613343600.0
1587,3,1,2021-02-16,123,51,2157,411,2021-02-16,1613430000.0
1588,3,1,2021-02-17,145,115,2302,526,2021-02-17,1613516400.0
1589,3,1,2021-02-18,103,141,2405,667,2021-02-18,1613602800.0
1590,3,1,2021-02-19,122,72,2527,739,2021-02-19,1613689200.0
1591,3,1,2021-02-20,0,0,2527,739,2021-02-20,1613775600.0
1592,3,1,2021-02-21,0,0,2527,739,2021-02-21,1613862000.0
1593,3,1,2021-02-22,78,48,2605,787,2021-02-22,1613948400.0
1594,3,1,2021-02-23,158,98,2763,885,2021-02-23,1614034800.0
1595,3,1,2021-02-24,190,119,2953,1004,2021-02-24,1614121200.0
1596,3,1,2021-02-25,258,86,3211,1090,2021-02-25,1614207600.0
1597,3,1,2021-02-26,264,67,3475,1157,2021-02-26,1614294000.0
1598,3,1,2021-02-27,121,1,3596,1158,2021-02-27,1614380400.0
1599,3,1,2021-02-28,0,0,3596,1158,2021-02-28,1614466800.0
1600,3,1,2021-03-01,179,84,3775,1242,2021-03-01,1614553200.0
1601,3,1,2021-03-02,255,106,4030,1348,2021-03-02,1614639600.0
1602,3,1,2021-03-03,255,124,4285,1472,2021-03-03,1614726000.0
1603,3,1,2021-03-04,281,75,4566,1547,2021-03-04,1614812400.0
1604,3,1,2021-03-05,271,40,4837,1587,2021-03-05,1614898800.0
1605,3,1,2021-03-06,116,0,4953,1587,2021-03-06,1614985200.0
1606,3,1,2021-03-07,0,0,4953,1587,2021-03-07,1615071600.0
1607,3,1,2021-03-08,186,37,5139,1624,2021-03-08,1615158000.0
1608,3,1,2021-03-09,350,86,5489,1710,2021-03-09,1615244400.0
1609,3,1,2021-03-10,357,95,5846,1805,2021-03-10,1615330800.0
1610,3,1,2021-03-11,270,114,6116,1919,2021-03-11,1615417200.0
1611,3,1,2021-03-12,287,90,6403,2009,2021-03-12,1615503600.0
1612,3,1,2021-03-13,110,2,6513,2011,2021-03-13,1615590000.0
1613,3,1,2021-03-14,0,0,6513,2011,2021-03-14,1615676400.0
1614,3,1,2021-03-15,180,23,6693,2034,2021-03-15,1615762800.0
1615,3,1,2021-03-16,241,135,6934,2169,2021-03-16,1615849200.0
1616,3,1,2021-03-17,273,121,7207,2290,2021-03-17,1615935600.0
1617,3,1,2021-03-18,249,145,7456,2435,2021-03-18,1616022000.0
1618,3,1,2021-03-19,284,110,7740,2545,2021-03-19,1616108400.0
1619,3,1,2021-03-20,255,12,7995,2557,2021-03-20,1616194800.0
1620,3,1,2021-03-21,119,0,8114,2557,2021-03-21,1616281200.0
1621,3,1,2021-03-22,219,102,8333,2659,2021-03-22,1616367600.0
1622,3,1,2021-03-23,274,177,8607,2836,2021-03-23,1616454000.0
1623,3,1,2021-03-24,234,195,8841,3031,2021-03-24,1616540400.0
1624,3,1,2021-03-25,167,169,9008,3200,2021-03-25,1616626800.0
1625,3,1,2021-03-26,189,294,9197,3494,2021-03-26,1616713200.0
1626,3,1,2021-03-27,56,88,9253,3582,2021-03-27,1616799600.0
1627,3,1,2021-03-28,0,0,9253,3582,2021-03-28,1616886000.0
1628,3,1,2021-03-29,175,232,9428,3814,2021-03-29,1616972400.0
1629,3,1,2021-03-30,445,212,9873,4026,2021-03-30,1617058800.0
1630,3,1,2021-03-31,318,270,10191,4296,2021-03-31,1617145200.0
1631,3,1,2021-04-01,444,239,10635,4535,2021-04-01,1617231600.0
1632,3,1,2021-04-02,306,265,10941,4800,2021-04-02,1617318000.0
1633,3,1,2021-04-03,152,113,11093,4913,2021-04-03,1617404400.0
1634,3,1,2021-04-04,0,0,11093,4913,2021-04-04,1617490800.0
1635,3,1,2021-04-05,118,8,11211,4921,2021-04-05,1617577200.0
1636,3,1,2021-04-06,438,302,11649,5223,2021-04-06,1617663600.0
1637,3,1,2021-04-07,501,316,12150,5539,2021-04-07,1617750000.0
1638,3,1,2021-04-08,510,233,12660,5772,2021-04-08,1617836400.0
1639,3,1,2021-04-09,496,206,13156,5978,2021-04-09,1617922800.0
1640,3,1,2021-04-10,146,86,13302,6064,2021-04-10,1618009200.0
1641,3,1,2021-04-11,1,0,13303,6064,2021-04-11,1618095600.0
1642,3,1,2021-04-12,552,237,13855,6301,2021-04-12,1618185600.0
1643,3,1,2021-04-13,671,204,14526,6505,2021-04-13,1618272000.0
1644,3,1,2021-04-14,718,256,15244,6761,2021-04-14,1618358400.0
1645,3,1,2021-04-15,773,201,16017,6962,2021-04-15,1618444800.0
1646,3,1,2021-04-16,752,245,16769,7207,2021-04-16,1618531200.0
1647,3,1,2021-04-17,499,98,17268,7305,2021-04-17,1618617600.0
1648,3,1,2021-04-18,499,8,17767,7313,2021-04-18,1618704000.0
1649,3,1,2021-04-19,713,195,18480,7508,2021-04-19,1618790400.0
1650,3,1,2021-04-20,604,235,19084,7743,2021-04-20,1618876800.0
1651,3,1,2021-04-21,865,165,19949,7908,2021-04-21,1618963200.0
1652,3,1,2021-04-22,723,173,20672,8081,2021-04-22,1619049600.0
1653,3,1,2021-04-23,704,173,21376,8254,2021-04-23,1619136000.0
1654,3,1,2021-04-24,525,57,21901,8311,2021-04-24,1619222400.0
1655,3,1,2021-04-25,612,4,22513,8315,2021-04-25,1619308800.0
1656,3,1,2021-04-26,777,170,23290,8485,2021-04-26,1619395200.0
1657,3,1,2021-04-27,784,244,24074,8729,2021-04-27,1619481600.0
1658,3,1,2021-04-28,692,258,24766,8987,2021-04-28,1619568000.0
1659,3,1,2021-04-29,621,233,25387,9220,2021-04-29,1619654400.0
1660,3,1,2021-04-30,673,214,26060,9434,2021-04-30,1619740800.0
1661,3,1,2021-05-01,210,6,26270,9440,2021-05-01,1619827200.0
1662,3,1,2021-05-02,602,28,26872,9468,2021-05-02,1619913600.0
1663,3,1,2021-05-03,553,343,27425,9811,2021-05-03,1620000000.0
1664,3,1,2021-05-04,617,279,28042,10090,2021-05-04,1620086400.0
1665,3,1,2021-05-05,656,408,28698,10498,2021-05-05,1620172800.0
1666,3,1,2021-05-06,650,419,29348,10917,2021-05-06,1620259200.0
1667,3,1,2021-05-07,546,419,29894,11336,2021-05-07,1620345600.0
1668,3,1,2021-05-08,341,43,30235,11379,2021-05-08,1620432000.0
1669,3,1,2021-05-09,262,58,30497,11437,2021-05-09,1620518400.0
1670,3,1,2021-05-10,418,579,30915,12016,2021-05-10,1620604800.0
1671,3,1,2021-05-11,392,460,31307,12476,2021-05-11,1620691200.0
1672,3,1,2021-05-12,502,592,31809,13068,2021-05-12,1620777600.0
1673,3,1,2021-05-13,333,62,32142,13130,2021-05-13,1620864000.0
1674,3,1,2021-05-14,473,505,32615,13635,2021-05-14,1620950400.0
1675,3,1,2021-05-15,254,325,32869,13960,2021-05-15,1621036800.0
1676,3,1,2021-05-16,207,200,33076,14160,2021-05-16,1621123200.0
1677,3,1,2021-05-17,444,546,33520,14706,2021-05-17,1621206000.0
1678,3,1,2021-05-18,559,504,34079,15210,2021-05-18,1621292400.0
1679,3,1,2021-05-19,525,507,34604,15717,2021-05-19,1621378800.0
1680,3,1,2021-05-20,636,396,35240,16113,2021-05-20,1621465200.0
1681,3,1,2021-05-21,490,573,35730,16686,2021-05-21,1621551600.0
1682,3,1,2021-05-22,168,486,35898,17172,2021-05-22,1621638000.0
1683,3,1,2021-05-23,269,454,36167,17626,2021-05-23,1621724400.0
1684,3,1,2021-05-24,560,209,36727,17835,2021-05-24,1621810800.0
1685,3,1,2021-05-25,495,681,37222,18516,2021-05-25,1621897200.0
1686,3,1,2021-05-26,433,655,37655,19171,2021-05-26,1621983600.0
1687,3,1,2021-05-27,690,451,38345,19622,2021-05-27,1622070000.0
1688,3,1,2021-05-28,546,517,38891,20139,2021-05-28,1622156400.0
1689,3,1,2021-05-29,239,341,39130,20480,2021-05-29,1622242800.0
1690,3,1,2021-05-30,151,394,39281,20874,2021-05-30,1622329200.0
1691,3,1,2021-05-31,341,550,39622,21424,2021-05-31,1622415600.0
1692,3,1,2021-06-01,394,416,40016,21840,2021-06-01,1622502000.0
1693,3,1,2021-06-02,523,518,40539,22358,2021-06-02,1622588400.0
1694,3,1,2021-06-03,475,424,41014,22782,2021-06-03,1622674800.0
1695,3,1,2021-06-04,542,450,41556,23232,2021-06-04,1622761200.0
1696,3,1,2021-06-05,271,270,41827,23502,2021-06-05,1622847600.0
1697,3,1,2021-06-06,211,285,42038,23787,2021-06-06,1622934000.0
1698,3,1,2021-06-07,464,407,42502,24194,2021-06-07,1623020400.0
1699,3,1,2021-06-08,518,271,43020,24465,2021-06-08,1623106800.0
1700,3,1,2021-06-09,493,339,43513,24804,2021-06-09,1623193200.0
1701,3,1,2021-06-10,344,251,43857,25055,2021-06-10,1623279600.0
1702,3,1,2021-06-11,408,434,44265,25489,2021-06-11,1623366000.0
1703,3,1,2021-06-12,166,269,44431,25758,2021-06-12,1623452400.0
1704,3,1,2021-06-13,200,247,44631,26005,2021-06-13,1623538800.0
1705,3,1,2021-06-14,352,519,44983,26524,2021-06-14,1623625200.0
1706,3,1,2021-06-15,355,405,45338,26929,2021-06-15,1623711600.0
1707,3,1,2021-06-16,394,407,45732,27336,2021-06-16,1623798000.0
1708,3,1,2021-06-17,364,539,46096,27875,2021-06-17,1623884400.0
1709,3,1,2021-06-18,338,536,46434,28411,2021-06-18,1623970800.0
1710,3,1,2021-06-19,230,237,46664,28648,2021-06-19,1624057200.0
1711,3,1,2021-06-20,123,263,46787,28911,2021-06-20,1624143600.0
1712,3,1,2021-06-21,264,556,47051,29467,2021-06-21,1624230000.0
1713,3,1,2021-06-22,306,427,47357,29894,2021-06-22,1624316400.0
1714,3,1,2021-06-23,272,494,47629,30388,2021-06-23,1624402800.0
1715,3,1,2021-06-24,387,460,48016,30848,2021-06-24,1624489200.0
1716,3,1,2021-06-25,377,505,48393,31353,2021-06-25,1624575600.0
1717,3,1,2021-06-26,164,309,48557,31662,2021-06-26,1624662000.0
1718,3,1,2021-06-27,117,161,48674,31823,2021-06-27,1624748400.0
1719,3,1,2021-06-28,281,551,48955,32374,2021-06-28,1624834800.0
1720,3,1,2021-06-29,325,463,49280,32837,2021-06-29,1624921200.0
1721,3,1,2021-06-30,268,627,49548,33464,2021-06-30,1625007600.0
1722,3,1,2021-07-01,311,368,49859,33832,2021-07-01,1625094000.0
1723,3,1,2021-07-02,347,471,50206,34303,2021-07-02,1625180400.0
1724,3,1,2021-07-03,203,244,50409,34547,2021-07-03,1625266800.0
1725,3,1,2021-07-04,85,226,50494,34773,2021-07-04,1625353200.0
1726,3,1,2021-07-05,291,505,50785,35278,2021-07-05,1625439600.0
1727,3,1,2021-07-06,291,424,51076,35702,2021-07-06,1625526000.0
1728,3,2,2020-12-27,0,0,0,0,2020-12-27,1609023600.0
1729,3,2,2020-12-28,0,0,0,0,2020-12-28,1609110000.0
1730,3,2,2020-12-29,0,0,0,0,2020-12-29,1609196400.0
1731,3,2,2020-12-30,0,0,0,0,2020-12-30,1609282800.0
1732,3,2,2020-12-31,0,0,0,0,2020-12-31,1609369200.0
1733,3,2,2021-01-01,0,0,0,0,2021-01-01,1609455600.0
1734,3,2,2021-01-02,0,0,0,0,2021-01-02,1609542000.0
1735,3,2,2021-01-03,0,0,0,0,2021-01-03,1609628400.0
1736,3,2,2021-01-04,0,0,0,0,2021-01-04,1609714800.0
1737,3,2,2021-01-05,0,0,0,0,2021-01-05,1609801200.0
1738,3,2,2021-01-06,0,0,0,0,2021-01-06,1609887600.0
1739,3,2,2021-01-07,0,0,0,0,2021-01-07,1609974000.0
1740,3,2,2021-01-08,0,0,0,0,2021-01-08,1610060400.0
1741,3,2,2021-01-09,0,0,0,0,2021-01-09,1610146800.0
1742,3,2,2021-01-10,0,0,0,0,2021-01-10,1610233200.0
1743,3,2,2021-01-11,0,0,0,0,2021-01-11,1610319600.0
1744,3,2,2021-01-12,0,0,0,0,2021-01-12,1610406000.0
1745,3,2,2021-01-13,0,0,0,0,2021-01-13,1610492400.0
1746,3,2,2021-01-14,0,0,0,0,2021-01-14,1610578800.0
1747,3,2,2021-01-15,0,0,0,0,2021-01-15,1610665200.0
1748,3,2,2021-01-16,0,0,0,0,2021-01-16,1610751600.0
1749,3,2,2021-01-17,0,0,0,0,2021-01-17,1610838000.0
1750,3,2,2021-01-18,0,0,0,0,2021-01-18,1610924400.0
1751,3,2,2021-01-19,0,0,0,0,2021-01-19,1611010800.0
1752,3,2,2021-01-20,0,0,0,0,2021-01-20,1611097200.0
1753,3,2,2021-01-21,0,0,0,0,2021-01-21,1611183600.0
1754,3,2,2021-01-22,0,0,0,0,2021-01-22,1611270000.0
1755,3,2,2021-01-23,0,0,0,0,2021-01-23,1611356400.0
1756,3,2,2021-01-24,0,0,0,0,2021-01-24,1611442800.0
1757,3,2,2021-01-25,0,0,0,0,2021-01-25,1611529200.0
1758,3,2,2021-01-26,0,0,0,0,2021-01-26,1611615600.0
1759,3,2,2021-01-27,0,0,0,0,2021-01-27,1611702000.0
1760,3,2,2021-01-28,0,0,0,0,2021-01-28,1611788400.0
1761,3,2,2021-01-29,0,0,0,0,2021-01-29,1611874800.0
1762,3,2,2021-01-30,0,0,0,0,2021-01-30,1611961200.0
1763,3,2,2021-01-31,0,0,0,0,2021-01-31,1612047600.0
1764,3,2,2021-02-01,0,0,0,0,2021-02-01,1612134000.0
1765,3,2,2021-02-02,0,0,0,0,2021-02-02,1612220400.0
1766,3,2,2021-02-03,0,0,0,0,2021-02-03,1612306800.0
1767,3,2,2021-02-04,0,0,0,0,2021-02-04,1612393200.0
1768,3,2,2021-02-05,0,0,0,0,2021-02-05,1612479600.0
1769,3,2,2021-02-06,0,0,0,0,2021-02-06,1612566000.0
1770,3,2,2021-02-07,0,0,0,0,2021-02-07,1612652400.0
1771,3,2,2021-02-08,1,0,1,0,2021-02-08,1612738800.0
1772,3,2,2021-02-09,0,0,1,0,2021-02-09,1612825200.0
1773,3,2,2021-02-10,0,0,1,0,2021-02-10,1612911600.0
1774,3,2,2021-02-11,0,0,1,0,2021-02-11,1612998000.0
1775,3,2,2021-02-12,0,0,1,0,2021-02-12,1613084400.0
1776,3,2,2021-02-13,0,0,1,0,2021-02-13,1613170800.0
1777,3,2,2021-02-14,0,0,1,0,2021-02-14,1613257200.0
1778,3,2,2021-02-15,0,0,1,0,2021-02-15,1613343600.0
1779,3,2,2021-02-16,0,0,1,0,2021-02-16,1613430000.0
1780,3,2,2021-02-17,0,0,1,0,2021-02-17,1613516400.0
1781,3,2,2021-02-18,0,0,1,0,2021-02-18,1613602800.0
1782,3,2,2021-02-19,0,0,1,0,2021-02-19,1613689200.0
1783,3,2,2021-02-20,0,0,1,0,2021-02-20,1613775600.0
1784,3,2,2021-02-21,0,0,1,0,2021-02-21,1613862000.0
1785,3,2,2021-02-22,0,0,1,0,2021-02-22,1613948400.0
1786,3,2,2021-02-23,0,0,1,0,2021-02-23,1614034800.0
1787,3,2,2021-02-24,0,0,1,0,2021-02-24,1614121200.0
1788,3,2,2021-02-25,0,0,1,0,2021-02-25,1614207600.0
1789,3,2,2021-02-26,0,0,1,0,2021-02-26,1614294000.0
1790,3,2,2021-02-27,0,0,1,0,2021-02-27,1614380400.0
1791,3,2,2021-02-28,0,0,1,0,2021-02-28,1614466800.0
1792,3,2,2021-03-01,0,0,1,0,2021-03-01,1614553200.0
1793,3,2,2021-03-02,0,0,1,0,2021-03-02,1614639600.0
1794,3,2,2021-03-03,0,0,1,0,2021-03-03,1614726000.0
1795,3,2,2021-03-04,0,0,1,0,2021-03-04,1614812400.0
1796,3,2,2021-03-05,0,0,1,0,2021-03-05,1614898800.0
1797,3,2,2021-03-06,0,0,1,0,2021-03-06,1614985200.0
1798,3,2,2021-03-07,0,0,1,0,2021-03-07,1615071600.0
1799,3,2,2021-03-08,0,0,1,0,2021-03-08,1615158000.0
1800,3,2,2021-03-09,0,0,1,0,2021-03-09,1615244400.0
1801,3,2,2021-03-10,0,0,1,0,2021-03-10,1615330800.0
1802,3,2,2021-03-11,0,0,1,0,2021-03-11,1615417200.0
1803,3,2,2021-03-12,0,0,1,0,2021-03-12,1615503600.0
1804,3,2,2021-03-13,0,0,1,0,2021-03-13,1615590000.0
1805,3,2,2021-03-14,0,0,1,0,2021-03-14,1615676400.0
1806,3,2,2021-03-15,0,0,1,0,2021-03-15,1615762800.0
1807,3,2,2021-03-16,0,0,1,0,2021-03-16,1615849200.0
1808,3,2,2021-03-17,0,0,1,0,2021-03-17,1615935600.0
1809,3,2,2021-03-18,0,0,1,0,2021-03-18,1616022000.0
1810,3,2,2021-03-19,0,0,1,0,2021-03-19,1616108400.0
1811,3,2,2021-03-20,0,0,1,0,2021-03-20,1616194800.0
1812,3,2,2021-03-21,0,0,1,0,2021-03-21,1616281200.0
1813,3,2,2021-03-22,0,0,1,0,2021-03-22,1616367600.0
1814,3,2,2021-03-23,0,0,1,0,2021-03-23,1616454000.0
1815,3,2,2021-03-24,0,0,1,0,2021-03-24,1616540400.0
1816,3,2,2021-03-25,0,0,1,0,2021-03-25,1616626800.0
1817,3,2,2021-03-26,0,0,1,0,2021-03-26,1616713200.0
1818,3,2,2021-03-27,0,0,1,0,2021-03-27,1616799600.0
1819,3,2,2021-03-28,0,0,1,0,2021-03-28,1616886000.0
1820,3,2,2021-03-29,0,0,1,0,2021-03-29,1616972400.0
1821,3,2,2021-03-30,0,0,1,0,2021-03-30,1617058800.0
1822,3,2,2021-03-31,0,0,1,0,2021-03-31,1617145200.0
1823,3,2,2021-04-01,0,0,1,0,2021-04-01,1617231600.0
1824,3,2,2021-04-02,0,0,1,0,2021-04-02,1617318000.0
1825,3,2,2021-04-03,0,0,1,0,2021-04-03,1617404400.0
1826,3,2,2021-04-04,0,0,1,0,2021-04-04,1617490800.0
1827,3,2,2021-04-05,0,0,1,0,2021-04-05,1617577200.0
1828,3,2,2021-04-06,0,0,1,0,2021-04-06,1617663600.0
1829,3,2,2021-04-07,0,0,1,0,2021-04-07,1617750000.0
1830,3,2,2021-04-08,0,0,1,0,2021-04-08,1617836400.0
1831,3,2,2021-04-09,0,0,1,0,2021-04-09,1617922800.0
1832,3,2,2021-04-10,0,0,1,0,2021-04-10,1618009200.0
1833,3,2,2021-04-11,0,0,1,0,2021-04-11,1618095600.0
1834,3,2,2021-04-12,0,0,1,0,2021-04-12,1618185600.0
1835,3,2,2021-04-13,0,0,1,0,2021-04-13,1618272000.0
1836,3,2,2021-04-14,0,0,1,0,2021-04-14,1618358400.0
1837,3,2,2021-04-15,0,0,1,0,2021-04-15,1618444800.0
1838,3,2,2021-04-16,0,0,1,0,2021-04-16,1618531200.0
1839,3,2,2021-04-17,0,0,1,0,2021-04-17,1618617600.0
1840,3,2,2021-04-18,0,0,1,0,2021-04-18,1618704000.0
1841,3,2,2021-04-19,0,0,1,0,2021-04-19,1618790400.0
1842,3,2,2021-04-20,0,0,1,0,2021-04-20,1618876800.0
1843,3,2,2021-04-21,0,0,1,0,2021-04-21,1618963200.0
1844,3,2,2021-04-22,0,0,1,0,2021-04-22,1619049600.0
1845,3,2,2021-04-23,0,0,1,0,2021-04-23,1619136000.0
1846,3,2,2021-04-24,0,0,1,0,2021-04-24,1619222400.0
1847,3,2,2021-04-25,0,0,1,0,2021-04-25,1619308800.0
1848,3,2,2021-04-26,0,0,1,0,2021-04-26,1619395200.0
1849,3,2,2021-04-27,0,0,1,0,2021-04-27,1619481600.0
1850,3,2,2021-04-28,0,0,1,0,2021-04-28,1619568000.0
1851,3,2,2021-04-29,0,0,1,0,2021-04-29,1619654400.0
1852,3,2,2021-04-30,0,0,1,0,2021-04-30,1619740800.0
1853,3,2,2021-05-01,0,0,1,0,2021-05-01,1619827200.0
1854,3,2,2021-05-02,0,0,1,0,2021-05-02,1619913600.0
1855,3,2,2021-05-03,0,0,1,0,2021-05-03,1620000000.0
1856,3,2,2021-05-04,0,0,1,0,2021-05-04,1620086400.0
1857,3,2,2021-05-05,0,0,1,0,2021-05-05,1620172800.0
1858,3,2,2021-05-06,0,0,1,0,2021-05-06,1620259200.0
1859,3,2,2021-05-07,0,0,1,0,2021-05-07,1620345600.0
1860,3,2,2021-05-08,0,0,1,0,2021-05-08,1620432000.0
1861,3,2,2021-05-09,0,0,1,0,2021-05-09,1620518400.0
1862,3,2,2021-05-10,0,0,1,0,2021-05-10,1620604800.0
1863,3,2,2021-05-11,0,0,1,0,2021-05-11,1620691200.0
1864,3,2,2021-05-12,0,0,1,0,2021-05-12,1620777600.0
1865,3,2,2021-05-13,0,0,1,0,2021-05-13,1620864000.0
1866,3,2,2021-05-14,0,0,1,0,2021-05-14,1620950400.0
1867,3,2,2021-05-15,0,0,1,0,2021-05-15,1621036800.0
1868,3,2,2021-05-16,0,0,1,0,2021-05-16,1621123200.0
1869,3,2,2021-05-17,0,0,1,0,2021-05-17,1621206000.0
1870,3,2,2021-05-18,0,0,1,0,2021-05-18,1621292400.0
1871,3,2,2021-05-19,0,0,1,0,2021-05-19,1621378800.0
1872,3,2,2021-05-20,0,0,1,0,2021-05-20,1621465200.0
1873,3,2,2021-05-21,0,0,1,0,2021-05-21,1621551600.0
1874,3,2,2021-05-22,0,0,1,0,2021-05-22,1621638000.0
1875,3,2,2021-05-23,0,0,1,0,2021-05-23,1621724400.0
1876,3,2,2021-05-24,0,0,1,0,2021-05-24,1621810800.0
1877,3,2,2021-05-25,0,0,1,0,2021-05-25,1621897200.0
1878,3,2,2021-05-26,0,0,1,0,2021-05-26,1621983600.0
1879,3,2,2021-05-27,0,0,1,0,2021-05-27,1622070000.0
1880,3,2,2021-05-28,0,0,1,0,2021-05-28,1622156400.0
1881,3,2,2021-05-29,0,0,1,0,2021-05-29,1622242800.0
1882,3,2,2021-05-30,0,0,1,0,2021-05-30,1622329200.0
1883,3,2,2021-05-31,0,0,1,0,2021-05-31,1622415600.0
1884,3,2,2021-06-01,0,0,1,0,2021-06-01,1622502000.0
1885,3,2,2021-06-02,0,0,1,0,2021-06-02,1622588400.0
1886,3,2,2021-06-03,0,0,1,0,2021-06-03,1622674800.0
1887,3,2,2021-06-04,0,0,1,0,2021-06-04,1622761200.0
1888,3,2,2021-06-05,0,0,1,0,2021-06-05,1622847600.0
1889,3,2,2021-06-06,0,0,1,0,2021-06-06,1622934000.0
1890,3,2,2021-06-07,0,0,1,0,2021-06-07,1623020400.0
1891,3,2,2021-06-08,0,0,1,0,2021-06-08,1623106800.0
1892,3,2,2021-06-09,0,0,1,0,2021-06-09,1623193200.0
1893,3,2,2021-06-10,0,0,1,0,2021-06-10,1623279600.0
1894,3,2,2021-06-11,0,0,1,0,2021-06-11,1623366000.0
1895,3,2,2021-06-12,0,0,1,0,2021-06-12,1623452400.0
1896,3,2,2021-06-13,0,0,1,0,2021-06-13,1623538800.0
1897,3,2,2021-06-14,0,0,1,0,2021-06-14,1623625200.0
1898,3,2,2021-06-15,0,0,1,0,2021-06-15,1623711600.0
1899,3,2,2021-06-16,0,0,1,0,2021-06-16,1623798000.0
1900,3,2,2021-06-17,0,0,1,0,2021-06-17,1623884400.0
1901,3,2,2021-06-18,0,0,1,0,2021-06-18,1623970800.0
1902,3,2,2021-06-19,0,0,1,0,2021-06-19,1624057200.0
1903,3,2,2021-06-20,0,0,1,0,2021-06-20,1624143600.0
1904,3,2,2021-06-21,0,0,1,0,2021-06-21,1624230000.0
1905,3,2,2021-06-22,0,0,1,0,2021-06-22,1624316400.0
1906,3,2,2021-06-23,0,0,1,0,2021-06-23,1624402800.0
1907,3,2,2021-06-24,0,0,1,0,2021-06-24,1624489200.0
1908,3,2,2021-06-25,0,0,1,0,2021-06-25,1624575600.0
1909,3,2,2021-06-26,0,0,1,0,2021-06-26,1624662000.0
1910,3,2,2021-06-27,0,0,1,0,2021-06-27,1624748400.0
1911,3,2,2021-06-28,0,0,1,0,2021-06-28,1624834800.0
1912,3,2,2021-06-29,0,0,1,0,2021-06-29,1624921200.0
1913,3,2,2021-06-30,0,1,1,1,2021-06-30,1625007600.0
1914,3,2,2021-07-01,0,0,1,1,2021-07-01,1625094000.0
1915,3,2,2021-07-02,0,0,1,1,2021-07-02,1625180400.0
1916,3,2,2021-07-03,0,0,1,1,2021-07-03,1625266800.0
1917,3,2,2021-07-04,0,0,1,1,2021-07-04,1625353200.0
1918,3,2,2021-07-05,0,0,1,1,2021-07-05,1625439600.0
1919,3,2,2021-07-06,0,0,1,1,2021-07-06,1625526000.0
1920,3,3,2020-12-27,0,0,0,0,2020-12-27,1609023600.0
1921,3,3,2020-12-28,0,0,0,0,2020-12-28,1609110000.0
1922,3,3,2020-12-29,0,0,0,0,2020-12-29,1609196400.0
1923,3,3,2020-12-30,0,0,0,0,2020-12-30,1609282800.0
1924,3,3,2020-12-31,0,0,0,0,2020-12-31,1609369200.0
1925,3,3,2021-01-01,0,0,0,0,2021-01-01,1609455600.0
1926,3,3,2021-01-02,0,0,0,0,2021-01-02,1609542000.0
1927,3,3,2021-01-03,0,0,0,0,2021-01-03,1609628400.0
1928,3,3,2021-01-04,0,0,0,0,2021-01-04,1609714800.0
1929,3,3,2021-01-05,0,0,0,0,2021-01-05,1609801200.0
1930,3,3,2021-01-06,0,0,0,0,2021-01-06,1609887600.0
1931,3,3,2021-01-07,0,0,0,0,2021-01-07,1609974000.0
1932,3,3,2021-01-08,0,0,0,0,2021-01-08,1610060400.0
1933,3,3,2021-01-09,0,0,0,0,2021-01-09,1610146800.0
1934,3,3,2021-01-10,0,0,0,0,2021-01-10,1610233200.0
1935,3,3,2021-01-11,0,0,0,0,2021-01-11,1610319600.0
1936,3,3,2021-01-12,0,0,0,0,2021-01-12,1610406000.0
1937,3,3,2021-01-13,0,0,0,0,2021-01-13,1610492400.0
1938,3,3,2021-01-14,0,0,0,0,2021-01-14,1610578800.0
1939,3,3,2021-01-15,0,0,0,0,2021-01-15,1610665200.0
1940,3,3,2021-01-16,0,0,0,0,2021-01-16,1610751600.0
1941,3,3,2021-01-17,0,0,0,0,2021-01-17,1610838000.0
1942,3,3,2021-01-18,0,0,0,0,2021-01-18,1610924400.0
1943,3,3,2021-01-19,0,0,0,0,2021-01-19,1611010800.0
1944,3,3,2021-01-20,0,0,0,0,2021-01-20,1611097200.0
1945,3,3,2021-01-21,0,0,0,0,2021-01-21,1611183600.0
1946,3,3,2021-01-22,0,0,0,0,2021-01-22,1611270000.0
1947,3,3,2021-01-23,0,0,0,0,2021-01-23,1611356400.0
1948,3,3,2021-01-24,0,0,0,0,2021-01-24,1611442800.0
1949,3,3,2021-01-25,0,0,0,0,2021-01-25,1611529200.0
1950,3,3,2021-01-26,0,0,0,0,2021-01-26,1611615600.0
1951,3,3,2021-01-27,0,0,0,0,2021-01-27,1611702000.0
1952,3,3,2021-01-28,0,0,0,0,2021-01-28,1611788400.0
1953,3,3,2021-01-29,0,0,0,0,2021-01-29,1611874800.0
1954,3,3,2021-01-30,0,0,0,0,2021-01-30,1611961200.0
1955,3,3,2021-01-31,0,0,0,0,2021-01-31,1612047600.0
1956,3,3,2021-02-01,0,0,0,0,2021-02-01,1612134000.0
1957,3,3,2021-02-02,0,0,0,0,2021-02-02,1612220400.0
1958,3,3,2021-02-03,0,0,0,0,2021-02-03,1612306800.0
1959,3,3,2021-02-04,0,0,0,0,2021-02-04,1612393200.0
1960,3,3,2021-02-05,0,0,0,0,2021-02-05,1612479600.0
1961,3,3,2021-02-06,0,0,0,0,2021-02-06,1612566000.0
1962,3,3,2021-02-07,0,0,0,0,2021-02-07,1612652400.0
1963,3,3,2021-02-08,0,0,0,0,2021-02-08,1612738800.0
1964,3,3,2021-02-09,0,0,0,0,2021-02-09,1612825200.0
1965,3,3,2021-02-10,0,0,0,0,2021-02-10,1612911600.0
1966,3,3,2021-02-11,0,0,0,0,2021-02-11,1612998000.0
1967,3,3,2021-02-12,0,0,0,0,2021-02-12,1613084400.0
1968,3,3,2021-02-13,0,0,0,0,2021-02-13,1613170800.0
1969,3,3,2021-02-14,0,0,0,0,2021-02-14,1613257200.0
1970,3,3,2021-02-15,0,0,0,0,2021-02-15,1613343600.0
1971,3,3,2021-02-16,0,0,0,0,2021-02-16,1613430000.0
1972,3,3,2021-02-17,0,0,0,0,2021-02-17,1613516400.0
1973,3,3,2021-02-18,0,0,0,0,2021-02-18,1613602800.0
1974,3,3,2021-02-19,0,0,0,0,2021-02-19,1613689200.0
1975,3,3,2021-02-20,0,0,0,0,2021-02-20,1613775600.0
1976,3,3,2021-02-21,0,0,0,0,2021-02-21,1613862000.0
1977,3,3,2021-02-22,0,0,0,0,2021-02-22,1613948400.0
1978,3,3,2021-02-23,0,0,0,0,2021-02-23,1614034800.0
1979,3,3,2021-02-24,0,0,0,0,2021-02-24,1614121200.0
1980,3,3,2021-02-25,0,0,0,0,2021-02-25,1614207600.0
1981,3,3,2021-02-26,0,0,0,0,2021-02-26,1614294000.0
1982,3,3,2021-02-27,0,0,0,0,2021-02-27,1614380400.0
1983,3,3,2021-02-28,0,0,0,0,2021-02-28,1614466800.0
1984,3,3,2021-03-01,1,0,1,0,2021-03-01,1614553200.0
1985,3,3,2021-03-02,0,0,1,0,2021-03-02,1614639600.0
1986,3,3,2021-03-03,0,0,1,0,2021-03-03,1614726000.0
1987,3,3,2021-03-04,0,0,1,0,2021-03-04,1614812400.0
1988,3,3,2021-03-05,0,0,1,0,2021-03-05,1614898800.0
1989,3,3,2021-03-06,0,0,1,0,2021-03-06,1614985200.0
1990,3,3,2021-03-07,0,0,1,0,2021-03-07,1615071600.0
1991,3,3,2021-03-08,1,0,2,0,2021-03-08,1615158000.0
1992,3,3,2021-03-09,0,0,2,0,2021-03-09,1615244400.0
1993,3,3,2021-03-10,0,0,2,0,2021-03-10,1615330800.0
1994,3,3,2021-03-11,0,0,2,0,2021-03-11,1615417200.0
1995,3,3,2021-03-12,0,0,2,0,2021-03-12,1615503600.0
1996,3,3,2021-03-13,0,0,2,0,2021-03-13,1615590000.0
1997,3,3,2021-03-14,0,0,2,0,2021-03-14,1615676400.0
1998,3,3,2021-03-15,0,0,2,0,2021-03-15,1615762800.0
1999,3,3,2021-03-16,0,0,2,0,2021-03-16,1615849200.0
2000,3,3,2021-03-17,0,0,2,0,2021-03-17,1615935600.0
2001,3,3,2021-03-18,0,0,2,0,2021-03-18,1616022000.0
2002,3,3,2021-03-19,0,0,2,0,2021-03-19,1616108400.0
2003,3,3,2021-03-20,0,0,2,0,2021-03-20,1616194800.0
2004,3,3,2021-03-21,0,0,2,0,2021-03-21,1616281200.0
2005,3,3,2021-03-22,0,0,2,0,2021-03-22,1616367600.0
2006,3,3,2021-03-23,0,0,2,0,2021-03-23,1616454000.0
2007,3,3,2021-03-24,1,0,3,0,2021-03-24,1616540400.0
2008,3,3,2021-03-25,0,0,3,0,2021-03-25,1616626800.0
2009,3,3,2021-03-26,0,0,3,0,2021-03-26,1616713200.0
2010,3,3,2021-03-27,0,0,3,0,2021-03-27,1616799600.0
2011,3,3,2021-03-28,0,0,3,0,2021-03-28,1616886000.0
2012,3,3,2021-03-29,0,0,3,0,2021-03-29,1616972400.0
2013,3,3,2021-03-30,0,0,3,0,2021-03-30,1617058800.0
2014,3,3,2021-03-31,0,0,3,0,2021-03-31,1617145200.0
2015,3,3,2021-04-01,0,0,3,0,2021-04-01,1617231600.0
2016,3,3,2021-04-02,0,0,3,0,2021-04-02,1617318000.0
2017,3,3,2021-04-03,0,0,3,0,2021-04-03,1617404400.0
2018,3,3,2021-04-04,0,0,3,0,2021-04-04,1617490800.0
2019,3,3,2021-04-05,0,0,3,0,2021-04-05,1617577200.0
2020,3,3,2021-04-06,0,0,3,0,2021-04-06,1617663600.0
2021,3,3,2021-04-07,0,0,3,0,2021-04-07,1617750000.0
2022,3,3,2021-04-08,1,0,4,0,2021-04-08,1617836400.0
2023,3,3,2021-04-09,0,0,4,0,2021-04-09,1617922800.0
2024,3,3,2021-04-10,0,0,4,0,2021-04-10,1618009200.0
2025,3,3,2021-04-11,1,0,5,0,2021-04-11,1618095600.0
2026,3,3,2021-04-12,0,0,5,0,2021-04-12,1618185600.0
2027,3,3,2021-04-13,0,0,5,0,2021-04-13,1618272000.0
2028,3,3,2021-04-14,0,0,5,0,2021-04-14,1618358400.0
2029,3,3,2021-04-15,0,0,5,0,2021-04-15,1618444800.0
2030,3,3,2021-04-16,0,0,5,0,2021-04-16,1618531200.0
2031,3,3,2021-04-17,0,0,5,0,2021-04-17,1618617600.0
2032,3,3,2021-04-18,0,0,5,0,2021-04-18,1618704000.0
2033,3,3,2021-04-19,0,0,5,0,2021-04-19,1618790400.0
2034,3,3,2021-04-20,0,0,5,0,2021-04-20,1618876800.0
2035,3,3,2021-04-21,0,0,5,0,2021-04-21,1618963200.0
2036,3,3,2021-04-22,0,0,5,0,2021-04-22,1619049600.0
2037,3,3,2021-04-23,0,0,5,0,2021-04-23,1619136000.0
2038,3,3,2021-04-24,0,0,5,0,2021-04-24,1619222400.0
2039,3,3,2021-04-25,0,0,5,0,2021-04-25,1619308800.0
2040,3,3,2021-04-26,0,0,5,0,2021-04-26,1619395200.0
2041,3,3,2021-04-27,0,0,5,0,2021-04-27,1619481600.0
2042,3,3,2021-04-28,0,0,5,0,2021-04-28,1619568000.0
2043,3,3,2021-04-29,0,0,5,0,2021-04-29,1619654400.0
2044,3,3,2021-04-30,0,0,5,0,2021-04-30,1619740800.0
2045,3,3,2021-05-01,0,0,5,0,2021-05-01,1619827200.0
2046,3,3,2021-05-02,0,0,5,0,2021-05-02,1619913600.0
2047,3,3,2021-05-03,0,0,5,0,2021-05-03,1620000000.0
2048,3,3,2021-05-04,0,0,5,0,2021-05-04,1620086400.0
2049,3,3,2021-05-05,1,0,6,0,2021-05-05,1620172800.0
2050,3,3,2021-05-06,0,0,6,0,2021-05-06,1620259200.0
2051,3,3,2021-05-07,0,0,6,0,2021-05-07,1620345600.0
2052,3,3,2021-05-08,0,0,6,0,2021-05-08,1620432000.0
2053,3,3,2021-05-09,0,0,6,0,2021-05-09,1620518400.0
2054,3,3,2021-05-10,0,0,6,0,2021-05-10,1620604800.0
2055,3,3,2021-05-11,0,0,6,0,2021-05-11,1620691200.0
2056,3,3,2021-05-12,0,0,6,0,2021-05-12,1620777600.0
2057,3,3,2021-05-13,0,0,6,0,2021-05-13,1620864000.0
2058,3,3,2021-05-14,0,0,6,0,2021-05-14,1620950400.0
2059,3,3,2021-05-15,0,0,6,0,2021-05-15,1621036800.0
2060,3,3,2021-05-16,0,0,6,0,2021-05-16,1621123200.0
2061,3,3,2021-05-17,0,0,6,0,2021-05-17,1621206000.0
2062,3,3,2021-05-18,0,0,6,0,2021-05-18,1621292400.0
2063,3,3,2021-05-19,0,0,6,0,2021-05-19,1621378800.0
2064,3,3,2021-05-20,0,0,6,0,2021-05-20,1621465200.0
2065,3,3,2021-05-21,0,0,6,0,2021-05-21,1621551600.0
2066,3,3,2021-05-22,0,0,6,0,2021-05-22,1621638000.0
2067,3,3,2021-05-23,0,0,6,0,2021-05-23,1621724400.0
2068,3,3,2021-05-24,0,0,6,0,2021-05-24,1621810800.0
2069,3,3,2021-05-25,0,0,6,0,2021-05-25,1621897200.0
2070,3,3,2021-05-26,0,0,6,0,2021-05-26,1621983600.0
2071,3,3,2021-05-27,0,0,6,0,2021-05-27,1622070000.0
2072,3,3,2021-05-28,0,0,6,0,2021-05-28,1622156400.0
2073,3,3,2021-05-29,0,0,6,0,2021-05-29,1622242800.0
2074,3,3,2021-05-30,0,0,6,0,2021-05-30,1622329200.0
2075,3,3,2021-05-31,0,0,6,0,2021-05-31,1622415600.0
2076,3,3,2021-06-01,0,0,6,0,2021-06-01,1622502000.0
2077,3,3,2021-06-02,0,0,6,0,2021-06-02,1622588400.0
2078,3,3,2021-06-03,0,0,6,0,2021-06-03,1622674800.0
2079,3,3,2021-06-04,0,0,6,0,2021-06-04,1622761200.0
2080,3,3,2021-06-05,0,0,6,0,2021-06-05,1622847600.0
2081,3,3,2021-06-06,0,0,6,0,2021-06-06,1622934000.0
2082,3,3,2021-06-07,0,0,6,0,2021-06-07,1623020400.0
2083,3,3,2021-06-08,0,0,6,0,2021-06-08,1623106800.0
2084,3,3,2021-06-09,0,0,6,0,2021-06-09,1623193200.0
2085,3,3,2021-06-10,0,0,6,0,2021-06-10,1623279600.0
2086,3,3,2021-06-11,0,0,6,0,2021-06-11,1623366000.0
2087,3,3,2021-06-12,0,0,6,0,2021-06-12,1623452400.0
2088,3,3,2021-06-13,0,0,6,0,2021-06-13,1623538800.0
2089,3,3,2021-06-14,0,0,6,0,2021-06-14,1623625200.0
2090,3,3,2021-06-15,0,0,6,0,2021-06-15,1623711600.0
2091,3,3,2021-06-16,0,0,6,0,2021-06-16,1623798000.0
2092,3,3,2021-06-17,0,1,6,1,2021-06-17,1623884400.0
2093,3,3,2021-06-18,0,0,6,1,2021-06-18,1623970800.0
2094,3,3,2021-06-19,0,0,6,1,2021-06-19,1624057200.0
2095,3,3,2021-06-20,0,0,6,1,2021-06-20,1624143600.0
2096,3,3,2021-06-21,0,0,6,1,2021-06-21,1624230000.0
2097,3,3,2021-06-22,0,0,6,1,2021-06-22,1624316400.0
2098,3,3,2021-06-23,0,1,6,2,2021-06-23,1624402800.0
2099,3,3,2021-06-24,0,0,6,2,2021-06-24,1624489200.0
2100,3,3,2021-06-25,0,0,6,2,2021-06-25,1624575600.0
2101,3,3,2021-06-26,0,0,6,2,2021-06-26,1624662000.0
2102,3,3,2021-06-27,0,0,6,2,2021-06-27,1624748400.0
2103,3,3,2021-06-28,0,0,6,2,2021-06-28,1624834800.0
2104,3,3,2021-06-29,0,0,6,2,2021-06-29,1624921200.0
2105,3,3,2021-06-30,0,0,6,2,2021-06-30,1625007600.0
2106,3,3,2021-07-01,0,0,6,2,2021-07-01,1625094000.0
2107,3,3,2021-07-02,0,0,6,2,2021-07-02,1625180400.0
2108,3,3,2021-07-03,0,0,6,2,2021-07-03,1625266800.0
2109,3,3,2021-07-04,0,0,6,2,2021-07-04,1625353200.0
2110,3,3,2021-07-05,0,0,6,2,2021-07-05,1625439600.0
2111,3,3,2021-07-06,0,0,6,2,2021-07-06,1625526000.0
2112,3,4,2020-12-27,0,0,0,0,2020-12-27,1609023600.0
2113,3,4,2020-12-28,0,0,0,0,2020-12-28,1609110000.0
2114,3,4,2020-12-29,0,0,0,0,2020-12-29,1609196400.0
2115,3,4,2020-12-30,0,0,0,0,2020-12-30,1609282800.0
2116,3,4,2020-12-31,0,0,0,0,2020-12-31,1609369200.0
2117,3,4,2021-01-01,0,0,0,0,2021-01-01,1609455600.0
2118,3,4,2021-01-02,0,0,0,0,2021-01-02,1609542000.0
2119,3,4,2021-01-03,0,0,0,0,2021-01-03,1609628400.0
2120,3,4,2021-01-04,0,0,0,0,2021-01-04,1609714800.0
2121,3,4,2021-01-05,0,0,0,0,2021-01-05,1609801200.0
2122,3,4,2021-01-06,0,0,0,0,2021-01-06,1609887600.0
2123,3,4,2021-01-07,0,0,0,0,2021-01-07,1609974000.0
2124,3,4,2021-01-08,0,0,0,0,2021-01-08,1610060400.0
2125,3,4,2021-01-09,0,0,0,0,2021-01-09,1610146800.0
2126,3,4,2021-01-10,0,0,0,0,2021-01-10,1610233200.0
2127,3,4,2021-01-11,0,0,0,0,2021-01-11,1610319600.0
2128,3,4,2021-01-12,0,0,0,0,2021-01-12,1610406000.0
2129,3,4,2021-01-13,0,0,0,0,2021-01-13,1610492400.0
2130,3,4,2021-01-14,0,0,0,0,2021-01-14,1610578800.0
2131,3,4,2021-01-15,0,0,0,0,2021-01-15,1610665200.0
2132,3,4,2021-01-16,0,0,0,0,2021-01-16,1610751600.0
2133,3,4,2021-01-17,0,0,0,0,2021-01-17,1610838000.0
2134,3,4,2021-01-18,0,0,0,0,2021-01-18,1610924400.0
2135,3,4,2021-01-19,0,0,0,0,2021-01-19,1611010800.0
2136,3,4,2021-01-20,0,0,0,0,2021-01-20,1611097200.0
2137,3,4,2021-01-21,0,0,0,0,2021-01-21,1611183600.0
2138,3,4,2021-01-22,0,0,0,0,2021-01-22,1611270000.0
2139,3,4,2021-01-23,0,0,0,0,2021-01-23,1611356400.0
2140,3,4,2021-01-24,0,0,0,0,2021-01-24,1611442800.0
2141,3,4,2021-01-25,0,0,0,0,2021-01-25,1611529200.0
2142,3,4,2021-01-26,0,0,0,0,2021-01-26,1611615600.0
2143,3,4,2021-01-27,0,0,0,0,2021-01-27,1611702000.0
2144,3,4,2021-01-28,0,0,0,0,2021-01-28,1611788400.0
2145,3,4,2021-01-29,0,0,0,0,2021-01-29,1611874800.0
2146,3,4,2021-01-30,0,0,0,0,2021-01-30,1611961200.0
2147,3,4,2021-01-31,0,0,0,0,2021-01-31,1612047600.0
2148,3,4,2021-02-01,0,0,0,0,2021-02-01,1612134000.0
2149,3,4,2021-02-02,0,0,0,0,2021-02-02,1612220400.0
2150,3,4,2021-02-03,0,0,0,0,2021-02-03,1612306800.0
2151,3,4,2021-02-04,0,0,0,0,2021-02-04,1612393200.0
2152,3,4,2021-02-05,0,0,0,0,2021-02-05,1612479600.0
2153,3,4,2021-02-06,0,0,0,0,2021-02-06,1612566000.0
2154,3,4,2021-02-07,0,0,0,0,2021-02-07,1612652400.0
2155,3,4,2021-02-08,0,0,0,0,2021-02-08,1612738800.0
2156,3,4,2021-02-09,0,0,0,0,2021-02-09,1612825200.0
2157,3,4,2021-02-10,0,0,0,0,2021-02-10,1612911600.0
2158,3,4,2021-02-11,0,0,0,0,2021-02-11,1612998000.0
2159,3,4,2021-02-12,0,0,0,0,2021-02-12,1613084400.0
2160,3,4,2021-02-13,0,0,0,0,2021-02-13,1613170800.0
2161,3,4,2021-02-14,0,0,0,0,2021-02-14,1613257200.0
2162,3,4,2021-02-15,0,0,0,0,2021-02-15,1613343600.0
2163,3,4,2021-02-16,0,0,0,0,2021-02-16,1613430000.0
2164,3,4,2021-02-17,0,0,0,0,2021-02-17,1613516400.0
2165,3,4,2021-02-18,0,0,0,0,2021-02-18,1613602800.0
2166,3,4,2021-02-19,0,0,0,0,2021-02-19,1613689200.0
2167,3,4,2021-02-20,0,0,0,0,2021-02-20,1613775600.0
2168,3,4,2021-02-21,0,0,0,0,2021-02-21,1613862000.0
2169,3,4,2021-02-22,0,0,0,0,2021-02-22,1613948400.0
2170,3,4,2021-02-23,0,0,0,0,2021-02-23,1614034800.0
2171,3,4,2021-02-24,0,0,0,0,2021-02-24,1614121200.0
2172,3,4,2021-02-25,0,0,0,0,2021-02-25,1614207600.0
2173,3,4,2021-02-26,0,0,0,0,2021-02-26,1614294000.0
2174,3,4,2021-02-27,0,0,0,0,2021-02-27,1614380400.0
2175,3,4,2021-02-28,0,0,0,0,2021-02-28,1614466800.0
2176,3,4,2021-03-01,0,0,0,0,2021-03-01,1614553200.0
2177,3,4,2021-03-02,0,0,0,0,2021-03-02,1614639600.0
2178,3,4,2021-03-03,0,0,0,0,2021-03-03,1614726000.0
2179,3,4,2021-03-04,0,0,0,0,2021-03-04,1614812400.0
2180,3,4,2021-03-05,0,0,0,0,2021-03-05,1614898800.0
2181,3,4,2021-03-06,0,0,0,0,2021-03-06,1614985200.0
2182,3,4,2021-03-07,0,0,0,0,2021-03-07,1615071600.0
2183,3,4,2021-03-08,0,0,0,0,2021-03-08,1615158000.0
2184,3,4,2021-03-09,0,0,0,0,2021-03-09,1615244400.0
2185,3,4,2021-03-10,0,0,0,0,2021-03-10,1615330800.0
2186,3,4,2021-03-11,0,0,0,0,2021-03-11,1615417200.0
2187,3,4,2021-03-12,0,0,0,0,2021-03-12,1615503600.0
2188,3,4,2021-03-13,0,0,0,0,2021-03-13,1615590000.0
2189,3,4,2021-03-14,0,0,0,0,2021-03-14,1615676400.0
2190,3,4,2021-03-15,0,0,0,0,2021-03-15,1615762800.0
2191,3,4,2021-03-16,0,0,0,0,2021-03-16,1615849200.0
2192,3,4,2021-03-17,0,0,0,0,2021-03-17,1615935600.0
2193,3,4,2021-03-18,0,0,0,0,2021-03-18,1616022000.0
2194,3,4,2021-03-19,0,0,0,0,2021-03-19,1616108400.0
2195,3,4,2021-03-20,0,0,0,0,2021-03-20,1616194800.0
2196,3,4,2021-03-21,0,0,0,0,2021-03-21,1616281200.0
2197,3,4,2021-03-22,0,0,0,0,2021-03-22,1616367600.0
2198,3,4,2021-03-23,0,0,0,0,2021-03-23,1616454000.0
2199,3,4,2021-03-24,0,0,0,0,2021-03-24,1616540400.0
2200,3,4,2021-03-25,0,0,0,0,2021-03-25,1616626800.0
2201,3,4,2021-03-26,0,0,0,0,2021-03-26,1616713200.0
2202,3,4,2021-03-27,0,0,0,0,2021-03-27,1616799600.0
2203,3,4,2021-03-28,0,0,0,0,2021-03-28,1616886000.0
2204,3,4,2021-03-29,0,0,0,0,2021-03-29,1616972400.0
2205,3,4,2021-03-30,0,0,0,0,2021-03-30,1617058800.0
2206,3,4,2021-03-31,0,0,0,0,2021-03-31,1617145200.0
2207,3,4,2021-04-01,0,0,0,0,2021-04-01,1617231600.0
2208,3,4,2021-04-02,0,0,0,0,2021-04-02,1617318000.0
2209,3,4,2021-04-03,0,0,0,0,2021-04-03,1617404400.0
2210,3,4,2021-04-04,0,0,0,0,2021-04-04,1617490800.0
2211,3,4,2021-04-05,0,0,0,0,2021-04-05,1617577200.0
2212,3,4,2021-04-06,0,0,0,0,2021-04-06,1617663600.0
2213,3,4,2021-04-07,0,0,0,0,2021-04-07,1617750000.0
2214,3,4,2021-04-08,0,0,0,0,2021-04-08,1617836400.0
2215,3,4,2021-04-09,0,0,0,0,2021-04-09,1617922800.0
2216,3,4,2021-04-10,0,0,0,0,2021-04-10,1618009200.0
2217,3,4,2021-04-11,0,0,0,0,2021-04-11,1618095600.0
2218,3,4,2021-04-12,0,0,0,0,2021-04-12,1618185600.0
2219,3,4,2021-04-13,0,0,0,0,2021-04-13,1618272000.0
2220,3,4,2021-04-14,0,0,0,0,2021-04-14,1618358400.0
2221,3,4,2021-04-15,0,0,0,0,2021-04-15,1618444800.0
2222,3,4,2021-04-16,0,0,0,0,2021-04-16,1618531200.0
2223,3,4,2021-04-17,0,0,0,0,2021-04-17,1618617600.0
2224,3,4,2021-04-18,0,0,0,0,2021-04-18,1618704000.0
2225,3,4,2021-04-19,0,0,0,0,2021-04-19,1618790400.0
2226,3,4,2021-04-20,0,0,0,0,2021-04-20,1618876800.0
2227,3,4,2021-04-21,0,0,0,0,2021-04-21,1618963200.0
2228,3,4,2021-04-22,0,0,0,0,2021-04-22,1619049600.0
2229,3,4,2021-04-23,0,0,0,0,2021-04-23,1619136000.0
2230,3,4,2021-04-24,0,0,0,0,2021-04-24,1619222400.0
2231,3,4,2021-04-25,0,0,0,0,2021-04-25,1619308800.0
2232,3,4,2021-04-26,0,0,0,0,2021-04-26,1619395200.0
2233,3,4,2021-04-27,0,0,0,0,2021-04-27,1619481600.0
2234,3,4,2021-04-28,0,0,0,0,2021-04-28,1619568000.0
2235,3,4,2021-04-29,0,0,0,0,2021-04-29,1619654400.0
2236,3,4,2021-04-30,0,0,0,0,2021-04-30,1619740800.0
2237,3,4,2021-05-01,0,0,0,0,2021-05-01,1619827200.0
2238,3,4,2021-05-02,0,0,0,0,2021-05-02,1619913600.0
2239,3,4,2021-05-03,0,0,0,0,2021-05-03,1620000000.0
2240,3,4,2021-05-04,0,0,0,0,2021-05-04,1620086400.0
2241,3,4,2021-05-05,0,0,0,0,2021-05-05,1620172800.0
2242,3,4,2021-05-06,0,0,0,0,2021-05-06,1620259200.0
2243,3,4,2021-05-07,0,0,0,0,2021-05-07,1620345600.0
2244,3,4,2021-05-08,0,0,0,0,2021-05-08,1620432000.0
2245,3,4,2021-05-09,0,0,0,0,2021-05-09,1620518400.0
2246,3,4,2021-05-10,0,0,0,0,2021-05-10,1620604800.0
2247,3,4,2021-05-11,0,0,0,0,2021-05-11,1620691200.0
2248,3,4,2021-05-12,0,0,0,0,2021-05-12,1620777600.0
2249,3,4,2021-05-13,0,0,0,0,2021-05-13,1620864000.0
2250,3,4,2021-05-14,0,0,0,0,2021-05-14,1620950400.0
2251,3,4,2021-05-15,0,0,0,0,2021-05-15,1621036800.0
2252,3,4,2021-05-16,0,0,0,0,2021-05-16,1621123200.0
2253,3,4,2021-05-17,0,0,0,0,2021-05-17,1621206000.0
2254,3,4,2021-05-18,0,0,0,0,2021-05-18,1621292400.0
2255,3,4,2021-05-19,0,0,0,0,2021-05-19,1621378800.0
2256,3,4,2021-05-20,0,0,0,0,2021-05-20,1621465200.0
2257,3,4,2021-05-21,0,0,0,0,2021-05-21,1621551600.0
2258,3,4,2021-05-22,0,0,0,0,2021-05-22,1621638000.0
2259,3,4,2021-05-23,0,0,0,0,2021-05-23,1621724400.0
2260,3,4,2021-05-24,0,0,0,0,2021-05-24,1621810800.0
2261,3,4,2021-05-25,0,0,0,0,2021-05-25,1621897200.0
2262,3,4,2021-05-26,0,0,0,0,2021-05-26,1621983600.0
2263,3,4,2021-05-27,0,0,0,0,2021-05-27,1622070000.0
2264,3,4,2021-05-28,0,0,0,0,2021-05-28,1622156400.0
2265,3,4,2021-05-29,0,0,0,0,2021-05-29,1622242800.0
2266,3,4,2021-05-30,0,0,0,0,2021-05-30,1622329200.0
2267,3,4,2021-05-31,0,0,0,0,2021-05-31,1622415600.0
2268,3,4,2021-06-01,0,0,0,0,2021-06-01,1622502000.0
2269,3,4,2021-06-02,0,0,0,0,2021-06-02,1622588400.0
2270,3,4,2021-06-03,0,0,0,0,2021-06-03,1622674800.0
2271,3,4,2021-06-04,0,0,0,0,2021-06-04,1622761200.0
2272,3,4,2021-06-05,0,0,0,0,2021-06-05,1622847600.0
2273,3,4,2021-06-06,0,0,0,0,2021-06-06,1622934000.0
2274,3,4,2021-06-07,0,0,0,0,2021-06-07,1623020400.0
2275,3,4,2021-06-08,0,0,0,0,2021-06-08,1623106800.0
2276,3,4,2021-06-09,0,0,0,0,2021-06-09,1623193200.0
2277,3,4,2021-06-10,0,0,0,0,2021-06-10,1623279600.0
2278,3,4,2021-06-11,0,0,0,0,2021-06-11,1623366000.0
2279,3,4,2021-06-12,0,0,0,0,2021-06-12,1623452400.0
2280,3,4,2021-06-13,0,0,0,0,2021-06-13,1623538800.0
2281,3,4,2021-06-14,0,0,0,0,2021-06-14,1623625200.0
2282,3,4,2021-06-15,0,0,0,0,2021-06-15,1623711600.0
2283,3,4,2021-06-16,0,0,0,0,2021-06-16,1623798000.0
2284,3,4,2021-06-17,0,0,0,0,2021-06-17,1623884400.0
2285,3,4,2021-06-18,0,0,0,0,2021-06-18,1623970800.0
2286,3,4,2021-06-19,0,0,0,0,2021-06-19,1624057200.0
2287,3,4,2021-06-20,0,0,0,0,2021-06-20,1624143600.0
2288,3,4,2021-06-21,0,0,0,0,2021-06-21,1624230000.0
2289,3,4,2021-06-22,0,0,0,0,2021-06-22,1624316400.0
2290,3,4,2021-06-23,0,0,0,0,2021-06-23,1624402800.0
2291,3,4,2021-06-24,0,0,0,0,2021-06-24,1624489200.0
2292,3,4,2021-06-25,0,0,0,0,2021-06-25,1624575600.0
2293,3,4,2021-06-26,0,0,0,0,2021-06-26,1624662000.0
2294,3,4,2021-06-27,0,0,0,0,2021-06-27,1624748400.0
2295,3,4,2021-06-28,0,0,0,0,2021-06-28,1624834800.0
2296,3,4,2021-06-29,0,0,0,0,2021-06-29,1624921200.0
2297,3,4,2021-06-30,0,0,0,0,2021-06-30,1625007600.0
2298,3,4,2021-07-01,0,0,0,0,2021-07-01,1625094000.0
2299,3,4,2021-07-02,0,0,0,0,2021-07-02,1625180400.0
2300,3,4,2021-07-03,0,0,0,0,2021-07-03,1625266800.0
2301,3,4,2021-07-04,0,0,0,0,2021-07-04,1625353200.0
2302,3,4,2021-07-05,0,0,0,0,2021-07-05,1625439600.0
2303,3,4,2021-07-06,0,0,0,0,2021-07-06,1625526000.0
2304,4,1,2020-12-27,0,0,0,0,2020-12-27,1609023600.0
2305,4,1,2020-12-28,0,0,0,0,2020-12-28,1609110000.0
2306,4,1,2020-12-29,0,0,0,0,2020-12-29,1609196400.0
2307,4,1,2020-12-30,0,0,0,0,2020-12-30,1609282800.0
2308,4,1,2020-12-31,0,0,0,0,2020-12-31,1609369200.0
2309,4,1,2021-01-01,1,0,1,0,2021-01-01,1609455600.0
2310,4,1,2021-01-02,0,0,1,0,2021-01-02,1609542000.0
2311,4,1,2021-01-03,0,0,1,0,2021-01-03,1609628400.0
2312,4,1,2021-01-04,0,0,1,0,2021-01-04,1609714800.0
2313,4,1,2021-01-05,2,0,3,0,2021-01-05,1609801200.0
2314,4,1,2021-01-06,0,0,3,0,2021-01-06,1609887600.0
2315,4,1,2021-01-07,0,0,3,0,2021-01-07,1609974000.0
2316,4,1,2021-01-08,0,0,3,0,2021-01-08,1610060400.0
2317,4,1,2021-01-09,1,0,4,0,2021-01-09,1610146800.0
2318,4,1,2021-01-10,0,0,4,0,2021-01-10,1610233200.0
2319,4,1,2021-01-11,0,0,4,0,2021-01-11,1610319600.0
2320,4,1,2021-01-12,0,0,4,0,2021-01-12,1610406000.0
2321,4,1,2021-01-13,0,0,4,0,2021-01-13,1610492400.0
2322,4,1,2021-01-14,0,0,4,0,2021-01-14,1610578800.0
2323,4,1,2021-01-15,332,0,336,0,2021-01-15,1610665200.0
2324,4,1,2021-01-16,27,0,363,0,2021-01-16,1610751600.0
2325,4,1,2021-01-17,0,0,363,0,2021-01-17,1610838000.0
2326,4,1,2021-01-18,49,0,412,0,2021-01-18,1610924400.0
2327,4,1,2021-01-19,393,0,805,0,2021-01-19,1611010800.0
2328,4,1,2021-01-20,481,0,1286,0,2021-01-20,1611097200.0
2329,4,1,2021-01-21,614,1,1900,1,2021-01-21,1611183600.0
2330,4,1,2021-01-22,409,0,2309,1,2021-01-22,1611270000.0
2331,4,1,2021-01-23,75,0,2384,1,2021-01-23,1611356400.0
2332,4,1,2021-01-24,0,0,2384,1,2021-01-24,1611442800.0
2333,4,1,2021-01-25,272,0,2656,1,2021-01-25,1611529200.0
2334,4,1,2021-01-26,429,0,3085,1,2021-01-26,1611615600.0
2335,4,1,2021-01-27,317,0,3402,1,2021-01-27,1611702000.0
2336,4,1,2021-01-28,407,0,3809,1,2021-01-28,1611788400.0
2337,4,1,2021-01-29,421,3,4230,4,2021-01-29,1611874800.0
2338,4,1,2021-01-30,419,0,4649,4,2021-01-30,1611961200.0
2339,4,1,2021-01-31,0,0,4649,4,2021-01-31,1612047600.0
2340,4,1,2021-02-01,371,3,5020,7,2021-02-01,1612134000.0
2341,4,1,2021-02-02,499,4,5519,11,2021-02-02,1612220400.0
2342,4,1,2021-02-03,602,13,6121,24,2021-02-03,1612306800.0
2343,4,1,2021-02-04,626,21,6747,45,2021-02-04,1612393200.0
2344,4,1,2021-02-05,564,98,7311,143,2021-02-05,1612479600.0
2345,4,1,2021-02-06,501,4,7812,147,2021-02-06,1612566000.0
2346,4,1,2021-02-07,0,8,7812,155,2021-02-07,1612652400.0
2347,4,1,2021-02-08,467,34,8279,189,2021-02-08,1612738800.0
2348,4,1,2021-02-09,784,90,9063,279,2021-02-09,1612825200.0
2349,4,1,2021-02-10,820,85,9883,364,2021-02-10,1612911600.0
2350,4,1,2021-02-11,796,85,10679,449,2021-02-11,1612998000.0
2351,4,1,2021-02-12,637,95,11316,544,2021-02-12,1613084400.0
2352,4,1,2021-02-13,651,74,11967,618,2021-02-13,1613170800.0
2353,4,1,2021-02-14,1,0,11968,618,2021-02-14,1613257200.0
2354,4,1,2021-02-15,524,124,12492,742,2021-02-15,1613343600.0
2355,4,1,2021-02-16,651,534,13143,1276,2021-02-16,1613430000.0
2356,4,1,2021-02-17,592,328,13735,1604,2021-02-17,1613516400.0
2357,4,1,2021-02-18,493,414,14228,2018,2021-02-18,1613602800.0
2358,4,1,2021-02-19,496,320,14724,2338,2021-02-19,1613689200.0
2359,4,1,2021-02-20,576,116,15300,2454,2021-02-20,1613775600.0
2360,4,1,2021-02-21,0,0,15300,2454,2021-02-21,1613862000.0
2361,4,1,2021-02-22,402,236,15702,2690,2021-02-22,1613948400.0
2362,4,1,2021-02-23,607,236,16309,2926,2021-02-23,1614034800.0
2363,4,1,2021-02-24,583,253,16892,3179,2021-02-24,1614121200.0
2364,4,1,2021-02-25,645,294,17537,3473,2021-02-25,1614207600.0
2365,4,1,2021-02-26,483,470,18020,3943,2021-02-26,1614294000.0
2366,4,1,2021-02-27,386,470,18406,4413,2021-02-27,1614380400.0
2367,4,1,2021-02-28,0,0,18406,4413,2021-02-28,1614466800.0
2368,4,1,2021-03-01,290,391,18696,4804,2021-03-01,1614553200.0
2369,4,1,2021-03-02,485,500,19181,5304,2021-03-02,1614639600.0
2370,4,1,2021-03-03,755,554,19936,5858,2021-03-03,1614726000.0
2371,4,1,2021-03-04,774,538,20710,6396,2021-03-04,1614812400.0
2372,4,1,2021-03-05,727,532,21437,6928,2021-03-05,1614898800.0
2373,4,1,2021-03-06,812,529,22249,7457,2021-03-06,1614985200.0
2374,4,1,2021-03-07,0,0,22249,7457,2021-03-07,1615071600.0
2375,4,1,2021-03-08,435,590,22684,8047,2021-03-08,1615158000.0
2376,4,1,2021-03-09,670,774,23354,8821,2021-03-09,1615244400.0
2377,4,1,2021-03-10,644,848,23998,9669,2021-03-10,1615330800.0
2378,4,1,2021-03-11,699,642,24697,10311,2021-03-11,1615417200.0
2379,4,1,2021-03-12,729,661,25426,10972,2021-03-12,1615503600.0
2380,4,1,2021-03-13,668,609,26094,11581,2021-03-13,1615590000.0
2381,4,1,2021-03-14,2,0,26096,11581,2021-03-14,1615676400.0
2382,4,1,2021-03-15,503,504,26599,12085,2021-03-15,1615762800.0
2383,4,1,2021-03-16,680,708,27279,12793,2021-03-16,1615849200.0
2384,4,1,2021-03-17,846,537,28125,13330,2021-03-17,1615935600.0
2385,4,1,2021-03-18,1021,551,29146,13881,2021-03-18,1616022000.0
2386,4,1,2021-03-19,784,541,29930,14422,2021-03-19,1616108400.0
2387,4,1,2021-03-20,576,595,30506,15017,2021-03-20,1616194800.0
2388,4,1,2021-03-21,0,0,30506,15017,2021-03-21,1616281200.0
2389,4,1,2021-03-22,565,478,31071,15495,2021-03-22,1616367600.0
2390,4,1,2021-03-23,780,634,31851,16129,2021-03-23,1616454000.0
2391,4,1,2021-03-24,792,667,32643,16796,2021-03-24,1616540400.0
2392,4,1,2021-03-25,929,548,33572,17344,2021-03-25,1616626800.0
2393,4,1,2021-03-26,921,441,34493,17785,2021-03-26,1616713200.0
2394,4,1,2021-03-27,782,337,35275,18122,2021-03-27,1616799600.0
2395,4,1,2021-03-28,1,0,35276,18122,2021-03-28,1616886000.0
2396,4,1,2021-03-29,961,269,36237,18391,2021-03-29,1616972400.0
2397,4,1,2021-03-30,883,498,37120,18889,2021-03-30,1617058800.0
2398,4,1,2021-03-31,740,669,37860,19558,2021-03-31,1617145200.0
2399,4,1,2021-04-01,716,707,38576,20265,2021-04-01,1617231600.0
2400,4,1,2021-04-02,688,758,39264,21023,2021-04-02,1617318000.0
2401,4,1,2021-04-03,699,699,39963,21722,2021-04-03,1617404400.0
2402,4,1,2021-04-04,0,0,39963,21722,2021-04-04,1617490800.0
2403,4,1,2021-04-05,0,2,39963,21724,2021-04-05,1617577200.0
2404,4,1,2021-04-06,794,634,40757,22358,2021-04-06,1617663600.0
2405,4,1,2021-04-07,1369,777,42126,23135,2021-04-07,1617750000.0
2406,4,1,2021-04-08,1792,775,43918,23910,2021-04-08,1617836400.0
2407,4,1,2021-04-09,1508,779,45426,24689,2021-04-09,1617922800.0
2408,4,1,2021-04-10,1137,649,46563,25338,2021-04-10,1618009200.0
2409,4,1,2021-04-11,2,0,46565,25338,2021-04-11,1618095600.0
2410,4,1,2021-04-12,1238,542,47803,25880,2021-04-12,1618185600.0
2411,4,1,2021-04-13,1440,745,49243,26625,2021-04-13,1618272000.0
2412,4,1,2021-04-14,2069,770,51312,27395,2021-04-14,1618358400.0
2413,4,1,2021-04-15,2504,939,53816,28334,2021-04-15,1618444800.0
2414,4,1,2021-04-16,1932,766,55748,29100,2021-04-16,1618531200.0
2415,4,1,2021-04-17,1289,595,57037,29695,2021-04-17,1618617600.0
2416,4,1,2021-04-18,0,0,57037,29695,2021-04-18,1618704000.0
2417,4,1,2021-04-19,1377,561,58414,30256,2021-04-19,1618790400.0
2418,4,1,2021-04-20,1649,792,60063,31048,2021-04-20,1618876800.0
2419,4,1,2021-04-21,2127,598,62190,31646,2021-04-21,1618963200.0
2420,4,1,2021-04-22,2946,780,65136,32426,2021-04-22,1619049600.0
2421,4,1,2021-04-23,2309,796,67445,33222,2021-04-23,1619136000.0
2422,4,1,2021-04-24,1102,790,68547,34012,2021-04-24,1619222400.0
2423,4,1,2021-04-25,2,0,68549,34012,2021-04-25,1619308800.0
2424,4,1,2021-04-26,1164,908,69713,34920,2021-04-26,1619395200.0
2425,4,1,2021-04-27,1683,1014,71396,35934,2021-04-27,1619481600.0
2426,4,1,2021-04-28,2897,716,74293,36650,2021-04-28,1619568000.0
2427,4,1,2021-04-29,3946,797,78239,37447,2021-04-29,1619654400.0
2428,4,1,2021-04-30,3432,879,81671,38326,2021-04-30,1619740800.0
2429,4,1,2021-05-01,2106,202,83777,38528,2021-05-01,1619827200.0
2430,4,1,2021-05-02,2,0,83779,38528,2021-05-02,1619913600.0
2431,4,1,2021-05-03,1865,542,85644,39070,2021-05-03,1620000000.0
2432,4,1,2021-05-04,2127,1072,87771,40142,2021-05-04,1620086400.0
2433,4,1,2021-05-05,3118,1607,90889,41749,2021-05-05,1620172800.0
2434,4,1,2021-05-06,4005,1562,94894,43311,2021-05-06,1620259200.0
2435,4,1,2021-05-07,3228,1502,98122,44813,2021-05-07,1620345600.0
2436,4,1,2021-05-08,1566,481,99688,45294,2021-05-08,1620432000.0
2437,4,1,2021-05-09,0,0,99688,45294,2021-05-09,1620518400.0
2438,4,1,2021-05-10,2411,976,102099,46270,2021-05-10,1620604800.0
2439,4,1,2021-05-11,3630,1583,105729,47853,2021-05-11,1620691200.0
2440,4,1,2021-05-12,4677,2310,110406,50163,2021-05-12,1620777600.0
2441,4,1,2021-05-13,3553,544,113959,50707,2021-05-13,1620864000.0
2442,4,1,2021-05-14,5189,2350,119148,53057,2021-05-14,1620950400.0
2443,4,1,2021-05-15,3141,1477,122289,54534,2021-05-15,1621036800.0
2444,4,1,2021-05-16,3,6,122292,54540,2021-05-16,1621123200.0
2445,4,1,2021-05-17,2926,1372,125218,55912,2021-05-17,1621206000.0
2446,4,1,2021-05-18,3590,1552,128808,57464,2021-05-18,1621292400.0
2447,4,1,2021-05-19,4570,2162,133378,59626,2021-05-19,1621378800.0
2448,4,1,2021-05-20,5048,2648,138426,62274,2021-05-20,1621465200.0
2449,4,1,2021-05-21,4830,2414,143256,64688,2021-05-21,1621551600.0
2450,4,1,2021-05-22,3282,1112,146538,65800,2021-05-22,1621638000.0
2451,4,1,2021-05-23,2,0,146540,65800,2021-05-23,1621724400.0
2452,4,1,2021-05-24,3589,966,150129,66766,2021-05-24,1621810800.0
2453,4,1,2021-05-25,3931,1511,154060,68277,2021-05-25,1621897200.0
2454,4,1,2021-05-26,4717,2604,158777,70881,2021-05-26,1621983600.0
2455,4,1,2021-05-27,4302,3688,163079,74569,2021-05-27,1622070000.0
2456,4,1,2021-05-28,4131,3497,167210,78066,2021-05-28,1622156400.0
2457,4,1,2021-05-29,2398,2256,169608,80322,2021-05-29,1622242800.0
2458,4,1,2021-05-30,6,13,169614,80335,2021-05-30,1622329200.0
2459,4,1,2021-05-31,2141,1988,171755,82323,2021-05-31,1622415600.0
2460,4,1,2021-06-01,2996,2342,174751,84665,2021-06-01,1622502000.0
2461,4,1,2021-06-02,3730,3044,178481,87709,2021-06-02,1622588400.0
2462,4,1,2021-06-03,3779,3326,182260,91035,2021-06-03,1622674800.0
2463,4,1,2021-06-04,3575,3409,185835,94444,2021-06-04,1622761200.0
2464,4,1,2021-06-05,2116,1799,187951,96243,2021-06-05,1622847600.0
2465,4,1,2021-06-06,1046,74,188997,96317,2021-06-06,1622934000.0
2466,4,1,2021-06-07,1840,2324,190837,98641,2021-06-07,1623020400.0
2467,4,1,2021-06-08,2311,3047,193148,101688,2021-06-08,1623106800.0
2468,4,1,2021-06-09,2804,4548,195952,106236,2021-06-09,1623193200.0
2469,4,1,2021-06-10,3208,4210,199160,110446,2021-06-10,1623279600.0
2470,4,1,2021-06-11,2679,4398,201839,114844,2021-06-11,1623366000.0
2471,4,1,2021-06-12,1572,3203,203411,118047,2021-06-12,1623452400.0
2472,4,1,2021-06-13,1279,184,204690,118231,2021-06-13,1623538800.0
2473,4,1,2021-06-14,1376,3029,206066,121260,2021-06-14,1623625200.0
2474,4,1,2021-06-15,1820,3330,207886,124590,2021-06-15,1623711600.0
2475,4,1,2021-06-16,2533,4393,210419,128983,2021-06-16,1623798000.0
2476,4,1,2021-06-17,2368,4700,212787,133683,2021-06-17,1623884400.0
2477,4,1,2021-06-18,2415,4674,215202,138357,2021-06-18,1623970800.0
2478,4,1,2021-06-19,1221,3407,216423,141764,2021-06-19,1624057200.0
2479,4,1,2021-06-20,603,235,217026,141999,2021-06-20,1624143600.0
2480,4,1,2021-06-21,1154,3087,218180,145086,2021-06-21,1624230000.0
2481,4,1,2021-06-22,1438,3538,219618,148624,2021-06-22,1624316400.0
2482,4,1,2021-06-23,2131,4786,221749,153410,2021-06-23,1624402800.0
2483,4,1,2021-06-24,2153,3874,223902,157284,2021-06-24,1624489200.0
2484,4,1,2021-06-25,2056,3918,225958,161202,2021-06-25,1624575600.0
2485,4,1,2021-06-26,1316,2598,227274,163800,2021-06-26,1624662000.0
2486,4,1,2021-06-27,607,199,227881,163999,2021-06-27,1624748400.0
2487,4,1,2021-06-28,1235,2351,229116,166350,2021-06-28,1624834800.0
2488,4,1,2021-06-29,1592,2637,230708,168987,2021-06-29,1624921200.0
2489,4,1,2021-06-30,2408,3613,233116,172600,2021-06-30,1625007600.0
2490,4,1,2021-07-01,2537,3613,235653,176213,2021-07-01,1625094000.0
2491,4,1,2021-07-02,2337,3467,237990,179680,2021-07-02,1625180400.0
2492,4,1,2021-07-03,1507,2309,239497,181989,2021-07-03,1625266800.0
2493,4,1,2021-07-04,820,965,240317,182954,2021-07-04,1625353200.0
2494,4,1,2021-07-05,1566,2036,241883,184990,2021-07-05,1625439600.0
2495,4,1,2021-07-06,2229,2284,244112,187274,2021-07-06,1625526000.0
2496,4,2,2020-12-27,0,0,0,0,2020-12-27,1609023600.0
2497,4,2,2020-12-28,0,0,0,0,2020-12-28,1609110000.0
2498,4,2,2020-12-29,0,0,0,0,2020-12-29,1609196400.0
2499,4,2,2020-12-30,0,0,0,0,2020-12-30,1609282800.0
2500,4,2,2020-12-31,0,0,0,0,2020-12-31,1609369200.0
2501,4,2,2021-01-01,0,0,0,0,2021-01-01,1609455600.0
2502,4,2,2021-01-02,0,0,0,0,2021-01-02,1609542000.0
2503,4,2,2021-01-03,0,0,0,0,2021-01-03,1609628400.0
2504,4,2,2021-01-04,0,0,0,0,2021-01-04,1609714800.0
2505,4,2,2021-01-05,0,0,0,0,2021-01-05,1609801200.0
2506,4,2,2021-01-06,0,0,0,0,2021-01-06,1609887600.0
2507,4,2,2021-01-07,0,0,0,0,2021-01-07,1609974000.0
2508,4,2,2021-01-08,0,0,0,0,2021-01-08,1610060400.0
2509,4,2,2021-01-09,0,0,0,0,2021-01-09,1610146800.0
2510,4,2,2021-01-10,0,0,0,0,2021-01-10,1610233200.0
2511,4,2,2021-01-11,0,0,0,0,2021-01-11,1610319600.0
2512,4,2,2021-01-12,0,0,0,0,2021-01-12,1610406000.0
2513,4,2,2021-01-13,0,0,0,0,2021-01-13,1610492400.0
2514,4,2,2021-01-14,0,0,0,0,2021-01-14,1610578800.0
2515,4,2,2021-01-15,0,0,0,0,2021-01-15,1610665200.0
2516,4,2,2021-01-16,0,0,0,0,2021-01-16,1610751600.0
2517,4,2,2021-01-17,0,0,0,0,2021-01-17,1610838000.0
2518,4,2,2021-01-18,0,0,0,0,2021-01-18,1610924400.0
2519,4,2,2021-01-19,0,0,0,0,2021-01-19,1611010800.0
2520,4,2,2021-01-20,0,0,0,0,2021-01-20,1611097200.0
2521,4,2,2021-01-21,0,0,0,0,2021-01-21,1611183600.0
2522,4,2,2021-01-22,0,0,0,0,2021-01-22,1611270000.0
2523,4,2,2021-01-23,0,0,0,0,2021-01-23,1611356400.0
2524,4,2,2021-01-24,0,0,0,0,2021-01-24,1611442800.0
2525,4,2,2021-01-25,0,0,0,0,2021-01-25,1611529200.0
2526,4,2,2021-01-26,0,0,0,0,2021-01-26,1611615600.0
2527,4,2,2021-01-27,0,0,0,0,2021-01-27,1611702000.0
2528,4,2,2021-01-28,0,0,0,0,2021-01-28,1611788400.0
2529,4,2,2021-01-29,0,0,0,0,2021-01-29,1611874800.0
2530,4,2,2021-01-30,0,0,0,0,2021-01-30,1611961200.0
2531,4,2,2021-01-31,0,0,0,0,2021-01-31,1612047600.0
2532,4,2,2021-02-01,1,0,1,0,2021-02-01,1612134000.0
2533,4,2,2021-02-02,0,0,1,0,2021-02-02,1612220400.0
2534,4,2,2021-02-03,0,0,1,0,2021-02-03,1612306800.0
2535,4,2,2021-02-04,0,0,1,0,2021-02-04,1612393200.0
2536,4,2,2021-02-05,0,0,1,0,2021-02-05,1612479600.0
2537,4,2,2021-02-06,0,0,1,0,2021-02-06,1612566000.0
2538,4,2,2021-02-07,0,0,1,0,2021-02-07,1612652400.0
2539,4,2,2021-02-08,0,0,1,0,2021-02-08,1612738800.0
2540,4,2,2021-02-09,0,0,1,0,2021-02-09,1612825200.0
2541,4,2,2021-02-10,0,0,1,0,2021-02-10,1612911600.0
2542,4,2,2021-02-11,0,0,1,0,2021-02-11,1612998000.0
2543,4,2,2021-02-12,0,0,1,0,2021-02-12,1613084400.0
2544,4,2,2021-02-13,0,0,1,0,2021-02-13,1613170800.0
2545,4,2,2021-02-14,0,0,1,0,2021-02-14,1613257200.0
2546,4,2,2021-02-15,0,0,1,0,2021-02-15,1613343600.0
2547,4,2,2021-02-16,0,0,1,0,2021-02-16,1613430000.0
2548,4,2,2021-02-17,0,0,1,0,2021-02-17,1613516400.0
2549,4,2,2021-02-18,0,0,1,0,2021-02-18,1613602800.0
2550,4,2,2021-02-19,0,0,1,0,2021-02-19,1613689200.0
2551,4,2,2021-02-20,0,0,1,0,2021-02-20,1613775600.0
2552,4,2,2021-02-21,0,0,1,0,2021-02-21,1613862000.0
2553,4,2,2021-02-22,0,0,1,0,2021-02-22,1613948400.0
2554,4,2,2021-02-23,0,0,1,0,2021-02-23,1614034800.0
2555,4,2,2021-02-24,0,0,1,0,2021-02-24,1614121200.0
2556,4,2,2021-02-25,0,0,1,0,2021-02-25,1614207600.0
2557,4,2,2021-02-26,0,0,1,0,2021-02-26,1614294000.0
2558,4,2,2021-02-27,0,0,1,0,2021-02-27,1614380400.0
2559,4,2,2021-02-28,0,0,1,0,2021-02-28,1614466800.0
2560,4,2,2021-03-01,0,0,1,0,2021-03-01,1614553200.0
2561,4,2,2021-03-02,0,0,1,0,2021-03-02,1614639600.0
2562,4,2,2021-03-03,0,0,1,0,2021-03-03,1614726000.0
2563,4,2,2021-03-04,0,0,1,0,2021-03-04,1614812400.0
2564,4,2,2021-03-05,0,0,1,0,2021-03-05,1614898800.0
2565,4,2,2021-03-06,0,0,1,0,2021-03-06,1614985200.0
2566,4,2,2021-03-07,0,0,1,0,2021-03-07,1615071600.0
2567,4,2,2021-03-08,0,0,1,0,2021-03-08,1615158000.0
2568,4,2,2021-03-09,0,0,1,0,2021-03-09,1615244400.0
2569,4,2,2021-03-10,0,0,1,0,2021-03-10,1615330800.0
2570,4,2,2021-03-11,0,0,1,0,2021-03-11,1615417200.0
2571,4,2,2021-03-12,0,0,1,0,2021-03-12,1615503600.0
2572,4,2,2021-03-13,0,0,1,0,2021-03-13,1615590000.0
2573,4,2,2021-03-14,0,0,1,0,2021-03-14,1615676400.0
2574,4,2,2021-03-15,1,0,2,0,2021-03-15,1615762800.0
2575,4,2,2021-03-16,0,0,2,0,2021-03-16,1615849200.0
2576,4,2,2021-03-17,0,0,2,0,2021-03-17,1615935600.0
2577,4,2,2021-03-18,0,0,2,0,2021-03-18,1616022000.0
2578,4,2,2021-03-19,0,0,2,0,2021-03-19,1616108400.0
2579,4,2,2021-03-20,0,0,2,0,2021-03-20,1616194800.0
2580,4,2,2021-03-21,0,0,2,0,2021-03-21,1616281200.0
2581,4,2,2021-03-22,0,0,2,0,2021-03-22,1616367600.0
2582,4,2,2021-03-23,0,0,2,0,2021-03-23,1616454000.0
2583,4,2,2021-03-24,0,0,2,0,2021-03-24,1616540400.0
2584,4,2,2021-03-25,0,0,2,0,2021-03-25,1616626800.0
2585,4,2,2021-03-26,0,0,2,0,2021-03-26,1616713200.0
2586,4,2,2021-03-27,0,0,2,0,2021-03-27,1616799600.0
2587,4,2,2021-03-28,0,0,2,0,2021-03-28,1616886000.0
2588,4,2,2021-03-29,0,0,2,0,2021-03-29,1616972400.0
2589,4,2,2021-03-30,0,0,2,0,2021-03-30,1617058800.0
2590,4,2,2021-03-31,0,0,2,0,2021-03-31,1617145200.0
2591,4,2,2021-04-01,0,0,2,0,2021-04-01,1617231600.0
2592,4,2,2021-04-02,0,0,2,0,2021-04-02,1617318000.0
2593,4,2,2021-04-03,0,0,2,0,2021-04-03,1617404400.0
2594,4,2,2021-04-04,0,0,2,0,2021-04-04,1617490800.0
2595,4,2,2021-04-05,0,0,2,0,2021-04-05,1617577200.0
2596,4,2,2021-04-06,1,0,3,0,2021-04-06,1617663600.0
2597,4,2,2021-04-07,0,0,3,0,2021-04-07,1617750000.0
2598,4,2,2021-04-08,0,0,3,0,2021-04-08,1617836400.0
2599,4,2,2021-04-09,0,0,3,0,2021-04-09,1617922800.0
2600,4,2,2021-04-10,0,0,3,0,2021-04-10,1618009200.0
2601,4,2,2021-04-11,0,0,3,0,2021-04-11,1618095600.0
2602,4,2,2021-04-12,0,0,3,0,2021-04-12,1618185600.0
2603,4,2,2021-04-13,0,0,3,0,2021-04-13,1618272000.0
2604,4,2,2021-04-14,0,0,3,0,2021-04-14,1618358400.0
2605,4,2,2021-04-15,0,0,3,0,2021-04-15,1618444800.0
2606,4,2,2021-04-16,0,0,3,0,2021-04-16,1618531200.0
2607,4,2,2021-04-17,0,0,3,0,2021-04-17,1618617600.0
2608,4,2,2021-04-18,0,0,3,0,2021-04-18,1618704000.0
2609,4,2,2021-04-19,0,0,3,0,2021-04-19,1618790400.0
2610,4,2,2021-04-20,0,0,3,0,2021-04-20,1618876800.0
2611,4,2,2021-04-21,0,0,3,0,2021-04-21,1618963200.0
2612,4,2,2021-04-22,0,0,3,0,2021-04-22,1619049600.0
2613,4,2,2021-04-23,0,0,3,0,2021-04-23,1619136000.0
2614,4,2,2021-04-24,0,0,3,0,2021-04-24,1619222400.0
2615,4,2,2021-04-25,0,0,3,0,2021-04-25,1619308800.0
2616,4,2,2021-04-26,0,0,3,0,2021-04-26,1619395200.0
2617,4,2,2021-04-27,0,0,3,0,2021-04-27,1619481600.0
2618,4,2,2021-04-28,0,0,3,0,2021-04-28,1619568000.0
2619,4,2,2021-04-29,0,0,3,0,2021-04-29,1619654400.0
2620,4,2,2021-04-30,0,0,3,0,2021-04-30,1619740800.0
2621,4,2,2021-05-01,0,0,3,0,2021-05-01,1619827200.0
2622,4,2,2021-05-02,0,0,3,0,2021-05-02,1619913600.0
2623,4,2,2021-05-03,0,0,3,0,2021-05-03,1620000000.0
2624,4,2,2021-05-04,0,0,3,0,2021-05-04,1620086400.0
2625,4,2,2021-05-05,0,0,3,0,2021-05-05,1620172800.0
2626,4,2,2021-05-06,0,0,3,0,2021-05-06,1620259200.0
2627,4,2,2021-05-07,0,0,3,0,2021-05-07,1620345600.0
2628,4,2,2021-05-08,0,0,3,0,2021-05-08,1620432000.0
2629,4,2,2021-05-09,1,0,4,0,2021-05-09,1620518400.0
2630,4,2,2021-05-10,0,0,4,0,2021-05-10,1620604800.0
2631,4,2,2021-05-11,0,0,4,0,2021-05-11,1620691200.0
2632,4,2,2021-05-12,0,0,4,0,2021-05-12,1620777600.0
2633,4,2,2021-05-13,0,0,4,0,2021-05-13,1620864000.0
2634,4,2,2021-05-14,0,0,4,0,2021-05-14,1620950400.0
2635,4,2,2021-05-15,0,0,4,0,2021-05-15,1621036800.0
2636,4,2,2021-05-16,0,0,4,0,2021-05-16,1621123200.0
2637,4,2,2021-05-17,0,0,4,0,2021-05-17,1621206000.0
2638,4,2,2021-05-18,0,0,4,0,2021-05-18,1621292400.0
2639,4,2,2021-05-19,0,0,4,0,2021-05-19,1621378800.0
2640,4,2,2021-05-20,0,0,4,0,2021-05-20,1621465200.0
2641,4,2,2021-05-21,0,0,4,0,2021-05-21,1621551600.0
2642,4,2,2021-05-22,0,0,4,0,2021-05-22,1621638000.0
2643,4,2,2021-05-23,0,0,4,0,2021-05-23,1621724400.0
2644,4,2,2021-05-24,0,0,4,0,2021-05-24,1621810800.0
2645,4,2,2021-05-25,0,0,4,0,2021-05-25,1621897200.0
2646,4,2,2021-05-26,0,0,4,0,2021-05-26,1621983600.0
2647,4,2,2021-05-27,0,0,4,0,2021-05-27,1622070000.0
2648,4,2,2021-05-28,2,0,6,0,2021-05-28,1622156400.0
2649,4,2,2021-05-29,0,0,6,0,2021-05-29,1622242800.0
2650,4,2,2021-05-30,0,0,6,0,2021-05-30,1622329200.0
2651,4,2,2021-05-31,0,0,6,0,2021-05-31,1622415600.0
2652,4,2,2021-06-01,0,0,6,0,2021-06-01,1622502000.0
2653,4,2,2021-06-02,0,0,6,0,2021-06-02,1622588400.0
2654,4,2,2021-06-03,0,0,6,0,2021-06-03,1622674800.0
2655,4,2,2021-06-04,0,0,6,0,2021-06-04,1622761200.0
2656,4,2,2021-06-05,0,0,6,0,2021-06-05,1622847600.0
2657,4,2,2021-06-06,0,0,6,0,2021-06-06,1622934000.0
2658,4,2,2021-06-07,0,0,6,0,2021-06-07,1623020400.0
2659,4,2,2021-06-08,0,0,6,0,2021-06-08,1623106800.0
2660,4,2,2021-06-09,0,0,6,0,2021-06-09,1623193200.0
2661,4,2,2021-06-10,1,1,7,1,2021-06-10,1623279600.0
2662,4,2,2021-06-11,0,2,7,3,2021-06-11,1623366000.0
2663,4,2,2021-06-12,0,0,7,3,2021-06-12,1623452400.0
2664,4,2,2021-06-13,0,0,7,3,2021-06-13,1623538800.0
2665,4,2,2021-06-14,0,0,7,3,2021-06-14,1623625200.0
2666,4,2,2021-06-15,0,0,7,3,2021-06-15,1623711600.0
2667,4,2,2021-06-16,0,0,7,3,2021-06-16,1623798000.0
2668,4,2,2021-06-17,0,0,7,3,2021-06-17,1623884400.0
2669,4,2,2021-06-18,0,0,7,3,2021-06-18,1623970800.0
2670,4,2,2021-06-19,0,0,7,3,2021-06-19,1624057200.0
2671,4,2,2021-06-20,0,0,7,3,2021-06-20,1624143600.0
2672,4,2,2021-06-21,0,0,7,3,2021-06-21,1624230000.0
2673,4,2,2021-06-22,0,0,7,3,2021-06-22,1624316400.0
2674,4,2,2021-06-23,0,0,7,3,2021-06-23,1624402800.0
2675,4,2,2021-06-24,0,0,7,3,2021-06-24,1624489200.0
2676,4,2,2021-06-25,0,0,7,3,2021-06-25,1624575600.0
2677,4,2,2021-06-26,0,0,7,3,2021-06-26,1624662000.0
2678,4,2,2021-06-27,0,0,7,3,2021-06-27,1624748400.0
2679,4,2,2021-06-28,0,0,7,3,2021-06-28,1624834800.0
2680,4,2,2021-06-29,0,0,7,3,2021-06-29,1624921200.0
2681,4,2,2021-06-30,0,0,7,3,2021-06-30,1625007600.0
2682,4,2,2021-07-01,0,0,7,3,2021-07-01,1625094000.0
2683,4,2,2021-07-02,0,0,7,3,2021-07-02,1625180400.0
2684,4,2,2021-07-03,0,0,7,3,2021-07-03,1625266800.0
2685,4,2,2021-07-04,0,1,7,4,2021-07-04,1625353200.0
2686,4,2,2021-07-05,0,0,7,4,2021-07-05,1625439600.0
2687,4,2,2021-07-06,0,0,7,4,2021-07-06,1625526000.0
2688,4,3,2020-12-27,0,0,0,0,2020-12-27,1609023600.0
2689,4,3,2020-12-28,0,0,0,0,2020-12-28,1609110000.0
2690,4,3,2020-12-29,0,0,0,0,2020-12-29,1609196400.0
2691,4,3,2020-12-30,0,0,0,0,2020-12-30,1609282800.0
2692,4,3,2020-12-31,0,0,0,0,2020-12-31,1609369200.0
2693,4,3,2021-01-01,0,0,0,0,2021-01-01,1609455600.0
2694,4,3,2021-01-02,0,0,0,0,2021-01-02,1609542000.0
2695,4,3,2021-01-03,0,0,0,0,2021-01-03,1609628400.0
2696,4,3,2021-01-04,0,0,0,0,2021-01-04,1609714800.0
2697,4,3,2021-01-05,0,0,0,0,2021-01-05,1609801200.0
2698,4,3,2021-01-06,0,0,0,0,2021-01-06,1609887600.0
2699,4,3,2021-01-07,0,0,0,0,2021-01-07,1609974000.0
2700,4,3,2021-01-08,0,0,0,0,2021-01-08,1610060400.0
2701,4,3,2021-01-09,0,0,0,0,2021-01-09,1610146800.0
2702,4,3,2021-01-10,0,0,0,0,2021-01-10,1610233200.0
2703,4,3,2021-01-11,0,0,0,0,2021-01-11,1610319600.0
2704,4,3,2021-01-12,0,0,0,0,2021-01-12,1610406000.0
2705,4,3,2021-01-13,0,0,0,0,2021-01-13,1610492400.0
2706,4,3,2021-01-14,0,0,0,0,2021-01-14,1610578800.0
2707,4,3,2021-01-15,0,0,0,0,2021-01-15,1610665200.0
2708,4,3,2021-01-16,0,0,0,0,2021-01-16,1610751600.0
2709,4,3,2021-01-17,0,0,0,0,2021-01-17,1610838000.0
2710,4,3,2021-01-18,0,0,0,0,2021-01-18,1610924400.0
2711,4,3,2021-01-19,0,0,0,0,2021-01-19,1611010800.0
2712,4,3,2021-01-20,0,0,0,0,2021-01-20,1611097200.0
2713,4,3,2021-01-21,0,0,0,0,2021-01-21,1611183600.0
2714,4,3,2021-01-22,0,0,0,0,2021-01-22,1611270000.0
2715,4,3,2021-01-23,0,0,0,0,2021-01-23,1611356400.0
2716,4,3,2021-01-24,0,0,0,0,2021-01-24,1611442800.0
2717,4,3,2021-01-25,0,0,0,0,2021-01-25,1611529200.0
2718,4,3,2021-01-26,0,0,0,0,2021-01-26,1611615600.0
2719,4,3,2021-01-27,0,0,0,0,2021-01-27,1611702000.0
2720,4,3,2021-01-28,0,0,0,0,2021-01-28,1611788400.0
2721,4,3,2021-01-29,0,0,0,0,2021-01-29,1611874800.0
2722,4,3,2021-01-30,0,0,0,0,2021-01-30,1611961200.0
2723,4,3,2021-01-31,0,0,0,0,2021-01-31,1612047600.0
2724,4,3,2021-02-01,0,0,0,0,2021-02-01,1612134000.0
2725,4,3,2021-02-02,0,0,0,0,2021-02-02,1612220400.0
2726,4,3,2021-02-03,0,0,0,0,2021-02-03,1612306800.0
2727,4,3,2021-02-04,0,0,0,0,2021-02-04,1612393200.0
2728,4,3,2021-02-05,0,0,0,0,2021-02-05,1612479600.0
2729,4,3,2021-02-06,0,0,0,0,2021-02-06,1612566000.0
2730,4,3,2021-02-07,0,0,0,0,2021-02-07,1612652400.0
2731,4,3,2021-02-08,5,0,5,0,2021-02-08,1612738800.0
2732,4,3,2021-02-09,0,0,5,0,2021-02-09,1612825200.0
2733,4,3,2021-02-10,0,0,5,0,2021-02-10,1612911600.0
2734,4,3,2021-02-11,0,0,5,0,2021-02-11,1612998000.0
2735,4,3,2021-02-12,0,0,5,0,2021-02-12,1613084400.0
2736,4,3,2021-02-13,0,0,5,0,2021-02-13,1613170800.0
2737,4,3,2021-02-14,0,0,5,0,2021-02-14,1613257200.0
2738,4,3,2021-02-15,0,0,5,0,2021-02-15,1613343600.0
2739,4,3,2021-02-16,0,0,5,0,2021-02-16,1613430000.0
2740,4,3,2021-02-17,0,0,5,0,2021-02-17,1613516400.0
2741,4,3,2021-02-18,0,0,5,0,2021-02-18,1613602800.0
2742,4,3,2021-02-19,0,0,5,0,2021-02-19,1613689200.0
2743,4,3,2021-02-20,0,0,5,0,2021-02-20,1613775600.0
2744,4,3,2021-02-21,0,0,5,0,2021-02-21,1613862000.0
2745,4,3,2021-02-22,0,0,5,0,2021-02-22,1613948400.0
2746,4,3,2021-02-23,0,0,5,0,2021-02-23,1614034800.0
2747,4,3,2021-02-24,0,0,5,0,2021-02-24,1614121200.0
2748,4,3,2021-02-25,0,0,5,0,2021-02-25,1614207600.0
2749,4,3,2021-02-26,0,0,5,0,2021-02-26,1614294000.0
2750,4,3,2021-02-27,0,0,5,0,2021-02-27,1614380400.0
2751,4,3,2021-02-28,0,0,5,0,2021-02-28,1614466800.0
2752,4,3,2021-03-01,0,0,5,0,2021-03-01,1614553200.0
2753,4,3,2021-03-02,1,0,6,0,2021-03-02,1614639600.0
2754,4,3,2021-03-03,0,0,6,0,2021-03-03,1614726000.0
2755,4,3,2021-03-04,1,0,7,0,2021-03-04,1614812400.0
2756,4,3,2021-03-05,0,0,7,0,2021-03-05,1614898800.0
2757,4,3,2021-03-06,0,0,7,0,2021-03-06,1614985200.0
2758,4,3,2021-03-07,0,0,7,0,2021-03-07,1615071600.0
2759,4,3,2021-03-08,0,0,7,0,2021-03-08,1615158000.0
2760,4,3,2021-03-09,0,0,7,0,2021-03-09,1615244400.0
2761,4,3,2021-03-10,0,1,7,1,2021-03-10,1615330800.0
2762,4,3,2021-03-11,0,0,7,1,2021-03-11,1615417200.0
2763,4,3,2021-03-12,0,0,7,1,2021-03-12,1615503600.0
2764,4,3,2021-03-13,0,0,7,1,2021-03-13,1615590000.0
2765,4,3,2021-03-14,0,0,7,1,2021-03-14,1615676400.0
2766,4,3,2021-03-15,0,2,7,3,2021-03-15,1615762800.0
2767,4,3,2021-03-16,0,0,7,3,2021-03-16,1615849200.0
2768,4,3,2021-03-17,0,0,7,3,2021-03-17,1615935600.0
2769,4,3,2021-03-18,0,0,7,3,2021-03-18,1616022000.0
2770,4,3,2021-03-19,0,0,7,3,2021-03-19,1616108400.0
2771,4,3,2021-03-20,0,0,7,3,2021-03-20,1616194800.0
2772,4,3,2021-03-21,0,0,7,3,2021-03-21,1616281200.0
2773,4,3,2021-03-22,0,0,7,3,2021-03-22,1616367600.0
2774,4,3,2021-03-23,0,0,7,3,2021-03-23,1616454000.0
2775,4,3,2021-03-24,0,0,7,3,2021-03-24,1616540400.0
2776,4,3,2021-03-25,0,1,7,4,2021-03-25,1616626800.0
2777,4,3,2021-03-26,0,0,7,4,2021-03-26,1616713200.0
2778,4,3,2021-03-27,0,0,7,4,2021-03-27,1616799600.0
2779,4,3,2021-03-28,0,0,7,4,2021-03-28,1616886000.0
2780,4,3,2021-03-29,0,0,7,4,2021-03-29,1616972400.0
2781,4,3,2021-03-30,0,0,7,4,2021-03-30,1617058800.0
2782,4,3,2021-03-31,0,0,7,4,2021-03-31,1617145200.0
2783,4,3,2021-04-01,0,0,7,4,2021-04-01,1617231600.0
2784,4,3,2021-04-02,0,0,7,4,2021-04-02,1617318000.0
2785,4,3,2021-04-03,0,0,7,4,2021-04-03,1617404400.0
2786,4,3,2021-04-04,0,0,7,4,2021-04-04,1617490800.0
2787,4,3,2021-04-05,0,0,7,4,2021-04-05,1617577200.0
2788,4,3,2021-04-06,0,0,7,4,2021-04-06,1617663600.0
2789,4,3,2021-04-07,0,0,7,4,2021-04-07,1617750000.0
2790,4,3,2021-04-08,0,0,7,4,2021-04-08,1617836400.0
2791,4,3,2021-04-09,0,0,7,4,2021-04-09,1617922800.0
2792,4,3,2021-04-10,0,0,7,4,2021-04-10,1618009200.0
2793,4,3,2021-04-11,0,0,7,4,2021-04-11,1618095600.0
2794,4,3,2021-04-12,0,0,7,4,2021-04-12,1618185600.0
2795,4,3,2021-04-13,0,0,7,4,2021-04-13,1618272000.0
2796,4,3,2021-04-14,0,0,7,4,2021-04-14,1618358400.0
2797,4,3,2021-04-15,0,0,7,4,2021-04-15,1618444800.0
2798,4,3,2021-04-16,0,0,7,4,2021-04-16,1618531200.0
2799,4,3,2021-04-17,0,0,7,4,2021-04-17,1618617600.0
2800,4,3,2021-04-18,0,0,7,4,2021-04-18,1618704000.0
2801,4,3,2021-04-19,0,0,7,4,2021-04-19,1618790400.0
2802,4,3,2021-04-20,0,0,7,4,2021-04-20,1618876800.0
2803,4,3,2021-04-21,0,0,7,4,2021-04-21,1618963200.0
2804,4,3,2021-04-22,0,0,7,4,2021-04-22,1619049600.0
2805,4,3,2021-04-23,0,0,7,4,2021-04-23,1619136000.0
2806,4,3,2021-04-24,0,0,7,4,2021-04-24,1619222400.0
2807,4,3,2021-04-25,0,0,7,4,2021-04-25,1619308800.0
2808,4,3,2021-04-26,0,0,7,4,2021-04-26,1619395200.0
2809,4,3,2021-04-27,0,0,7,4,2021-04-27,1619481600.0
2810,4,3,2021-04-28,0,0,7,4,2021-04-28,1619568000.0
2811,4,3,2021-04-29,0,0,7,4,2021-04-29,1619654400.0
2812,4,3,2021-04-30,0,0,7,4,2021-04-30,1619740800.0
2813,4,3,2021-05-01,0,0,7,4,2021-05-01,1619827200.0
2814,4,3,2021-05-02,0,0,7,4,2021-05-02,1619913600.0
2815,4,3,2021-05-03,0,0,7,4,2021-05-03,1620000000.0
2816,4,3,2021-05-04,0,0,7,4,2021-05-04,1620086400.0
2817,4,3,2021-05-05,0,0,7,4,2021-05-05,1620172800.0
2818,4,3,2021-05-06,0,0,7,4,2021-05-06,1620259200.0
2819,4,3,2021-05-07,0,0,7,4,2021-05-07,1620345600.0
2820,4,3,2021-05-08,0,0,7,4,2021-05-08,1620432000.0
2821,4,3,2021-05-09,0,0,7,4,2021-05-09,1620518400.0
2822,4,3,2021-05-10,0,0,7,4,2021-05-10,1620604800.0
2823,4,3,2021-05-11,0,0,7,4,2021-05-11,1620691200.0
2824,4,3,2021-05-12,0,0,7,4,2021-05-12,1620777600.0
2825,4,3,2021-05-13,0,0,7,4,2021-05-13,1620864000.0
2826,4,3,2021-05-14,0,0,7,4,2021-05-14,1620950400.0
2827,4,3,2021-05-15,0,0,7,4,2021-05-15,1621036800.0
2828,4,3,2021-05-16,0,0,7,4,2021-05-16,1621123200.0
2829,4,3,2021-05-17,0,0,7,4,2021-05-17,1621206000.0
2830,4,3,2021-05-18,0,0,7,4,2021-05-18,1621292400.0
2831,4,3,2021-05-19,0,0,7,4,2021-05-19,1621378800.0
2832,4,3,2021-05-20,0,0,7,4,2021-05-20,1621465200.0
2833,4,3,2021-05-21,0,0,7,4,2021-05-21,1621551600.0
2834,4,3,2021-05-22,0,0,7,4,2021-05-22,1621638000.0
2835,4,3,2021-05-23,0,0,7,4,2021-05-23,1621724400.0
2836,4,3,2021-05-24,0,0,7,4,2021-05-24,1621810800.0
2837,4,3,2021-05-25,0,0,7,4,2021-05-25,1621897200.0
2838,4,3,2021-05-26,0,0,7,4,2021-05-26,1621983600.0
2839,4,3,2021-05-27,0,0,7,4,2021-05-27,1622070000.0
2840,4,3,2021-05-28,0,0,7,4,2021-05-28,1622156400.0
2841,4,3,2021-05-29,0,0,7,4,2021-05-29,1622242800.0
2842,4,3,2021-05-30,0,0,7,4,2021-05-30,1622329200.0
2843,4,3,2021-05-31,0,0,7,4,2021-05-31,1622415600.0
2844,4,3,2021-06-01,0,0,7,4,2021-06-01,1622502000.0
2845,4,3,2021-06-02,0,0,7,4,2021-06-02,1622588400.0
2846,4,3,2021-06-03,0,0,7,4,2021-06-03,1622674800.0
2847,4,3,2021-06-04,0,0,7,4,2021-06-04,1622761200.0
2848,4,3,2021-06-05,0,0,7,4,2021-06-05,1622847600.0
2849,4,3,2021-06-06,0,0,7,4,2021-06-06,1622934000.0
2850,4,3,2021-06-07,0,0,7,4,2021-06-07,1623020400.0
2851,4,3,2021-06-08,0,0,7,4,2021-06-08,1623106800.0
2852,4,3,2021-06-09,0,0,7,4,2021-06-09,1623193200.0
2853,4,3,2021-06-10,0,0,7,4,2021-06-10,1623279600.0
2854,4,3,2021-06-11,0,0,7,4,2021-06-11,1623366000.0
2855,4,3,2021-06-12,0,0,7,4,2021-06-12,1623452400.0
2856,4,3,2021-06-13,0,0,7,4,2021-06-13,1623538800.0
2857,4,3,2021-06-14,0,0,7,4,2021-06-14,1623625200.0
2858,4,3,2021-06-15,0,0,7,4,2021-06-15,1623711600.0
2859,4,3,2021-06-16,0,0,7,4,2021-06-16,1623798000.0
2860,4,3,2021-06-17,0,0,7,4,2021-06-17,1623884400.0
2861,4,3,2021-06-18,0,0,7,4,2021-06-18,1623970800.0
2862,4,3,2021-06-19,0,0,7,4,2021-06-19,1624057200.0
2863,4,3,2021-06-20,0,0,7,4,2021-06-20,1624143600.0
2864,4,3,2021-06-21,0,0,7,4,2021-06-21,1624230000.0
2865,4,3,2021-06-22,0,0,7,4,2021-06-22,1624316400.0
2866,4,3,2021-06-23,0,0,7,4,2021-06-23,1624402800.0
2867,4,3,2021-06-24,0,0,7,4,2021-06-24,1624489200.0
2868,4,3,2021-06-25,0,0,7,4,2021-06-25,1624575600.0
2869,4,3,2021-06-26,0,0,7,4,2021-06-26,1624662000.0
2870,4,3,2021-06-27,0,0,7,4,2021-06-27,1624748400.0
2871,4,3,2021-06-28,0,0,7,4,2021-06-28,1624834800.0
2872,4,3,2021-06-29,0,0,7,4,2021-06-29,1624921200.0
2873,4,3,2021-06-30,0,0,7,4,2021-06-30,1625007600.0
2874,4,3,2021-07-01,0,0,7,4,2021-07-01,1625094000.0
2875,4,3,2021-07-02,0,0,7,4,2021-07-02,1625180400.0
2876,4,3,2021-07-03,0,0,7,4,2021-07-03,1625266800.0
2877,4,3,2021-07-04,0,0,7,4,2021-07-04,1625353200.0
2878,4,3,2021-07-05,0,0,7,4,2021-07-05,1625439600.0
2879,4,3,2021-07-06,0,0,7,4,2021-07-06,1625526000.0
2880,4,4,2020-12-27,0,0,0,0,2020-12-27,1609023600.0
2881,4,4,2020-12-28,0,0,0,0,2020-12-28,1609110000.0
2882,4,4,2020-12-29,0,0,0,0,2020-12-29,1609196400.0
2883,4,4,2020-12-30,0,0,0,0,2020-12-30,1609282800.0
2884,4,4,2020-12-31,0,0,0,0,2020-12-31,1609369200.0
2885,4,4,2021-01-01,0,0,0,0,2021-01-01,1609455600.0
2886,4,4,2021-01-02,0,0,0,0,2021-01-02,1609542000.0
2887,4,4,2021-01-03,0,0,0,0,2021-01-03,1609628400.0
2888,4,4,2021-01-04,0,0,0,0,2021-01-04,1609714800.0
2889,4,4,2021-01-05,0,0,0,0,2021-01-05,1609801200.0
2890,4,4,2021-01-06,0,0,0,0,2021-01-06,1609887600.0
2891,4,4,2021-01-07,0,0,0,0,2021-01-07,1609974000.0
2892,4,4,2021-01-08,0,0,0,0,2021-01-08,1610060400.0
2893,4,4,2021-01-09,0,0,0,0,2021-01-09,1610146800.0
2894,4,4,2021-01-10,0,0,0,0,2021-01-10,1610233200.0
2895,4,4,2021-01-11,0,0,0,0,2021-01-11,1610319600.0
2896,4,4,2021-01-12,0,0,0,0,2021-01-12,1610406000.0
2897,4,4,2021-01-13,0,0,0,0,2021-01-13,1610492400.0
2898,4,4,2021-01-14,0,0,0,0,2021-01-14,1610578800.0
2899,4,4,2021-01-15,0,0,0,0,2021-01-15,1610665200.0
2900,4,4,2021-01-16,0,0,0,0,2021-01-16,1610751600.0
2901,4,4,2021-01-17,0,0,0,0,2021-01-17,1610838000.0
2902,4,4,2021-01-18,0,0,0,0,2021-01-18,1610924400.0
2903,4,4,2021-01-19,0,0,0,0,2021-01-19,1611010800.0
2904,4,4,2021-01-20,0,0,0,0,2021-01-20,1611097200.0
2905,4,4,2021-01-21,0,0,0,0,2021-01-21,1611183600.0
2906,4,4,2021-01-22,0,0,0,0,2021-01-22,1611270000.0
2907,4,4,2021-01-23,0,0,0,0,2021-01-23,1611356400.0
2908,4,4,2021-01-24,0,0,0,0,2021-01-24,1611442800.0
2909,4,4,2021-01-25,0,0,0,0,2021-01-25,1611529200.0
2910,4,4,2021-01-26,0,0,0,0,2021-01-26,1611615600.0
2911,4,4,2021-01-27,0,0,0,0,2021-01-27,1611702000.0
2912,4,4,2021-01-28,0,0,0,0,2021-01-28,1611788400.0
2913,4,4,2021-01-29,0,0,0,0,2021-01-29,1611874800.0
2914,4,4,2021-01-30,0,0,0,0,2021-01-30,1611961200.0
2915,4,4,2021-01-31,0,0,0,0,2021-01-31,1612047600.0
2916,4,4,2021-02-01,0,0,0,0,2021-02-01,1612134000.0
2917,4,4,2021-02-02,0,0,0,0,2021-02-02,1612220400.0
2918,4,4,2021-02-03,0,0,0,0,2021-02-03,1612306800.0
2919,4,4,2021-02-04,0,0,0,0,2021-02-04,1612393200.0
2920,4,4,2021-02-05,0,0,0,0,2021-02-05,1612479600.0
2921,4,4,2021-02-06,0,0,0,0,2021-02-06,1612566000.0
2922,4,4,2021-02-07,0,0,0,0,2021-02-07,1612652400.0
2923,4,4,2021-02-08,0,0,0,0,2021-02-08,1612738800.0
2924,4,4,2021-02-09,0,0,0,0,2021-02-09,1612825200.0
2925,4,4,2021-02-10,0,0,0,0,2021-02-10,1612911600.0
2926,4,4,2021-02-11,0,0,0,0,2021-02-11,1612998000.0
2927,4,4,2021-02-12,0,0,0,0,2021-02-12,1613084400.0
2928,4,4,2021-02-13,0,0,0,0,2021-02-13,1613170800.0
2929,4,4,2021-02-14,0,0,0,0,2021-02-14,1613257200.0
2930,4,4,2021-02-15,0,0,0,0,2021-02-15,1613343600.0
2931,4,4,2021-02-16,0,0,0,0,2021-02-16,1613430000.0
2932,4,4,2021-02-17,0,0,0,0,2021-02-17,1613516400.0
2933,4,4,2021-02-18,0,0,0,0,2021-02-18,1613602800.0
2934,4,4,2021-02-19,0,0,0,0,2021-02-19,1613689200.0
2935,4,4,2021-02-20,0,0,0,0,2021-02-20,1613775600.0
2936,4,4,2021-02-21,0,0,0,0,2021-02-21,1613862000.0
2937,4,4,2021-02-22,0,0,0,0,2021-02-22,1613948400.0
2938,4,4,2021-02-23,0,0,0,0,2021-02-23,1614034800.0
2939,4,4,2021-02-24,0,0,0,0,2021-02-24,1614121200.0
2940,4,4,2021-02-25,0,0,0,0,2021-02-25,1614207600.0
2941,4,4,2021-02-26,0,0,0,0,2021-02-26,1614294000.0
2942,4,4,2021-02-27,0,0,0,0,2021-02-27,1614380400.0
2943,4,4,2021-02-28,0,0,0,0,2021-02-28,1614466800.0
2944,4,4,2021-03-01,0,0,0,0,2021-03-01,1614553200.0
2945,4,4,2021-03-02,0,0,0,0,2021-03-02,1614639600.0
2946,4,4,2021-03-03,0,0,0,0,2021-03-03,1614726000.0
2947,4,4,2021-03-04,0,0,0,0,2021-03-04,1614812400.0
2948,4,4,2021-03-05,0,0,0,0,2021-03-05,1614898800.0
2949,4,4,2021-03-06,0,0,0,0,2021-03-06,1614985200.0
2950,4,4,2021-03-07,0,0,0,0,2021-03-07,1615071600.0
2951,4,4,2021-03-08,0,0,0,0,2021-03-08,1615158000.0
2952,4,4,2021-03-09,0,0,0,0,2021-03-09,1615244400.0
2953,4,4,2021-03-10,0,0,0,0,2021-03-10,1615330800.0
2954,4,4,2021-03-11,0,0,0,0,2021-03-11,1615417200.0
2955,4,4,2021-03-12,0,0,0,0,2021-03-12,1615503600.0
2956,4,4,2021-03-13,0,0,0,0,2021-03-13,1615590000.0
2957,4,4,2021-03-14,0,0,0,0,2021-03-14,1615676400.0
2958,4,4,2021-03-15,0,0,0,0,2021-03-15,1615762800.0
2959,4,4,2021-03-16,0,0,0,0,2021-03-16,1615849200.0
2960,4,4,2021-03-17,0,0,0,0,2021-03-17,1615935600.0
2961,4,4,2021-03-18,0,0,0,0,2021-03-18,1616022000.0
2962,4,4,2021-03-19,0,0,0,0,2021-03-19,1616108400.0
2963,4,4,2021-03-20,0,0,0,0,2021-03-20,1616194800.0
2964,4,4,2021-03-21,0,0,0,0,2021-03-21,1616281200.0
2965,4,4,2021-03-22,0,0,0,0,2021-03-22,1616367600.0
2966,4,4,2021-03-23,0,0,0,0,2021-03-23,1616454000.0
2967,4,4,2021-03-24,0,0,0,0,2021-03-24,1616540400.0
2968,4,4,2021-03-25,0,0,0,0,2021-03-25,1616626800.0
2969,4,4,2021-03-26,0,0,0,0,2021-03-26,1616713200.0
2970,4,4,2021-03-27,0,0,0,0,2021-03-27,1616799600.0
2971,4,4,2021-03-28,0,0,0,0,2021-03-28,1616886000.0
2972,4,4,2021-03-29,0,0,0,0,2021-03-29,1616972400.0
2973,4,4,2021-03-30,0,0,0,0,2021-03-30,1617058800.0
2974,4,4,2021-03-31,0,0,0,0,2021-03-31,1617145200.0
2975,4,4,2021-04-01,0,0,0,0,2021-04-01,1617231600.0
2976,4,4,2021-04-02,0,0,0,0,2021-04-02,1617318000.0
2977,4,4,2021-04-03,0,0,0,0,2021-04-03,1617404400.0
2978,4,4,2021-04-04,0,0,0,0,2021-04-04,1617490800.0
2979,4,4,2021-04-05,0,0,0,0,2021-04-05,1617577200.0
2980,4,4,2021-04-06,0,0,0,0,2021-04-06,1617663600.0
2981,4,4,2021-04-07,0,0,0,0,2021-04-07,1617750000.0
2982,4,4,2021-04-08,0,0,0,0,2021-04-08,1617836400.0
2983,4,4,2021-04-09,0,0,0,0,2021-04-09,1617922800.0
2984,4,4,2021-04-10,0,0,0,0,2021-04-10,1618009200.0
2985,4,4,2021-04-11,0,0,0,0,2021-04-11,1618095600.0
2986,4,4,2021-04-12,0,0,0,0,2021-04-12,1618185600.0
2987,4,4,2021-04-13,0,0,0,0,2021-04-13,1618272000.0
2988,4,4,2021-04-14,0,0,0,0,2021-04-14,1618358400.0
2989,4,4,2021-04-15,0,0,0,0,2021-04-15,1618444800.0
2990,4,4,2021-04-16,0,0,0,0,2021-04-16,1618531200.0
2991,4,4,2021-04-17,0,0,0,0,2021-04-17,1618617600.0
2992,4,4,2021-04-18,0,0,0,0,2021-04-18,1618704000.0
2993,4,4,2021-04-19,0,0,0,0,2021-04-19,1618790400.0
2994,4,4,2021-04-20,0,0,0,0,2021-04-20,1618876800.0
2995,4,4,2021-04-21,0,0,0,0,2021-04-21,1618963200.0
2996,4,4,2021-04-22,0,0,0,0,2021-04-22,1619049600.0
2997,4,4,2021-04-23,0,0,0,0,2021-04-23,1619136000.0
2998,4,4,2021-04-24,0,0,0,0,2021-04-24,1619222400.0
2999,4,4,2021-04-25,0,0,0,0,2021-04-25,1619308800.0
3000,4,4,2021-04-26,0,0,0,0,2021-04-26,1619395200.0
3001,4,4,2021-04-27,0,0,0,0,2021-04-27,1619481600.0
3002,4,4,2021-04-28,0,0,0,0,2021-04-28,1619568000.0
3003,4,4,2021-04-29,0,0,0,0,2021-04-29,1619654400.0
3004,4,4,2021-04-30,0,0,0,0,2021-04-30,1619740800.0
3005,4,4,2021-05-01,0,0,0,0,2021-05-01,1619827200.0
3006,4,4,2021-05-02,0,0,0,0,2021-05-02,1619913600.0
3007,4,4,2021-05-03,0,0,0,0,2021-05-03,1620000000.0
3008,4,4,2021-05-04,0,0,0,0,2021-05-04,1620086400.0
3009,4,4,2021-05-05,0,0,0,0,2021-05-05,1620172800.0
3010,4,4,2021-05-06,0,0,0,0,2021-05-06,1620259200.0
3011,4,4,2021-05-07,0,0,0,0,2021-05-07,1620345600.0
3012,4,4,2021-05-08,0,0,0,0,2021-05-08,1620432000.0
3013,4,4,2021-05-09,0,0,0,0,2021-05-09,1620518400.0
3014,4,4,2021-05-10,0,0,0,0,2021-05-10,1620604800.0
3015,4,4,2021-05-11,20,0,20,0,2021-05-11,1620691200.0
3016,4,4,2021-05-12,45,0,65,0,2021-05-12,1620777600.0
3017,4,4,2021-05-13,1,0,66,0,2021-05-13,1620864000.0
3018,4,4,2021-05-14,78,0,144,0,2021-05-14,1620950400.0
3019,4,4,2021-05-15,20,0,164,0,2021-05-15,1621036800.0
3020,4,4,2021-05-16,12,0,176,0,2021-05-16,1621123200.0
3021,4,4,2021-05-17,73,0,249,0,2021-05-17,1621206000.0
3022,4,4,2021-05-18,164,0,413,0,2021-05-18,1621292400.0
3023,4,4,2021-05-19,110,0,523,0,2021-05-19,1621378800.0
3024,4,4,2021-05-20,92,0,615,0,2021-05-20,1621465200.0
3025,4,4,2021-05-21,158,0,773,0,2021-05-21,1621551600.0
3026,4,4,2021-05-22,85,0,858,0,2021-05-22,1621638000.0
3027,4,4,2021-05-23,3,0,861,0,2021-05-23,1621724400.0
3028,4,4,2021-05-24,53,0,914,0,2021-05-24,1621810800.0
3029,4,4,2021-05-25,315,0,1229,0,2021-05-25,1621897200.0
3030,4,4,2021-05-26,262,0,1491,0,2021-05-26,1621983600.0
3031,4,4,2021-05-27,310,1,1801,1,2021-05-27,1622070000.0
3032,4,4,2021-05-28,241,0,2042,1,2021-05-28,1622156400.0
3033,4,4,2021-05-29,155,0,2197,1,2021-05-29,1622242800.0
3034,4,4,2021-05-30,1,0,2198,1,2021-05-30,1622329200.0
3035,4,4,2021-05-31,208,0,2406,1,2021-05-31,1622415600.0
3036,4,4,2021-06-01,300,0,2706,1,2021-06-01,1622502000.0
3037,4,4,2021-06-02,231,2,2937,3,2021-06-02,1622588400.0
3038,4,4,2021-06-03,261,0,3198,3,2021-06-03,1622674800.0
3039,4,4,2021-06-04,271,1,3469,4,2021-06-04,1622761200.0
3040,4,4,2021-06-05,93,0,3562,4,2021-06-05,1622847600.0
3041,4,4,2021-06-06,24,0,3586,4,2021-06-06,1622934000.0
3042,4,4,2021-06-07,169,0,3755,4,2021-06-07,1623020400.0
3043,4,4,2021-06-08,225,0,3980,4,2021-06-08,1623106800.0
3044,4,4,2021-06-09,152,0,4132,4,2021-06-09,1623193200.0
3045,4,4,2021-06-10,142,0,4274,4,2021-06-10,1623279600.0
3046,4,4,2021-06-11,153,0,4427,4,2021-06-11,1623366000.0
3047,4,4,2021-06-12,140,0,4567,4,2021-06-12,1623452400.0
3048,4,4,2021-06-13,35,0,4602,4,2021-06-13,1623538800.0
3049,4,4,2021-06-14,104,0,4706,4,2021-06-14,1623625200.0
3050,4,4,2021-06-15,217,0,4923,4,2021-06-15,1623711600.0
3051,4,4,2021-06-16,181,0,5104,4,2021-06-16,1623798000.0
3052,4,4,2021-06-17,130,1,5234,5,2021-06-17,1623884400.0
3053,4,4,2021-06-18,144,0,5378,5,2021-06-18,1623970800.0
3054,4,4,2021-06-19,74,0,5452,5,2021-06-19,1624057200.0
3055,4,4,2021-06-20,22,0,5474,5,2021-06-20,1624143600.0
3056,4,4,2021-06-21,101,0,5575,5,2021-06-21,1624230000.0
3057,4,4,2021-06-22,165,0,5740,5,2021-06-22,1624316400.0
3058,4,4,2021-06-23,96,0,5836,5,2021-06-23,1624402800.0
3059,4,4,2021-06-24,119,0,5955,5,2021-06-24,1624489200.0
3060,4,4,2021-06-25,117,0,6072,5,2021-06-25,1624575600.0
3061,4,4,2021-06-26,70,0,6142,5,2021-06-26,1624662000.0
3062,4,4,2021-06-27,48,1,6190,6,2021-06-27,1624748400.0
3063,4,4,2021-06-28,62,0,6252,6,2021-06-28,1624834800.0
3064,4,4,2021-06-29,134,0,6386,6,2021-06-29,1624921200.0
3065,4,4,2021-06-30,129,0,6515,6,2021-06-30,1625007600.0
3066,4,4,2021-07-01,117,0,6632,6,2021-07-01,1625094000.0
3067,4,4,2021-07-02,144,0,6776,6,2021-07-02,1625180400.0
3068,4,4,2021-07-03,90,1,6866,7,2021-07-03,1625266800.0
3069,4,4,2021-07-04,51,0,6917,7,2021-07-04,1625353200.0
3070,4,4,2021-07-05,103,0,7020,7,2021-07-05,1625439600.0
3071,4,4,2021-07-06,149,0,7169,7,2021-07-06,1625526000.0
3072,5,1,2020-12-27,0,0,0,0,2020-12-27,1609023600.0
3073,5,1,2020-12-28,0,0,0,0,2020-12-28,1609110000.0
3074,5,1,2020-12-29,0,0,0,0,2020-12-29,1609196400.0
3075,5,1,2020-12-30,0,0,0,0,2020-12-30,1609282800.0
3076,5,1,2020-12-31,0,0,0,0,2020-12-31,1609369200.0
3077,5,1,2021-01-01,0,0,0,0,2021-01-01,1609455600.0
3078,5,1,2021-01-02,0,0,0,0,2021-01-02,1609542000.0
3079,5,1,2021-01-03,0,0,0,0,2021-01-03,1609628400.0
3080,5,1,2021-01-04,0,0,0,0,2021-01-04,1609714800.0
3081,5,1,2021-01-05,0,0,0,0,2021-01-05,1609801200.0
3082,5,1,2021-01-06,0,0,0,0,2021-01-06,1609887600.0
3083,5,1,2021-01-07,0,0,0,0,2021-01-07,1609974000.0
3084,5,1,2021-01-08,0,0,0,0,2021-01-08,1610060400.0
3085,5,1,2021-01-09,0,0,0,0,2021-01-09,1610146800.0
3086,5,1,2021-01-10,0,0,0,0,2021-01-10,1610233200.0
3087,5,1,2021-01-11,0,0,0,0,2021-01-11,1610319600.0
3088,5,1,2021-01-12,0,0,0,0,2021-01-12,1610406000.0
3089,5,1,2021-01-13,0,0,0,0,2021-01-13,1610492400.0
3090,5,1,2021-01-14,0,0,0,0,2021-01-14,1610578800.0
3091,5,1,2021-01-15,0,0,0,0,2021-01-15,1610665200.0
3092,5,1,2021-01-16,0,0,0,0,2021-01-16,1610751600.0
3093,5,1,2021-01-17,0,0,0,0,2021-01-17,1610838000.0
3094,5,1,2021-01-18,0,0,0,0,2021-01-18,1610924400.0
3095,5,1,2021-01-19,0,0,0,0,2021-01-19,1611010800.0
3096,5,1,2021-01-20,0,0,0,0,2021-01-20,1611097200.0
3097,5,1,2021-01-21,0,0,0,0,2021-01-21,1611183600.0
3098,5,1,2021-01-22,0,0,0,0,2021-01-22,1611270000.0
3099,5,1,2021-01-23,0,0,0,0,2021-01-23,1611356400.0
3100,5,1,2021-01-24,0,0,0,0,2021-01-24,1611442800.0
3101,5,1,2021-01-25,0,0,0,0,2021-01-25,1611529200.0
3102,5,1,2021-01-26,0,0,0,0,2021-01-26,1611615600.0
3103,5,1,2021-01-27,0,0,0,0,2021-01-27,1611702000.0
3104,5,1,2021-01-28,0,0,0,0,2021-01-28,1611788400.0
3105,5,1,2021-01-29,0,0,0,0,2021-01-29,1611874800.0
3106,5,1,2021-01-30,0,0,0,0,2021-01-30,1611961200.0
3107,5,1,2021-01-31,0,0,0,0,2021-01-31,1612047600.0
3108,5,1,2021-02-01,0,0,0,0,2021-02-01,1612134000.0
3109,5,1,2021-02-02,0,0,0,0,2021-02-02,1612220400.0
3110,5,1,2021-02-03,0,0,0,0,2021-02-03,1612306800.0
3111,5,1,2021-02-04,0,0,0,0,2021-02-04,1612393200.0
3112,5,1,2021-02-05,0,0,0,0,2021-02-05,1612479600.0
3113,5,1,2021-02-06,0,0,0,0,2021-02-06,1612566000.0
3114,5,1,2021-02-07,0,0,0,0,2021-02-07,1612652400.0
3115,5,1,2021-02-08,0,0,0,0,2021-02-08,1612738800.0
3116,5,1,2021-02-09,0,0,0,0,2021-02-09,1612825200.0
3117,5,1,2021-02-10,0,0,0,0,2021-02-10,1612911600.0
3118,5,1,2021-02-11,0,0,0,0,2021-02-11,1612998000.0
3119,5,1,2021-02-12,0,0,0,0,2021-02-12,1613084400.0
3120,5,1,2021-02-13,0,0,0,0,2021-02-13,1613170800.0
3121,5,1,2021-02-14,0,0,0,0,2021-02-14,1613257200.0
3122,5,1,2021-02-15,0,0,0,0,2021-02-15,1613343600.0
3123,5,1,2021-02-16,0,0,0,0,2021-02-16,1613430000.0
3124,5,1,2021-02-17,0,0,0,0,2021-02-17,1613516400.0
3125,5,1,2021-02-18,0,0,0,0,2021-02-18,1613602800.0
3126,5,1,2021-02-19,0,0,0,0,2021-02-19,1613689200.0
3127,5,1,2021-02-20,0,0,0,0,2021-02-20,1613775600.0
3128,5,1,2021-02-21,0,0,0,0,2021-02-21,1613862000.0
3129,5,1,2021-02-22,0,0,0,0,2021-02-22,1613948400.0
3130,5,1,2021-02-23,0,0,0,0,2021-02-23,1614034800.0
3131,5,1,2021-02-24,0,0,0,0,2021-02-24,1614121200.0
3132,5,1,2021-02-25,0,0,0,0,2021-02-25,1614207600.0
3133,5,1,2021-02-26,0,0,0,0,2021-02-26,1614294000.0
3134,5,1,2021-02-27,0,0,0,0,2021-02-27,1614380400.0
3135,5,1,2021-02-28,0,0,0,0,2021-02-28,1614466800.0
3136,5,1,2021-03-01,0,0,0,0,2021-03-01,1614553200.0
3137,5,1,2021-03-02,0,0,0,0,2021-03-02,1614639600.0
3138,5,1,2021-03-03,0,0,0,0,2021-03-03,1614726000.0
3139,5,1,2021-03-04,0,0,0,0,2021-03-04,1614812400.0
3140,5,1,2021-03-05,0,0,0,0,2021-03-05,1614898800.0
3141,5,1,2021-03-06,0,0,0,0,2021-03-06,1614985200.0
3142,5,1,2021-03-07,0,0,0,0,2021-03-07,1615071600.0
3143,5,1,2021-03-08,0,0,0,0,2021-03-08,1615158000.0
3144,5,1,2021-03-09,0,0,0,0,2021-03-09,1615244400.0
3145,5,1,2021-03-10,0,0,0,0,2021-03-10,1615330800.0
3146,5,1,2021-03-11,0,0,0,0,2021-03-11,1615417200.0
3147,5,1,2021-03-12,0,0,0,0,2021-03-12,1615503600.0
3148,5,1,2021-03-13,0,0,0,0,2021-03-13,1615590000.0
3149,5,1,2021-03-14,0,0,0,0,2021-03-14,1615676400.0
3150,5,1,2021-03-15,0,0,0,0,2021-03-15,1615762800.0
3151,5,1,2021-03-16,0,0,0,0,2021-03-16,1615849200.0
3152,5,1,2021-03-17,0,0,0,0,2021-03-17,1615935600.0
3153,5,1,2021-03-18,0,0,0,0,2021-03-18,1616022000.0
3154,5,1,2021-03-19,0,0,0,0,2021-03-19,1616108400.0
3155,5,1,2021-03-20,0,0,0,0,2021-03-20,1616194800.0
3156,5,1,2021-03-21,0,0,0,0,2021-03-21,1616281200.0
3157,5,1,2021-03-22,0,0,0,0,2021-03-22,1616367600.0
3158,5,1,2021-03-23,0,0,0,0,2021-03-23,1616454000.0
3159,5,1,2021-03-24,0,0,0,0,2021-03-24,1616540400.0
3160,5,1,2021-03-25,0,0,0,0,2021-03-25,1616626800.0
3161,5,1,2021-03-26,0,0,0,0,2021-03-26,1616713200.0
3162,5,1,2021-03-27,0,0,0,0,2021-03-27,1616799600.0
3163,5,1,2021-03-28,0,0,0,0,2021-03-28,1616886000.0
3164,5,1,2021-03-29,0,0,0,0,2021-03-29,1616972400.0
3165,5,1,2021-03-30,0,0,0,0,2021-03-30,1617058800.0
3166,5,1,2021-03-31,0,0,0,0,2021-03-31,1617145200.0
3167,5,1,2021-04-01,0,0,0,0,2021-04-01,1617231600.0
3168,5,1,2021-04-02,0,0,0,0,2021-04-02,1617318000.0
3169,5,1,2021-04-03,0,0,0,0,2021-04-03,1617404400.0
3170,5,1,2021-04-04,0,0,0,0,2021-04-04,1617490800.0
3171,5,1,2021-04-05,0,0,0,0,2021-04-05,1617577200.0
3172,5,1,2021-04-06,0,0,0,0,2021-04-06,1617663600.0
3173,5,1,2021-04-07,0,0,0,0,2021-04-07,1617750000.0
3174,5,1,2021-04-08,0,0,0,0,2021-04-08,1617836400.0
3175,5,1,2021-04-09,0,0,0,0,2021-04-09,1617922800.0
3176,5,1,2021-04-10,0,0,0,0,2021-04-10,1618009200.0
3177,5,1,2021-04-11,0,0,0,0,2021-04-11,1618095600.0
3178,5,1,2021-04-12,0,0,0,0,2021-04-12,1618185600.0
3179,5,1,2021-04-13,0,0,0,0,2021-04-13,1618272000.0
3180,5,1,2021-04-14,0,0,0,0,2021-04-14,1618358400.0
3181,5,1,2021-04-15,0,0,0,0,2021-04-15,1618444800.0
3182,5,1,2021-04-16,0,0,0,0,2021-04-16,1618531200.0
3183,5,1,2021-04-17,0,0,0,0,2021-04-17,1618617600.0
3184,5,1,2021-04-18,0,0,0,0,2021-04-18,1618704000.0
3185,5,1,2021-04-19,0,0,0,0,2021-04-19,1618790400.0
3186,5,1,2021-04-20,0,0,0,0,2021-04-20,1618876800.0
3187,5,1,2021-04-21,0,0,0,0,2021-04-21,1618963200.0
3188,5,1,2021-04-22,0,0,0,0,2021-04-22,1619049600.0
3189,5,1,2021-04-23,0,0,0,0,2021-04-23,1619136000.0
3190,5,1,2021-04-24,0,0,0,0,2021-04-24,1619222400.0
3191,5,1,2021-04-25,0,0,0,0,2021-04-25,1619308800.0
3192,5,1,2021-04-26,0,0,0,0,2021-04-26,1619395200.0
3193,5,1,2021-04-27,0,0,0,0,2021-04-27,1619481600.0
3194,5,1,2021-04-28,0,0,0,0,2021-04-28,1619568000.0
3195,5,1,2021-04-29,0,0,0,0,2021-04-29,1619654400.0
3196,5,1,2021-04-30,0,0,0,0,2021-04-30,1619740800.0
3197,5,1,2021-05-01,0,0,0,0,2021-05-01,1619827200.0
3198,5,1,2021-05-02,0,0,0,0,2021-05-02,1619913600.0
3199,5,1,2021-05-03,0,0,0,0,2021-05-03,1620000000.0
3200,5,1,2021-05-04,0,0,0,0,2021-05-04,1620086400.0
3201,5,1,2021-05-05,0,0,0,0,2021-05-05,1620172800.0
3202,5,1,2021-05-06,0,0,0,0,2021-05-06,1620259200.0
3203,5,1,2021-05-07,0,0,0,0,2021-05-07,1620345600.0
3204,5,1,2021-05-08,0,0,0,0,2021-05-08,1620432000.0
3205,5,1,2021-05-09,0,0,0,0,2021-05-09,1620518400.0
3206,5,1,2021-05-10,0,0,0,0,2021-05-10,1620604800.0
3207,5,1,2021-05-11,0,0,0,0,2021-05-11,1620691200.0
3208,5,1,2021-05-12,0,0,0,0,2021-05-12,1620777600.0
3209,5,1,2021-05-13,0,0,0,0,2021-05-13,1620864000.0
3210,5,1,2021-05-14,0,0,0,0,2021-05-14,1620950400.0
3211,5,1,2021-05-15,0,0,0,0,2021-05-15,1621036800.0
3212,5,1,2021-05-16,0,0,0,0,2021-05-16,1621123200.0
3213,5,1,2021-05-17,0,0,0,0,2021-05-17,1621206000.0
3214,5,1,2021-05-18,0,0,0,0,2021-05-18,1621292400.0
3215,5,1,2021-05-19,0,0,0,0,2021-05-19,1621378800.0
3216,5,1,2021-05-20,0,0,0,0,2021-05-20,1621465200.0
3217,5,1,2021-05-21,0,0,0,0,2021-05-21,1621551600.0
3218,5,1,2021-05-22,0,0,0,0,2021-05-22,1621638000.0
3219,5,1,2021-05-23,0,0,0,0,2021-05-23,1621724400.0
3220,5,1,2021-05-24,0,0,0,0,2021-05-24,1621810800.0
3221,5,1,2021-05-25,0,0,0,0,2021-05-25,1621897200.0
3222,5,1,2021-05-26,0,0,0,0,2021-05-26,1621983600.0
3223,5,1,2021-05-27,0,0,0,0,2021-05-27,1622070000.0
3224,5,1,2021-05-28,0,0,0,0,2021-05-28,1622156400.0
3225,5,1,2021-05-29,0,0,0,0,2021-05-29,1622242800.0
3226,5,1,2021-05-30,0,0,0,0,2021-05-30,1622329200.0
3227,5,1,2021-05-31,0,0,0,0,2021-05-31,1622415600.0
3228,5,1,2021-06-01,0,0,0,0,2021-06-01,1622502000.0
3229,5,1,2021-06-02,0,0,0,0,2021-06-02,1622588400.0
3230,5,1,2021-06-03,0,0,0,0,2021-06-03,1622674800.0
3231,5,1,2021-06-04,0,0,0,0,2021-06-04,1622761200.0
3232,5,1,2021-06-05,0,0,0,0,2021-06-05,1622847600.0
3233,5,1,2021-06-06,0,0,0,0,2021-06-06,1622934000.0
3234,5,1,2021-06-07,0,0,0,0,2021-06-07,1623020400.0
3235,5,1,2021-06-08,0,0,0,0,2021-06-08,1623106800.0
3236,5,1,2021-06-09,0,0,0,0,2021-06-09,1623193200.0
3237,5,1,2021-06-10,0,0,0,0,2021-06-10,1623279600.0
3238,5,1,2021-06-11,0,0,0,0,2021-06-11,1623366000.0
3239,5,1,2021-06-12,0,0,0,0,2021-06-12,1623452400.0
3240,5,1,2021-06-13,0,0,0,0,2021-06-13,1623538800.0
3241,5,1,2021-06-14,0,0,0,0,2021-06-14,1623625200.0
3242,5,1,2021-06-15,0,0,0,0,2021-06-15,1623711600.0
3243,5,1,2021-06-16,0,0,0,0,2021-06-16,1623798000.0
3244,5,1,2021-06-17,0,0,0,0,2021-06-17,1623884400.0
3245,5,1,2021-06-18,0,0,0,0,2021-06-18,1623970800.0
3246,5,1,2021-06-19,0,0,0,0,2021-06-19,1624057200.0
3247,5,1,2021-06-20,0,0,0,0,2021-06-20,1624143600.0
3248,5,1,2021-06-21,0,0,0,0,2021-06-21,1624230000.0
3249,5,1,2021-06-22,0,0,0,0,2021-06-22,1624316400.0
3250,5,1,2021-06-23,0,0,0,0,2021-06-23,1624402800.0
3251,5,1,2021-06-24,0,0,0,0,2021-06-24,1624489200.0
3252,5,1,2021-06-25,0,0,0,0,2021-06-25,1624575600.0
3253,5,1,2021-06-26,0,0,0,0,2021-06-26,1624662000.0
3254,5,1,2021-06-27,0,0,0,0,2021-06-27,1624748400.0
3255,5,1,2021-06-28,0,0,0,0,2021-06-28,1624834800.0
3256,5,1,2021-06-29,0,0,0,0,2021-06-29,1624921200.0
3257,5,1,2021-06-30,0,0,0,0,2021-06-30,1625007600.0
3258,5,1,2021-07-01,0,0,0,0,2021-07-01,1625094000.0
3259,5,1,2021-07-02,0,0,0,0,2021-07-02,1625180400.0
3260,5,1,2021-07-03,0,0,0,0,2021-07-03,1625266800.0
3261,5,1,2021-07-04,0,0,0,0,2021-07-04,1625353200.0
3262,5,1,2021-07-05,0,0,0,0,2021-07-05,1625439600.0
3263,5,1,2021-07-06,0,0,0,0,2021-07-06,1625526000.0
3264,5,2,2020-12-27,0,0,0,0,2020-12-27,1609023600.0
3265,5,2,2020-12-28,0,0,0,0,2020-12-28,1609110000.0
3266,5,2,2020-12-29,0,0,0,0,2020-12-29,1609196400.0
3267,5,2,2020-12-30,0,0,0,0,2020-12-30,1609282800.0
3268,5,2,2020-12-31,0,0,0,0,2020-12-31,1609369200.0
3269,5,2,2021-01-01,0,0,0,0,2021-01-01,1609455600.0
3270,5,2,2021-01-02,0,0,0,0,2021-01-02,1609542000.0
3271,5,2,2021-01-03,0,0,0,0,2021-01-03,1609628400.0
3272,5,2,2021-01-04,0,0,0,0,2021-01-04,1609714800.0
3273,5,2,2021-01-05,0,0,0,0,2021-01-05,1609801200.0
3274,5,2,2021-01-06,0,0,0,0,2021-01-06,1609887600.0
3275,5,2,2021-01-07,0,0,0,0,2021-01-07,1609974000.0
3276,5,2,2021-01-08,0,0,0,0,2021-01-08,1610060400.0
3277,5,2,2021-01-09,0,0,0,0,2021-01-09,1610146800.0
3278,5,2,2021-01-10,0,0,0,0,2021-01-10,1610233200.0
3279,5,2,2021-01-11,0,0,0,0,2021-01-11,1610319600.0
3280,5,2,2021-01-12,0,0,0,0,2021-01-12,1610406000.0
3281,5,2,2021-01-13,0,0,0,0,2021-01-13,1610492400.0
3282,5,2,2021-01-14,0,0,0,0,2021-01-14,1610578800.0
3283,5,2,2021-01-15,0,0,0,0,2021-01-15,1610665200.0
3284,5,2,2021-01-16,0,0,0,0,2021-01-16,1610751600.0
3285,5,2,2021-01-17,0,0,0,0,2021-01-17,1610838000.0
3286,5,2,2021-01-18,0,0,0,0,2021-01-18,1610924400.0
3287,5,2,2021-01-19,0,0,0,0,2021-01-19,1611010800.0
3288,5,2,2021-01-20,0,0,0,0,2021-01-20,1611097200.0
3289,5,2,2021-01-21,0,0,0,0,2021-01-21,1611183600.0
3290,5,2,2021-01-22,0,0,0,0,2021-01-22,1611270000.0
3291,5,2,2021-01-23,0,0,0,0,2021-01-23,1611356400.0
3292,5,2,2021-01-24,0,0,0,0,2021-01-24,1611442800.0
3293,5,2,2021-01-25,0,0,0,0,2021-01-25,1611529200.0
3294,5,2,2021-01-26,0,0,0,0,2021-01-26,1611615600.0
3295,5,2,2021-01-27,0,0,0,0,2021-01-27,1611702000.0
3296,5,2,2021-01-28,0,0,0,0,2021-01-28,1611788400.0
3297,5,2,2021-01-29,0,0,0,0,2021-01-29,1611874800.0
3298,5,2,2021-01-30,0,0,0,0,2021-01-30,1611961200.0
3299,5,2,2021-01-31,0,0,0,0,2021-01-31,1612047600.0
3300,5,2,2021-02-01,0,0,0,0,2021-02-01,1612134000.0
3301,5,2,2021-02-02,0,0,0,0,2021-02-02,1612220400.0
3302,5,2,2021-02-03,0,0,0,0,2021-02-03,1612306800.0
3303,5,2,2021-02-04,0,0,0,0,2021-02-04,1612393200.0
3304,5,2,2021-02-05,0,0,0,0,2021-02-05,1612479600.0
3305,5,2,2021-02-06,0,0,0,0,2021-02-06,1612566000.0
3306,5,2,2021-02-07,0,0,0,0,2021-02-07,1612652400.0
3307,5,2,2021-02-08,0,0,0,0,2021-02-08,1612738800.0
3308,5,2,2021-02-09,0,0,0,0,2021-02-09,1612825200.0
3309,5,2,2021-02-10,0,0,0,0,2021-02-10,1612911600.0
3310,5,2,2021-02-11,0,0,0,0,2021-02-11,1612998000.0
3311,5,2,2021-02-12,0,0,0,0,2021-02-12,1613084400.0
3312,5,2,2021-02-13,0,0,0,0,2021-02-13,1613170800.0
3313,5,2,2021-02-14,0,0,0,0,2021-02-14,1613257200.0
3314,5,2,2021-02-15,0,0,0,0,2021-02-15,1613343600.0
3315,5,2,2021-02-16,0,0,0,0,2021-02-16,1613430000.0
3316,5,2,2021-02-17,0,0,0,0,2021-02-17,1613516400.0
3317,5,2,2021-02-18,0,0,0,0,2021-02-18,1613602800.0
3318,5,2,2021-02-19,0,0,0,0,2021-02-19,1613689200.0
3319,5,2,2021-02-20,0,0,0,0,2021-02-20,1613775600.0
3320,5,2,2021-02-21,0,0,0,0,2021-02-21,1613862000.0
3321,5,2,2021-02-22,0,0,0,0,2021-02-22,1613948400.0
3322,5,2,2021-02-23,0,0,0,0,2021-02-23,1614034800.0
3323,5,2,2021-02-24,0,0,0,0,2021-02-24,1614121200.0
3324,5,2,2021-02-25,0,0,0,0,2021-02-25,1614207600.0
3325,5,2,2021-02-26,0,0,0,0,2021-02-26,1614294000.0
3326,5,2,2021-02-27,0,0,0,0,2021-02-27,1614380400.0
3327,5,2,2021-02-28,0,0,0,0,2021-02-28,1614466800.0
3328,5,2,2021-03-01,0,0,0,0,2021-03-01,1614553200.0
3329,5,2,2021-03-02,0,0,0,0,2021-03-02,1614639600.0
3330,5,2,2021-03-03,0,0,0,0,2021-03-03,1614726000.0
3331,5,2,2021-03-04,0,0,0,0,2021-03-04,1614812400.0
3332,5,2,2021-03-05,0,0,0,0,2021-03-05,1614898800.0
3333,5,2,2021-03-06,0,0,0,0,2021-03-06,1614985200.0
3334,5,2,2021-03-07,0,0,0,0,2021-03-07,1615071600.0
3335,5,2,2021-03-08,0,0,0,0,2021-03-08,1615158000.0
3336,5,2,2021-03-09,0,0,0,0,2021-03-09,1615244400.0
3337,5,2,2021-03-10,0,0,0,0,2021-03-10,1615330800.0
3338,5,2,2021-03-11,0,0,0,0,2021-03-11,1615417200.0
3339,5,2,2021-03-12,0,0,0,0,2021-03-12,1615503600.0
3340,5,2,2021-03-13,0,0,0,0,2021-03-13,1615590000.0
3341,5,2,2021-03-14,0,0,0,0,2021-03-14,1615676400.0
3342,5,2,2021-03-15,0,0,0,0,2021-03-15,1615762800.0
3343,5,2,2021-03-16,0,0,0,0,2021-03-16,1615849200.0
3344,5,2,2021-03-17,0,0,0,0,2021-03-17,1615935600.0
3345,5,2,2021-03-18,0,0,0,0,2021-03-18,1616022000.0
3346,5,2,2021-03-19,0,0,0,0,2021-03-19,1616108400.0
3347,5,2,2021-03-20,0,0,0,0,2021-03-20,1616194800.0
3348,5,2,2021-03-21,0,0,0,0,2021-03-21,1616281200.0
3349,5,2,2021-03-22,0,0,0,0,2021-03-22,1616367600.0
3350,5,2,2021-03-23,0,0,0,0,2021-03-23,1616454000.0
3351,5,2,2021-03-24,0,0,0,0,2021-03-24,1616540400.0
3352,5,2,2021-03-25,0,0,0,0,2021-03-25,1616626800.0
3353,5,2,2021-03-26,0,0,0,0,2021-03-26,1616713200.0
3354,5,2,2021-03-27,0,0,0,0,2021-03-27,1616799600.0
3355,5,2,2021-03-28,0,0,0,0,2021-03-28,1616886000.0
3356,5,2,2021-03-29,2,0,2,0,2021-03-29,1616972400.0
3357,5,2,2021-03-30,0,0,2,0,2021-03-30,1617058800.0
3358,5,2,2021-03-31,0,0,2,0,2021-03-31,1617145200.0
3359,5,2,2021-04-01,0,0,2,0,2021-04-01,1617231600.0
3360,5,2,2021-04-02,0,0,2,0,2021-04-02,1617318000.0
3361,5,2,2021-04-03,0,0,2,0,2021-04-03,1617404400.0
3362,5,2,2021-04-04,0,0,2,0,2021-04-04,1617490800.0
3363,5,2,2021-04-05,0,0,2,0,2021-04-05,1617577200.0
3364,5,2,2021-04-06,0,0,2,0,2021-04-06,1617663600.0
3365,5,2,2021-04-07,0,0,2,0,2021-04-07,1617750000.0
3366,5,2,2021-04-08,1,0,3,0,2021-04-08,1617836400.0
3367,5,2,2021-04-09,0,0,3,0,2021-04-09,1617922800.0
3368,5,2,2021-04-10,0,0,3,0,2021-04-10,1618009200.0
3369,5,2,2021-04-11,0,0,3,0,2021-04-11,1618095600.0
3370,5,2,2021-04-12,0,0,3,0,2021-04-12,1618185600.0
3371,5,2,2021-04-13,0,0,3,0,2021-04-13,1618272000.0
3372,5,2,2021-04-14,0,0,3,0,2021-04-14,1618358400.0
3373,5,2,2021-04-15,0,0,3,0,2021-04-15,1618444800.0
3374,5,2,2021-04-16,0,0,3,0,2021-04-16,1618531200.0
3375,5,2,2021-04-17,0,0,3,0,2021-04-17,1618617600.0
3376,5,2,2021-04-18,0,0,3,0,2021-04-18,1618704000.0
3377,5,2,2021-04-19,0,0,3,0,2021-04-19,1618790400.0
3378,5,2,2021-04-20,0,0,3,0,2021-04-20,1618876800.0
3379,5,2,2021-04-21,0,0,3,0,2021-04-21,1618963200.0
3380,5,2,2021-04-22,0,0,3,0,2021-04-22,1619049600.0
3381,5,2,2021-04-23,0,0,3,0,2021-04-23,1619136000.0
3382,5,2,2021-04-24,0,0,3,0,2021-04-24,1619222400.0
3383,5,2,2021-04-25,0,0,3,0,2021-04-25,1619308800.0
3384,5,2,2021-04-26,0,0,3,0,2021-04-26,1619395200.0
3385,5,2,2021-04-27,0,0,3,0,2021-04-27,1619481600.0
3386,5,2,2021-04-28,0,0,3,0,2021-04-28,1619568000.0
3387,5,2,2021-04-29,0,0,3,0,2021-04-29,1619654400.0
3388,5,2,2021-04-30,0,0,3,0,2021-04-30,1619740800.0
3389,5,2,2021-05-01,0,0,3,0,2021-05-01,1619827200.0
3390,5,2,2021-05-02,0,0,3,0,2021-05-02,1619913600.0
3391,5,2,2021-05-03,0,0,3,0,2021-05-03,1620000000.0
3392,5,2,2021-05-04,0,0,3,0,2021-05-04,1620086400.0
3393,5,2,2021-05-05,0,0,3,0,2021-05-05,1620172800.0
3394,5,2,2021-05-06,0,0,3,0,2021-05-06,1620259200.0
3395,5,2,2021-05-07,0,0,3,0,2021-05-07,1620345600.0
3396,5,2,2021-05-08,0,0,3,0,2021-05-08,1620432000.0
3397,5,2,2021-05-09,0,0,3,0,2021-05-09,1620518400.0
3398,5,2,2021-05-10,0,0,3,0,2021-05-10,1620604800.0
3399,5,2,2021-05-11,0,0,3,0,2021-05-11,1620691200.0
3400,5,2,2021-05-12,0,0,3,0,2021-05-12,1620777600.0
3401,5,2,2021-05-13,0,0,3,0,2021-05-13,1620864000.0
3402,5,2,2021-05-14,0,0,3,0,2021-05-14,1620950400.0
3403,5,2,2021-05-15,0,0,3,0,2021-05-15,1621036800.0
3404,5,2,2021-05-16,0,0,3,0,2021-05-16,1621123200.0
3405,5,2,2021-05-17,0,0,3,0,2021-05-17,1621206000.0
3406,5,2,2021-05-18,0,0,3,0,2021-05-18,1621292400.0
3407,5,2,2021-05-19,0,0,3,0,2021-05-19,1621378800.0
3408,5,2,2021-05-20,0,0,3,0,2021-05-20,1621465200.0
3409,5,2,2021-05-21,0,0,3,0,2021-05-21,1621551600.0
3410,5,2,2021-05-22,0,0,3,0,2021-05-22,1621638000.0
3411,5,2,2021-05-23,0,0,3,0,2021-05-23,1621724400.0
3412,5,2,2021-05-24,0,0,3,0,2021-05-24,1621810800.0
3413,5,2,2021-05-25,0,0,3,0,2021-05-25,1621897200.0
3414,5,2,2021-05-26,0,0,3,0,2021-05-26,1621983600.0
3415,5,2,2021-05-27,0,0,3,0,2021-05-27,1622070000.0
3416,5,2,2021-05-28,0,0,3,0,2021-05-28,1622156400.0
3417,5,2,2021-05-29,0,2,3,2,2021-05-29,1622242800.0
3418,5,2,2021-05-30,0,0,3,2,2021-05-30,1622329200.0
3419,5,2,2021-05-31,0,0,3,2,2021-05-31,1622415600.0
3420,5,2,2021-06-01,0,0,3,2,2021-06-01,1622502000.0
3421,5,2,2021-06-02,0,0,3,2,2021-06-02,1622588400.0
3422,5,2,2021-06-03,0,0,3,2,2021-06-03,1622674800.0
3423,5,2,2021-06-04,0,0,3,2,2021-06-04,1622761200.0
3424,5,2,2021-06-05,0,0,3,2,2021-06-05,1622847600.0
3425,5,2,2021-06-06,0,0,3,2,2021-06-06,1622934000.0
3426,5,2,2021-06-07,0,0,3,2,2021-06-07,1623020400.0
3427,5,2,2021-06-08,0,0,3,2,2021-06-08,1623106800.0
3428,5,2,2021-06-09,0,0,3,2,2021-06-09,1623193200.0
3429,5,2,2021-06-10,0,0,3,2,2021-06-10,1623279600.0
3430,5,2,2021-06-11,0,0,3,2,2021-06-11,1623366000.0
3431,5,2,2021-06-12,0,0,3,2,2021-06-12,1623452400.0
3432,5,2,2021-06-13,0,0,3,2,2021-06-13,1623538800.0
3433,5,2,2021-06-14,0,0,3,2,2021-06-14,1623625200.0
3434,5,2,2021-06-15,0,0,3,2,2021-06-15,1623711600.0
3435,5,2,2021-06-16,0,0,3,2,2021-06-16,1623798000.0
3436,5,2,2021-06-17,0,0,3,2,2021-06-17,1623884400.0
3437,5,2,2021-06-18,0,0,3,2,2021-06-18,1623970800.0
3438,5,2,2021-06-19,0,0,3,2,2021-06-19,1624057200.0
3439,5,2,2021-06-20,0,0,3,2,2021-06-20,1624143600.0
3440,5,2,2021-06-21,0,0,3,2,2021-06-21,1624230000.0
3441,5,2,2021-06-22,0,0,3,2,2021-06-22,1624316400.0
3442,5,2,2021-06-23,0,0,3,2,2021-06-23,1624402800.0
3443,5,2,2021-06-24,0,0,3,2,2021-06-24,1624489200.0
3444,5,2,2021-06-25,0,0,3,2,2021-06-25,1624575600.0
3445,5,2,2021-06-26,0,0,3,2,2021-06-26,1624662000.0
3446,5,2,2021-06-27,0,0,3,2,2021-06-27,1624748400.0
3447,5,2,2021-06-28,0,0,3,2,2021-06-28,1624834800.0
3448,5,2,2021-06-29,0,0,3,2,2021-06-29,1624921200.0
3449,5,2,2021-06-30,0,0,3,2,2021-06-30,1625007600.0
3450,5,2,2021-07-01,0,0,3,2,2021-07-01,1625094000.0
3451,5,2,2021-07-02,0,0,3,2,2021-07-02,1625180400.0
3452,5,2,2021-07-03,0,0,3,2,2021-07-03,1625266800.0
3453,5,2,2021-07-04,0,0,3,2,2021-07-04,1625353200.0
3454,5,2,2021-07-05,0,0,3,2,2021-07-05,1625439600.0
3455,5,2,2021-07-06,0,0,3,2,2021-07-06,1625526000.0
3456,5,3,2020-12-27,0,0,0,0,2020-12-27,1609023600.0
3457,5,3,2020-12-28,0,0,0,0,2020-12-28,1609110000.0
3458,5,3,2020-12-29,0,0,0,0,2020-12-29,1609196400.0
3459,5,3,2020-12-30,0,0,0,0,2020-12-30,1609282800.0
3460,5,3,2020-12-31,0,0,0,0,2020-12-31,1609369200.0
3461,5,3,2021-01-01,0,0,0,0,2021-01-01,1609455600.0
3462,5,3,2021-01-02,0,0,0,0,2021-01-02,1609542000.0
3463,5,3,2021-01-03,0,0,0,0,2021-01-03,1609628400.0
3464,5,3,2021-01-04,0,0,0,0,2021-01-04,1609714800.0
3465,5,3,2021-01-05,0,0,0,0,2021-01-05,1609801200.0
3466,5,3,2021-01-06,0,0,0,0,2021-01-06,1609887600.0
3467,5,3,2021-01-07,0,0,0,0,2021-01-07,1609974000.0
3468,5,3,2021-01-08,0,0,0,0,2021-01-08,1610060400.0
3469,5,3,2021-01-09,0,0,0,0,2021-01-09,1610146800.0
3470,5,3,2021-01-10,0,0,0,0,2021-01-10,1610233200.0
3471,5,3,2021-01-11,0,0,0,0,2021-01-11,1610319600.0
3472,5,3,2021-01-12,0,0,0,0,2021-01-12,1610406000.0
3473,5,3,2021-01-13,0,0,0,0,2021-01-13,1610492400.0
3474,5,3,2021-01-14,0,0,0,0,2021-01-14,1610578800.0
3475,5,3,2021-01-15,0,0,0,0,2021-01-15,1610665200.0
3476,5,3,2021-01-16,0,0,0,0,2021-01-16,1610751600.0
3477,5,3,2021-01-17,0,0,0,0,2021-01-17,1610838000.0
3478,5,3,2021-01-18,0,0,0,0,2021-01-18,1610924400.0
3479,5,3,2021-01-19,0,0,0,0,2021-01-19,1611010800.0
3480,5,3,2021-01-20,0,0,0,0,2021-01-20,1611097200.0
3481,5,3,2021-01-21,0,0,0,0,2021-01-21,1611183600.0
3482,5,3,2021-01-22,0,0,0,0,2021-01-22,1611270000.0
3483,5,3,2021-01-23,0,0,0,0,2021-01-23,1611356400.0
3484,5,3,2021-01-24,0,0,0,0,2021-01-24,1611442800.0
3485,5,3,2021-01-25,0,0,0,0,2021-01-25,1611529200.0
3486,5,3,2021-01-26,0,0,0,0,2021-01-26,1611615600.0
3487,5,3,2021-01-27,0,0,0,0,2021-01-27,1611702000.0
3488,5,3,2021-01-28,0,0,0,0,2021-01-28,1611788400.0
3489,5,3,2021-01-29,0,0,0,0,2021-01-29,1611874800.0
3490,5,3,2021-01-30,0,0,0,0,2021-01-30,1611961200.0
3491,5,3,2021-01-31,0,0,0,0,2021-01-31,1612047600.0
3492,5,3,2021-02-01,0,0,0,0,2021-02-01,1612134000.0
3493,5,3,2021-02-02,0,0,0,0,2021-02-02,1612220400.0
3494,5,3,2021-02-03,0,0,0,0,2021-02-03,1612306800.0
3495,5,3,2021-02-04,0,0,0,0,2021-02-04,1612393200.0
3496,5,3,2021-02-05,0,0,0,0,2021-02-05,1612479600.0
3497,5,3,2021-02-06,0,0,0,0,2021-02-06,1612566000.0
3498,5,3,2021-02-07,0,0,0,0,2021-02-07,1612652400.0
3499,5,3,2021-02-08,0,0,0,0,2021-02-08,1612738800.0
3500,5,3,2021-02-09,0,0,0,0,2021-02-09,1612825200.0
3501,5,3,2021-02-10,0,0,0,0,2021-02-10,1612911600.0
3502,5,3,2021-02-11,0,0,0,0,2021-02-11,1612998000.0
3503,5,3,2021-02-12,0,0,0,0,2021-02-12,1613084400.0
3504,5,3,2021-02-13,0,0,0,0,2021-02-13,1613170800.0
3505,5,3,2021-02-14,0,0,0,0,2021-02-14,1613257200.0
3506,5,3,2021-02-15,0,0,0,0,2021-02-15,1613343600.0
3507,5,3,2021-02-16,0,0,0,0,2021-02-16,1613430000.0
3508,5,3,2021-02-17,0,0,0,0,2021-02-17,1613516400.0
3509,5,3,2021-02-18,0,0,0,0,2021-02-18,1613602800.0
3510,5,3,2021-02-19,0,0,0,0,2021-02-19,1613689200.0
3511,5,3,2021-02-20,0,0,0,0,2021-02-20,1613775600.0
3512,5,3,2021-02-21,0,0,0,0,2021-02-21,1613862000.0
3513,5,3,2021-02-22,0,0,0,0,2021-02-22,1613948400.0
3514,5,3,2021-02-23,0,0,0,0,2021-02-23,1614034800.0
3515,5,3,2021-02-24,0,0,0,0,2021-02-24,1614121200.0
3516,5,3,2021-02-25,0,0,0,0,2021-02-25,1614207600.0
3517,5,3,2021-02-26,0,0,0,0,2021-02-26,1614294000.0
3518,5,3,2021-02-27,0,0,0,0,2021-02-27,1614380400.0
3519,5,3,2021-02-28,0,0,0,0,2021-02-28,1614466800.0
3520,5,3,2021-03-01,0,0,0,0,2021-03-01,1614553200.0
3521,5,3,2021-03-02,0,0,0,0,2021-03-02,1614639600.0
3522,5,3,2021-03-03,0,0,0,0,2021-03-03,1614726000.0
3523,5,3,2021-03-04,0,0,0,0,2021-03-04,1614812400.0
3524,5,3,2021-03-05,0,0,0,0,2021-03-05,1614898800.0
3525,5,3,2021-03-06,0,0,0,0,2021-03-06,1614985200.0
3526,5,3,2021-03-07,0,0,0,0,2021-03-07,1615071600.0
3527,5,3,2021-03-08,0,0,0,0,2021-03-08,1615158000.0
3528,5,3,2021-03-09,0,0,0,0,2021-03-09,1615244400.0
3529,5,3,2021-03-10,0,0,0,0,2021-03-10,1615330800.0
3530,5,3,2021-03-11,0,0,0,0,2021-03-11,1615417200.0
3531,5,3,2021-03-12,0,0,0,0,2021-03-12,1615503600.0
3532,5,3,2021-03-13,0,0,0,0,2021-03-13,1615590000.0
3533,5,3,2021-03-14,0,0,0,0,2021-03-14,1615676400.0
3534,5,3,2021-03-15,0,0,0,0,2021-03-15,1615762800.0
3535,5,3,2021-03-16,0,0,0,0,2021-03-16,1615849200.0
3536,5,3,2021-03-17,0,0,0,0,2021-03-17,1615935600.0
3537,5,3,2021-03-18,0,0,0,0,2021-03-18,1616022000.0
3538,5,3,2021-03-19,0,0,0,0,2021-03-19,1616108400.0
3539,5,3,2021-03-20,0,0,0,0,2021-03-20,1616194800.0
3540,5,3,2021-03-21,0,0,0,0,2021-03-21,1616281200.0
3541,5,3,2021-03-22,0,0,0,0,2021-03-22,1616367600.0
3542,5,3,2021-03-23,0,0,0,0,2021-03-23,1616454000.0
3543,5,3,2021-03-24,0,0,0,0,2021-03-24,1616540400.0
3544,5,3,2021-03-25,0,0,0,0,2021-03-25,1616626800.0
3545,5,3,2021-03-26,0,0,0,0,2021-03-26,1616713200.0
3546,5,3,2021-03-27,0,0,0,0,2021-03-27,1616799600.0
3547,5,3,2021-03-28,0,0,0,0,2021-03-28,1616886000.0
3548,5,3,2021-03-29,0,0,0,0,2021-03-29,1616972400.0
3549,5,3,2021-03-30,0,0,0,0,2021-03-30,1617058800.0
3550,5,3,2021-03-31,0,0,0,0,2021-03-31,1617145200.0
3551,5,3,2021-04-01,0,0,0,0,2021-04-01,1617231600.0
3552,5,3,2021-04-02,0,0,0,0,2021-04-02,1617318000.0
3553,5,3,2021-04-03,0,0,0,0,2021-04-03,1617404400.0
3554,5,3,2021-04-04,0,0,0,0,2021-04-04,1617490800.0
3555,5,3,2021-04-05,0,0,0,0,2021-04-05,1617577200.0
3556,5,3,2021-04-06,0,0,0,0,2021-04-06,1617663600.0
3557,5,3,2021-04-07,0,0,0,0,2021-04-07,1617750000.0
3558,5,3,2021-04-08,0,0,0,0,2021-04-08,1617836400.0
3559,5,3,2021-04-09,0,0,0,0,2021-04-09,1617922800.0
3560,5,3,2021-04-10,0,0,0,0,2021-04-10,1618009200.0
3561,5,3,2021-04-11,0,0,0,0,2021-04-11,1618095600.0
3562,5,3,2021-04-12,0,0,0,0,2021-04-12,1618185600.0
3563,5,3,2021-04-13,0,0,0,0,2021-04-13,1618272000.0
3564,5,3,2021-04-14,0,0,0,0,2021-04-14,1618358400.0
3565,5,3,2021-04-15,0,0,0,0,2021-04-15,1618444800.0
3566,5,3,2021-04-16,0,0,0,0,2021-04-16,1618531200.0
3567,5,3,2021-04-17,0,0,0,0,2021-04-17,1618617600.0
3568,5,3,2021-04-18,0,0,0,0,2021-04-18,1618704000.0
3569,5,3,2021-04-19,0,0,0,0,2021-04-19,1618790400.0
3570,5,3,2021-04-20,0,0,0,0,2021-04-20,1618876800.0
3571,5,3,2021-04-21,0,0,0,0,2021-04-21,1618963200.0
3572,5,3,2021-04-22,0,0,0,0,2021-04-22,1619049600.0
3573,5,3,2021-04-23,0,0,0,0,2021-04-23,1619136000.0
3574,5,3,2021-04-24,0,0,0,0,2021-04-24,1619222400.0
3575,5,3,2021-04-25,0,0,0,0,2021-04-25,1619308800.0
3576,5,3,2021-04-26,0,0,0,0,2021-04-26,1619395200.0
3577,5,3,2021-04-27,0,0,0,0,2021-04-27,1619481600.0
3578,5,3,2021-04-28,0,0,0,0,2021-04-28,1619568000.0
3579,5,3,2021-04-29,0,0,0,0,2021-04-29,1619654400.0
3580,5,3,2021-04-30,0,0,0,0,2021-04-30,1619740800.0
3581,5,3,2021-05-01,0,0,0,0,2021-05-01,1619827200.0
3582,5,3,2021-05-02,0,0,0,0,2021-05-02,1619913600.0
3583,5,3,2021-05-03,0,0,0,0,2021-05-03,1620000000.0
3584,5,3,2021-05-04,0,0,0,0,2021-05-04,1620086400.0
3585,5,3,2021-05-05,0,0,0,0,2021-05-05,1620172800.0
3586,5,3,2021-05-06,0,0,0,0,2021-05-06,1620259200.0
3587,5,3,2021-05-07,0,0,0,0,2021-05-07,1620345600.0
3588,5,3,2021-05-08,0,0,0,0,2021-05-08,1620432000.0
3589,5,3,2021-05-09,0,0,0,0,2021-05-09,1620518400.0
3590,5,3,2021-05-10,0,0,0,0,2021-05-10,1620604800.0
3591,5,3,2021-05-11,0,0,0,0,2021-05-11,1620691200.0
3592,5,3,2021-05-12,0,0,0,0,2021-05-12,1620777600.0
3593,5,3,2021-05-13,0,0,0,0,2021-05-13,1620864000.0
3594,5,3,2021-05-14,0,0,0,0,2021-05-14,1620950400.0
3595,5,3,2021-05-15,0,0,0,0,2021-05-15,1621036800.0
3596,5,3,2021-05-16,0,0,0,0,2021-05-16,1621123200.0
3597,5,3,2021-05-17,0,0,0,0,2021-05-17,1621206000.0
3598,5,3,2021-05-18,0,0,0,0,2021-05-18,1621292400.0
3599,5,3,2021-05-19,0,0,0,0,2021-05-19,1621378800.0
3600,5,3,2021-05-20,0,0,0,0,2021-05-20,1621465200.0
3601,5,3,2021-05-21,0,0,0,0,2021-05-21,1621551600.0
3602,5,3,2021-05-22,0,0,0,0,2021-05-22,1621638000.0
3603,5,3,2021-05-23,0,0,0,0,2021-05-23,1621724400.0
3604,5,3,2021-05-24,0,0,0,0,2021-05-24,1621810800.0
3605,5,3,2021-05-25,0,0,0,0,2021-05-25,1621897200.0
3606,5,3,2021-05-26,0,0,0,0,2021-05-26,1621983600.0
3607,5,3,2021-05-27,0,0,0,0,2021-05-27,1622070000.0
3608,5,3,2021-05-28,0,0,0,0,2021-05-28,1622156400.0
3609,5,3,2021-05-29,0,0,0,0,2021-05-29,1622242800.0
3610,5,3,2021-05-30,0,0,0,0,2021-05-30,1622329200.0
3611,5,3,2021-05-31,0,0,0,0,2021-05-31,1622415600.0
3612,5,3,2021-06-01,0,0,0,0,2021-06-01,1622502000.0
3613,5,3,2021-06-02,0,0,0,0,2021-06-02,1622588400.0
3614,5,3,2021-06-03,0,0,0,0,2021-06-03,1622674800.0
3615,5,3,2021-06-04,0,0,0,0,2021-06-04,1622761200.0
3616,5,3,2021-06-05,0,0,0,0,2021-06-05,1622847600.0
3617,5,3,2021-06-06,0,0,0,0,2021-06-06,1622934000.0
3618,5,3,2021-06-07,0,0,0,0,2021-06-07,1623020400.0
3619,5,3,2021-06-08,0,0,0,0,2021-06-08,1623106800.0
3620,5,3,2021-06-09,0,0,0,0,2021-06-09,1623193200.0
3621,5,3,2021-06-10,0,0,0,0,2021-06-10,1623279600.0
3622,5,3,2021-06-11,0,0,0,0,2021-06-11,1623366000.0
3623,5,3,2021-06-12,0,0,0,0,2021-06-12,1623452400.0
3624,5,3,2021-06-13,0,0,0,0,2021-06-13,1623538800.0
3625,5,3,2021-06-14,0,0,0,0,2021-06-14,1623625200.0
3626,5,3,2021-06-15,0,0,0,0,2021-06-15,1623711600.0
3627,5,3,2021-06-16,0,0,0,0,2021-06-16,1623798000.0
3628,5,3,2021-06-17,0,0,0,0,2021-06-17,1623884400.0
3629,5,3,2021-06-18,0,0,0,0,2021-06-18,1623970800.0
3630,5,3,2021-06-19,0,0,0,0,2021-06-19,1624057200.0
3631,5,3,2021-06-20,0,0,0,0,2021-06-20,1624143600.0
3632,5,3,2021-06-21,0,0,0,0,2021-06-21,1624230000.0
3633,5,3,2021-06-22,0,0,0,0,2021-06-22,1624316400.0
3634,5,3,2021-06-23,0,0,0,0,2021-06-23,1624402800.0
3635,5,3,2021-06-24,0,0,0,0,2021-06-24,1624489200.0
3636,5,3,2021-06-25,0,0,0,0,2021-06-25,1624575600.0
3637,5,3,2021-06-26,0,0,0,0,2021-06-26,1624662000.0
3638,5,3,2021-06-27,0,0,0,0,2021-06-27,1624748400.0
3639,5,3,2021-06-28,0,0,0,0,2021-06-28,1624834800.0
3640,5,3,2021-06-29,0,0,0,0,2021-06-29,1624921200.0
3641,5,3,2021-06-30,0,0,0,0,2021-06-30,1625007600.0
3642,5,3,2021-07-01,0,0,0,0,2021-07-01,1625094000.0
3643,5,3,2021-07-02,0,0,0,0,2021-07-02,1625180400.0
3644,5,3,2021-07-03,0,0,0,0,2021-07-03,1625266800.0
3645,5,3,2021-07-04,0,0,0,0,2021-07-04,1625353200.0
3646,5,3,2021-07-05,0,0,0,0,2021-07-05,1625439600.0
3647,5,3,2021-07-06,0,0,0,0,2021-07-06,1625526000.0
3648,5,4,2020-12-27,0,0,0,0,2020-12-27,1609023600.0
3649,5,4,2020-12-28,0,0,0,0,2020-12-28,1609110000.0
3650,5,4,2020-12-29,0,0,0,0,2020-12-29,1609196400.0
3651,5,4,2020-12-30,0,0,0,0,2020-12-30,1609282800.0
3652,5,4,2020-12-31,0,0,0,0,2020-12-31,1609369200.0
3653,5,4,2021-01-01,0,0,0,0,2021-01-01,1609455600.0
3654,5,4,2021-01-02,0,0,0,0,2021-01-02,1609542000.0
3655,5,4,2021-01-03,0,0,0,0,2021-01-03,1609628400.0
3656,5,4,2021-01-04,0,0,0,0,2021-01-04,1609714800.0
3657,5,4,2021-01-05,0,0,0,0,2021-01-05,1609801200.0
3658,5,4,2021-01-06,0,0,0,0,2021-01-06,1609887600.0
3659,5,4,2021-01-07,0,0,0,0,2021-01-07,1609974000.0
3660,5,4,2021-01-08,0,0,0,0,2021-01-08,1610060400.0
3661,5,4,2021-01-09,0,0,0,0,2021-01-09,1610146800.0
3662,5,4,2021-01-10,0,0,0,0,2021-01-10,1610233200.0
3663,5,4,2021-01-11,0,0,0,0,2021-01-11,1610319600.0
3664,5,4,2021-01-12,0,0,0,0,2021-01-12,1610406000.0
3665,5,4,2021-01-13,0,0,0,0,2021-01-13,1610492400.0
3666,5,4,2021-01-14,0,0,0,0,2021-01-14,1610578800.0
3667,5,4,2021-01-15,0,0,0,0,2021-01-15,1610665200.0
3668,5,4,2021-01-16,0,0,0,0,2021-01-16,1610751600.0
3669,5,4,2021-01-17,0,0,0,0,2021-01-17,1610838000.0
3670,5,4,2021-01-18,0,0,0,0,2021-01-18,1610924400.0
3671,5,4,2021-01-19,0,0,0,0,2021-01-19,1611010800.0
3672,5,4,2021-01-20,0,0,0,0,2021-01-20,1611097200.0
3673,5,4,2021-01-21,0,0,0,0,2021-01-21,1611183600.0
3674,5,4,2021-01-22,0,0,0,0,2021-01-22,1611270000.0
3675,5,4,2021-01-23,0,0,0,0,2021-01-23,1611356400.0
3676,5,4,2021-01-24,0,0,0,0,2021-01-24,1611442800.0
3677,5,4,2021-01-25,0,0,0,0,2021-01-25,1611529200.0
3678,5,4,2021-01-26,0,0,0,0,2021-01-26,1611615600.0
3679,5,4,2021-01-27,0,0,0,0,2021-01-27,1611702000.0
3680,5,4,2021-01-28,0,0,0,0,2021-01-28,1611788400.0
3681,5,4,2021-01-29,0,0,0,0,2021-01-29,1611874800.0
3682,5,4,2021-01-30,0,0,0,0,2021-01-30,1611961200.0
3683,5,4,2021-01-31,0,0,0,0,2021-01-31,1612047600.0
3684,5,4,2021-02-01,0,0,0,0,2021-02-01,1612134000.0
3685,5,4,2021-02-02,0,0,0,0,2021-02-02,1612220400.0
3686,5,4,2021-02-03,0,0,0,0,2021-02-03,1612306800.0
3687,5,4,2021-02-04,0,0,0,0,2021-02-04,1612393200.0
3688,5,4,2021-02-05,0,0,0,0,2021-02-05,1612479600.0
3689,5,4,2021-02-06,0,0,0,0,2021-02-06,1612566000.0
3690,5,4,2021-02-07,0,0,0,0,2021-02-07,1612652400.0
3691,5,4,2021-02-08,0,0,0,0,2021-02-08,1612738800.0
3692,5,4,2021-02-09,0,0,0,0,2021-02-09,1612825200.0
3693,5,4,2021-02-10,0,0,0,0,2021-02-10,1612911600.0
3694,5,4,2021-02-11,0,0,0,0,2021-02-11,1612998000.0
3695,5,4,2021-02-12,0,0,0,0,2021-02-12,1613084400.0
3696,5,4,2021-02-13,0,0,0,0,2021-02-13,1613170800.0
3697,5,4,2021-02-14,0,0,0,0,2021-02-14,1613257200.0
3698,5,4,2021-02-15,0,0,0,0,2021-02-15,1613343600.0
3699,5,4,2021-02-16,0,0,0,0,2021-02-16,1613430000.0
3700,5,4,2021-02-17,0,0,0,0,2021-02-17,1613516400.0
3701,5,4,2021-02-18,0,0,0,0,2021-02-18,1613602800.0
3702,5,4,2021-02-19,0,0,0,0,2021-02-19,1613689200.0
3703,5,4,2021-02-20,0,0,0,0,2021-02-20,1613775600.0
3704,5,4,2021-02-21,0,0,0,0,2021-02-21,1613862000.0
3705,5,4,2021-02-22,0,0,0,0,2021-02-22,1613948400.0
3706,5,4,2021-02-23,0,0,0,0,2021-02-23,1614034800.0
3707,5,4,2021-02-24,0,0,0,0,2021-02-24,1614121200.0
3708,5,4,2021-02-25,0,0,0,0,2021-02-25,1614207600.0
3709,5,4,2021-02-26,0,0,0,0,2021-02-26,1614294000.0
3710,5,4,2021-02-27,0,0,0,0,2021-02-27,1614380400.0
3711,5,4,2021-02-28,0,0,0,0,2021-02-28,1614466800.0
3712,5,4,2021-03-01,0,0,0,0,2021-03-01,1614553200.0
3713,5,4,2021-03-02,0,0,0,0,2021-03-02,1614639600.0
3714,5,4,2021-03-03,0,0,0,0,2021-03-03,1614726000.0
3715,5,4,2021-03-04,0,0,0,0,2021-03-04,1614812400.0
3716,5,4,2021-03-05,0,0,0,0,2021-03-05,1614898800.0
3717,5,4,2021-03-06,0,0,0,0,2021-03-06,1614985200.0
3718,5,4,2021-03-07,0,0,0,0,2021-03-07,1615071600.0
3719,5,4,2021-03-08,0,0,0,0,2021-03-08,1615158000.0
3720,5,4,2021-03-09,0,0,0,0,2021-03-09,1615244400.0
3721,5,4,2021-03-10,0,0,0,0,2021-03-10,1615330800.0
3722,5,4,2021-03-11,0,0,0,0,2021-03-11,1615417200.0
3723,5,4,2021-03-12,0,0,0,0,2021-03-12,1615503600.0
3724,5,4,2021-03-13,0,0,0,0,2021-03-13,1615590000.0
3725,5,4,2021-03-14,0,0,0,0,2021-03-14,1615676400.0
3726,5,4,2021-03-15,0,0,0,0,2021-03-15,1615762800.0
3727,5,4,2021-03-16,0,0,0,0,2021-03-16,1615849200.0
3728,5,4,2021-03-17,0,0,0,0,2021-03-17,1615935600.0
3729,5,4,2021-03-18,0,0,0,0,2021-03-18,1616022000.0
3730,5,4,2021-03-19,0,0,0,0,2021-03-19,1616108400.0
3731,5,4,2021-03-20,0,0,0,0,2021-03-20,1616194800.0
3732,5,4,2021-03-21,0,0,0,0,2021-03-21,1616281200.0
3733,5,4,2021-03-22,0,0,0,0,2021-03-22,1616367600.0
3734,5,4,2021-03-23,0,0,0,0,2021-03-23,1616454000.0
3735,5,4,2021-03-24,0,0,0,0,2021-03-24,1616540400.0
3736,5,4,2021-03-25,0,0,0,0,2021-03-25,1616626800.0
3737,5,4,2021-03-26,0,0,0,0,2021-03-26,1616713200.0
3738,5,4,2021-03-27,0,0,0,0,2021-03-27,1616799600.0
3739,5,4,2021-03-28,0,0,0,0,2021-03-28,1616886000.0
3740,5,4,2021-03-29,0,0,0,0,2021-03-29,1616972400.0
3741,5,4,2021-03-30,0,0,0,0,2021-03-30,1617058800.0
3742,5,4,2021-03-31,0,0,0,0,2021-03-31,1617145200.0
3743,5,4,2021-04-01,0,0,0,0,2021-04-01,1617231600.0
3744,5,4,2021-04-02,0,0,0,0,2021-04-02,1617318000.0
3745,5,4,2021-04-03,0,0,0,0,2021-04-03,1617404400.0
3746,5,4,2021-04-04,0,0,0,0,2021-04-04,1617490800.0
3747,5,4,2021-04-05,0,0,0,0,2021-04-05,1617577200.0
3748,5,4,2021-04-06,0,0,0,0,2021-04-06,1617663600.0
3749,5,4,2021-04-07,0,0,0,0,2021-04-07,1617750000.0
3750,5,4,2021-04-08,0,0,0,0,2021-04-08,1617836400.0
3751,5,4,2021-04-09,0,0,0,0,2021-04-09,1617922800.0
3752,5,4,2021-04-10,0,0,0,0,2021-04-10,1618009200.0
3753,5,4,2021-04-11,0,0,0,0,2021-04-11,1618095600.0
3754,5,4,2021-04-12,0,0,0,0,2021-04-12,1618185600.0
3755,5,4,2021-04-13,0,0,0,0,2021-04-13,1618272000.0
3756,5,4,2021-04-14,0,0,0,0,2021-04-14,1618358400.0
3757,5,4,2021-04-15,0,0,0,0,2021-04-15,1618444800.0
3758,5,4,2021-04-16,0,0,0,0,2021-04-16,1618531200.0
3759,5,4,2021-04-17,0,0,0,0,2021-04-17,1618617600.0
3760,5,4,2021-04-18,0,0,0,0,2021-04-18,1618704000.0
3761,5,4,2021-04-19,0,0,0,0,2021-04-19,1618790400.0
3762,5,4,2021-04-20,0,0,0,0,2021-04-20,1618876800.0
3763,5,4,2021-04-21,0,0,0,0,2021-04-21,1618963200.0
3764,5,4,2021-04-22,0,0,0,0,2021-04-22,1619049600.0
3765,5,4,2021-04-23,0,0,0,0,2021-04-23,1619136000.0
3766,5,4,2021-04-24,0,0,0,0,2021-04-24,1619222400.0
3767,5,4,2021-04-25,0,0,0,0,2021-04-25,1619308800.0
3768,5,4,2021-04-26,0,0,0,0,2021-04-26,1619395200.0
3769,5,4,2021-04-27,0,0,0,0,2021-04-27,1619481600.0
3770,5,4,2021-04-28,0,0,0,0,2021-04-28,1619568000.0
3771,5,4,2021-04-29,0,0,0,0,2021-04-29,1619654400.0
3772,5,4,2021-04-30,0,0,0,0,2021-04-30,1619740800.0
3773,5,4,2021-05-01,0,0,0,0,2021-05-01,1619827200.0
3774,5,4,2021-05-02,0,0,0,0,2021-05-02,1619913600.0
3775,5,4,2021-05-03,0,0,0,0,2021-05-03,1620000000.0
3776,5,4,2021-05-04,0,0,0,0,2021-05-04,1620086400.0
3777,5,4,2021-05-05,0,0,0,0,2021-05-05,1620172800.0
3778,5,4,2021-05-06,0,0,0,0,2021-05-06,1620259200.0
3779,5,4,2021-05-07,0,0,0,0,2021-05-07,1620345600.0
3780,5,4,2021-05-08,0,0,0,0,2021-05-08,1620432000.0
3781,5,4,2021-05-09,0,0,0,0,2021-05-09,1620518400.0
3782,5,4,2021-05-10,0,0,0,0,2021-05-10,1620604800.0
3783,5,4,2021-05-11,0,0,0,0,2021-05-11,1620691200.0
3784,5,4,2021-05-12,0,0,0,0,2021-05-12,1620777600.0
3785,5,4,2021-05-13,0,0,0,0,2021-05-13,1620864000.0
3786,5,4,2021-05-14,0,0,0,0,2021-05-14,1620950400.0
3787,5,4,2021-05-15,0,0,0,0,2021-05-15,1621036800.0
3788,5,4,2021-05-16,0,0,0,0,2021-05-16,1621123200.0
3789,5,4,2021-05-17,0,0,0,0,2021-05-17,1621206000.0
3790,5,4,2021-05-18,0,0,0,0,2021-05-18,1621292400.0
3791,5,4,2021-05-19,0,0,0,0,2021-05-19,1621378800.0
3792,5,4,2021-05-20,0,0,0,0,2021-05-20,1621465200.0
3793,5,4,2021-05-21,0,0,0,0,2021-05-21,1621551600.0
3794,5,4,2021-05-22,0,0,0,0,2021-05-22,1621638000.0
3795,5,4,2021-05-23,0,0,0,0,2021-05-23,1621724400.0
3796,5,4,2021-05-24,0,0,0,0,2021-05-24,1621810800.0
3797,5,4,2021-05-25,0,0,0,0,2021-05-25,1621897200.0
3798,5,4,2021-05-26,0,0,0,0,2021-05-26,1621983600.0
3799,5,4,2021-05-27,0,0,0,0,2021-05-27,1622070000.0
3800,5,4,2021-05-28,0,0,0,0,2021-05-28,1622156400.0
3801,5,4,2021-05-29,0,0,0,0,2021-05-29,1622242800.0
3802,5,4,2021-05-30,0,0,0,0,2021-05-30,1622329200.0
3803,5,4,2021-05-31,0,0,0,0,2021-05-31,1622415600.0
3804,5,4,2021-06-01,0,0,0,0,2021-06-01,1622502000.0
3805,5,4,2021-06-02,0,0,0,0,2021-06-02,1622588400.0
3806,5,4,2021-06-03,0,0,0,0,2021-06-03,1622674800.0
3807,5,4,2021-06-04,0,0,0,0,2021-06-04,1622761200.0
3808,5,4,2021-06-05,0,0,0,0,2021-06-05,1622847600.0
3809,5,4,2021-06-06,0,0,0,0,2021-06-06,1622934000.0
3810,5,4,2021-06-07,0,0,0,0,2021-06-07,1623020400.0
3811,5,4,2021-06-08,0,0,0,0,2021-06-08,1623106800.0
3812,5,4,2021-06-09,0,0,0,0,2021-06-09,1623193200.0
3813,5,4,2021-06-10,0,0,0,0,2021-06-10,1623279600.0
3814,5,4,2021-06-11,0,0,0,0,2021-06-11,1623366000.0
3815,5,4,2021-06-12,0,0,0,0,2021-06-12,1623452400.0
3816,5,4,2021-06-13,0,0,0,0,2021-06-13,1623538800.0
3817,5,4,2021-06-14,0,0,0,0,2021-06-14,1623625200.0
3818,5,4,2021-06-15,0,0,0,0,2021-06-15,1623711600.0
3819,5,4,2021-06-16,0,0,0,0,2021-06-16,1623798000.0
3820,5,4,2021-06-17,0,0,0,0,2021-06-17,1623884400.0
3821,5,4,2021-06-18,0,0,0,0,2021-06-18,1623970800.0
3822,5,4,2021-06-19,0,0,0,0,2021-06-19,1624057200.0
3823,5,4,2021-06-20,0,0,0,0,2021-06-20,1624143600.0
3824,5,4,2021-06-21,0,0,0,0,2021-06-21,1624230000.0
3825,5,4,2021-06-22,0,0,0,0,2021-06-22,1624316400.0
3826,5,4,2021-06-23,0,0,0,0,2021-06-23,1624402800.0
3827,5,4,2021-06-24,0,0,0,0,2021-06-24,1624489200.0
3828,5,4,2021-06-25,0,0,0,0,2021-06-25,1624575600.0
3829,5,4,2021-06-26,0,0,0,0,2021-06-26,1624662000.0
3830,5,4,2021-06-27,0,0,0,0,2021-06-27,1624748400.0
3831,5,4,2021-06-28,0,0,0,0,2021-06-28,1624834800.0
3832,5,4,2021-06-29,0,0,0,0,2021-06-29,1624921200.0
3833,5,4,2021-06-30,0,0,0,0,2021-06-30,1625007600.0
3834,5,4,2021-07-01,0,0,0,0,2021-07-01,1625094000.0
3835,5,4,2021-07-02,0,0,0,0,2021-07-02,1625180400.0
3836,5,4,2021-07-03,0,0,0,0,2021-07-03,1625266800.0
3837,5,4,2021-07-04,0,0,0,0,2021-07-04,1625353200.0
3838,5,4,2021-07-05,0,0,0,0,2021-07-05,1625439600.0
3839,5,4,2021-07-06,0,0,0,0,2021-07-06,1625526000.0
3840,6,1,2020-12-27,0,0,0,0,2020-12-27,1609023600.0
3841,6,1,2020-12-28,0,0,0,0,2020-12-28,1609110000.0
3842,6,1,2020-12-29,0,0,0,0,2020-12-29,1609196400.0
3843,6,1,2020-12-30,0,0,0,0,2020-12-30,1609282800.0
3844,6,1,2020-12-31,0,0,0,0,2020-12-31,1609369200.0
3845,6,1,2021-01-01,0,0,0,0,2021-01-01,1609455600.0
3846,6,1,2021-01-02,0,0,0,0,2021-01-02,1609542000.0
3847,6,1,2021-01-03,0,0,0,0,2021-01-03,1609628400.0
3848,6,1,2021-01-04,0,0,0,0,2021-01-04,1609714800.0
3849,6,1,2021-01-05,0,0,0,0,2021-01-05,1609801200.0
3850,6,1,2021-01-06,0,0,0,0,2021-01-06,1609887600.0
3851,6,1,2021-01-07,0,0,0,0,2021-01-07,1609974000.0
3852,6,1,2021-01-08,0,0,0,0,2021-01-08,1610060400.0
3853,6,1,2021-01-09,0,0,0,0,2021-01-09,1610146800.0
3854,6,1,2021-01-10,0,0,0,0,2021-01-10,1610233200.0
3855,6,1,2021-01-11,9,0,9,0,2021-01-11,1610319600.0
3856,6,1,2021-01-12,0,0,9,0,2021-01-12,1610406000.0
3857,6,1,2021-01-13,0,0,9,0,2021-01-13,1610492400.0
3858,6,1,2021-01-14,0,0,9,0,2021-01-14,1610578800.0
3859,6,1,2021-01-15,1,0,10,0,2021-01-15,1610665200.0
3860,6,1,2021-01-16,1,0,11,0,2021-01-16,1610751600.0
3861,6,1,2021-01-17,0,0,11,0,2021-01-17,1610838000.0
3862,6,1,2021-01-18,1,0,12,0,2021-01-18,1610924400.0
3863,6,1,2021-01-19,0,0,12,0,2021-01-19,1611010800.0
3864,6,1,2021-01-20,0,0,12,0,2021-01-20,1611097200.0
3865,6,1,2021-01-21,0,0,12,0,2021-01-21,1611183600.0
3866,6,1,2021-01-22,0,0,12,0,2021-01-22,1611270000.0
3867,6,1,2021-01-23,1,0,13,0,2021-01-23,1611356400.0
3868,6,1,2021-01-24,0,0,13,0,2021-01-24,1611442800.0
3869,6,1,2021-01-25,141,0,154,0,2021-01-25,1611529200.0
3870,6,1,2021-01-26,165,0,319,0,2021-01-26,1611615600.0
3871,6,1,2021-01-27,250,0,569,0,2021-01-27,1611702000.0
3872,6,1,2021-01-28,102,5,671,5,2021-01-28,1611788400.0
3873,6,1,2021-01-29,231,1,902,6,2021-01-29,1611874800.0
3874,6,1,2021-01-30,285,2,1187,8,2021-01-30,1611961200.0
3875,6,1,2021-01-31,1,0,1188,8,2021-01-31,1612047600.0
3876,6,1,2021-02-01,160,0,1348,8,2021-02-01,1612134000.0
3877,6,1,2021-02-02,330,0,1678,8,2021-02-02,1612220400.0
3878,6,1,2021-02-03,228,0,1906,8,2021-02-03,1612306800.0
3879,6,1,2021-02-04,215,3,2121,11,2021-02-04,1612393200.0
3880,6,1,2021-02-05,214,0,2335,11,2021-02-05,1612479600.0
3881,6,1,2021-02-06,83,10,2418,21,2021-02-06,1612566000.0
3882,6,1,2021-02-07,0,0,2418,21,2021-02-07,1612652400.0
3883,6,1,2021-02-08,82,2,2500,23,2021-02-08,1612738800.0
3884,6,1,2021-02-09,194,0,2694,23,2021-02-09,1612825200.0
3885,6,1,2021-02-10,187,1,2881,24,2021-02-10,1612911600.0
3886,6,1,2021-02-11,236,0,3117,24,2021-02-11,1612998000.0
3887,6,1,2021-02-12,287,1,3404,25,2021-02-12,1613084400.0
3888,6,1,2021-02-13,56,0,3460,25,2021-02-13,1613170800.0
3889,6,1,2021-02-14,1,0,3461,25,2021-02-14,1613257200.0
3890,6,1,2021-02-15,359,1,3820,26,2021-02-15,1613343600.0
3891,6,1,2021-02-16,266,3,4086,29,2021-02-16,1613430000.0
3892,6,1,2021-02-17,167,0,4253,29,2021-02-17,1613516400.0
3893,6,1,2021-02-18,217,1,4470,30,2021-02-18,1613602800.0
3894,6,1,2021-02-19,235,14,4705,44,2021-02-19,1613689200.0
3895,6,1,2021-02-20,139,4,4844,48,2021-02-20,1613775600.0
3896,6,1,2021-02-21,0,0,4844,48,2021-02-21,1613862000.0
3897,6,1,2021-02-22,130,118,4974,166,2021-02-22,1613948400.0
3898,6,1,2021-02-23,185,149,5159,315,2021-02-23,1614034800.0
3899,6,1,2021-02-24,176,140,5335,455,2021-02-24,1614121200.0
3900,6,1,2021-02-25,227,280,5562,735,2021-02-25,1614207600.0
3901,6,1,2021-02-26,242,257,5804,992,2021-02-26,1614294000.0
3902,6,1,2021-02-27,0,0,5804,992,2021-02-27,1614380400.0
3903,6,1,2021-02-28,0,0,5804,992,2021-02-28,1614466800.0
3904,6,1,2021-03-01,145,258,5949,1250,2021-03-01,1614553200.0
3905,6,1,2021-03-02,228,255,6177,1505,2021-03-02,1614639600.0
3906,6,1,2021-03-03,202,183,6379,1688,2021-03-03,1614726000.0
3907,6,1,2021-03-04,205,136,6584,1824,2021-03-04,1614812400.0
3908,6,1,2021-03-05,224,109,6808,1933,2021-03-05,1614898800.0
3909,6,1,2021-03-06,1,0,6809,1933,2021-03-06,1614985200.0
3910,6,1,2021-03-07,0,0,6809,1933,2021-03-07,1615071600.0
3911,6,1,2021-03-08,189,124,6998,2057,2021-03-08,1615158000.0
3912,6,1,2021-03-09,390,139,7388,2196,2021-03-09,1615244400.0
3913,6,1,2021-03-10,180,175,7568,2371,2021-03-10,1615330800.0
3914,6,1,2021-03-11,167,204,7735,2575,2021-03-11,1615417200.0
3915,6,1,2021-03-12,238,287,7973,2862,2021-03-12,1615503600.0
3916,6,1,2021-03-13,1,0,7974,2862,2021-03-13,1615590000.0
3917,6,1,2021-03-14,0,0,7974,2862,2021-03-14,1615676400.0
3918,6,1,2021-03-15,157,287,8131,3149,2021-03-15,1615762800.0
3919,6,1,2021-03-16,236,207,8367,3356,2021-03-16,1615849200.0
3920,6,1,2021-03-17,264,130,8631,3486,2021-03-17,1615935600.0
3921,6,1,2021-03-18,172,216,8803,3702,2021-03-18,1616022000.0
3922,6,1,2021-03-19,172,278,8975,3980,2021-03-19,1616108400.0
3923,6,1,2021-03-20,0,0,8975,3980,2021-03-20,1616194800.0
3924,6,1,2021-03-21,0,0,8975,3980,2021-03-21,1616281200.0
3925,6,1,2021-03-22,97,125,9072,4105,2021-03-22,1616367600.0
3926,6,1,2021-03-23,136,234,9208,4339,2021-03-23,1616454000.0
3927,6,1,2021-03-24,160,125,9368,4464,2021-03-24,1616540400.0
3928,6,1,2021-03-25,186,192,9554,4656,2021-03-25,1616626800.0
3929,6,1,2021-03-26,160,204,9714,4860,2021-03-26,1616713200.0
3930,6,1,2021-03-27,18,0,9732,4860,2021-03-27,1616799600.0
3931,6,1,2021-03-28,0,0,9732,4860,2021-03-28,1616886000.0
3932,6,1,2021-03-29,0,2,9732,4862,2021-03-29,1616972400.0
3933,6,1,2021-03-30,272,301,10004,5163,2021-03-30,1617058800.0
3934,6,1,2021-03-31,225,112,10229,5275,2021-03-31,1617145200.0
3935,6,1,2021-04-01,243,86,10472,5361,2021-04-01,1617231600.0
3936,6,1,2021-04-02,286,232,10758,5593,2021-04-02,1617318000.0
3937,6,1,2021-04-03,906,243,11664,5836,2021-04-03,1617404400.0
3938,6,1,2021-04-04,1,0,11665,5836,2021-04-04,1617490800.0
3939,6,1,2021-04-05,1,0,11666,5836,2021-04-05,1617577200.0
3940,6,1,2021-04-06,160,261,11826,6097,2021-04-06,1617663600.0
3941,6,1,2021-04-07,237,241,12063,6338,2021-04-07,1617750000.0
3942,6,1,2021-04-08,286,116,12349,6454,2021-04-08,1617836400.0
3943,6,1,2021-04-09,248,147,12597,6601,2021-04-09,1617922800.0
3944,6,1,2021-04-10,181,87,12778,6688,2021-04-10,1618009200.0
3945,6,1,2021-04-11,7,0,12785,6688,2021-04-11,1618095600.0
3946,6,1,2021-04-12,0,19,12785,6707,2021-04-12,1618185600.0
3947,6,1,2021-04-13,393,318,13178,7025,2021-04-13,1618272000.0
3948,6,1,2021-04-14,239,186,13417,7211,2021-04-14,1618358400.0
3949,6,1,2021-04-15,207,91,13624,7302,2021-04-15,1618444800.0
3950,6,1,2021-04-16,214,103,13838,7405,2021-04-16,1618531200.0
3951,6,1,2021-04-17,226,107,14064,7512,2021-04-17,1618617600.0
3952,6,1,2021-04-18,1,0,14065,7512,2021-04-18,1618704000.0
3953,6,1,2021-04-19,7,1,14072,7513,2021-04-19,1618790400.0
3954,6,1,2021-04-20,368,192,14440,7705,2021-04-20,1618876800.0
3955,6,1,2021-04-21,412,109,14852,7814,2021-04-21,1618963200.0
3956,6,1,2021-04-22,410,110,15262,7924,2021-04-22,1619049600.0
3957,6,1,2021-04-23,367,120,15629,8044,2021-04-23,1619136000.0
3958,6,1,2021-04-24,413,88,16042,8132,2021-04-24,1619222400.0
3959,6,1,2021-04-25,2,0,16044,8132,2021-04-25,1619308800.0
3960,6,1,2021-04-26,54,0,16098,8132,2021-04-26,1619395200.0
3961,6,1,2021-04-27,351,255,16449,8387,2021-04-27,1619481600.0
3962,6,1,2021-04-28,354,472,16803,8859,2021-04-28,1619568000.0
3963,6,1,2021-04-29,558,293,17361,9152,2021-04-29,1619654400.0
3964,6,1,2021-04-30,403,195,17764,9347,2021-04-30,1619740800.0
3965,6,1,2021-05-01,670,209,18434,9556,2021-05-01,1619827200.0
3966,6,1,2021-05-02,0,0,18434,9556,2021-05-02,1619913600.0
3967,6,1,2021-05-03,139,0,18573,9556,2021-05-03,1620000000.0
3968,6,1,2021-05-04,353,380,18926,9936,2021-05-04,1620086400.0
3969,6,1,2021-05-05,447,255,19373,10191,2021-05-05,1620172800.0
3970,6,1,2021-05-06,320,156,19693,10347,2021-05-06,1620259200.0
3971,6,1,2021-05-07,341,90,20034,10437,2021-05-07,1620345600.0
3972,6,1,2021-05-08,300,115,20334,10552,2021-05-08,1620432000.0
3973,6,1,2021-05-09,0,0,20334,10552,2021-05-09,1620518400.0
3974,6,1,2021-05-10,8,9,20342,10561,2021-05-10,1620604800.0
3975,6,1,2021-05-11,359,429,20701,10990,2021-05-11,1620691200.0
3976,6,1,2021-05-12,332,251,21033,11241,2021-05-12,1620777600.0
3977,6,1,2021-05-13,127,71,21160,11312,2021-05-13,1620864000.0
3978,6,1,2021-05-14,0,0,21160,11312,2021-05-14,1620950400.0
3979,6,1,2021-05-15,484,192,21644,11504,2021-05-15,1621036800.0
3980,6,1,2021-05-16,0,0,21644,11504,2021-05-16,1621123200.0
3981,6,1,2021-05-17,121,29,21765,11533,2021-05-17,1621206000.0
3982,6,1,2021-05-18,514,354,22279,11887,2021-05-18,1621292400.0
3983,6,1,2021-05-19,650,565,22929,12452,2021-05-19,1621378800.0
3984,6,1,2021-05-20,1055,350,23984,12802,2021-05-20,1621465200.0
3985,6,1,2021-05-21,1046,195,25030,12997,2021-05-21,1621551600.0
3986,6,1,2021-05-22,1241,173,26271,13170,2021-05-22,1621638000.0
3987,6,1,2021-05-23,0,0,26271,13170,2021-05-23,1621724400.0
3988,6,1,2021-05-24,1,0,26272,13170,2021-05-24,1621810800.0
3989,6,1,2021-05-25,882,522,27154,13692,2021-05-25,1621897200.0
3990,6,1,2021-05-26,1035,716,28189,14408,2021-05-26,1621983600.0
3991,6,1,2021-05-27,1310,351,29499,14759,2021-05-27,1622070000.0
3992,6,1,2021-05-28,952,231,30451,14990,2021-05-28,1622156400.0
3993,6,1,2021-05-29,1130,227,31581,15217,2021-05-29,1622242800.0
3994,6,1,2021-05-30,0,0,31581,15217,2021-05-30,1622329200.0
3995,6,1,2021-05-31,104,3,31685,15220,2021-05-31,1622415600.0
3996,6,1,2021-06-01,1147,487,32832,15707,2021-06-01,1622502000.0
3997,6,1,2021-06-02,1198,295,34030,16002,2021-06-02,1622588400.0
3998,6,1,2021-06-03,804,195,34834,16197,2021-06-03,1622674800.0
3999,6,1,2021-06-04,993,180,35827,16377,2021-06-04,1622761200.0
4000,6,1,2021-06-05,673,210,36500,16587,2021-06-05,1622847600.0
4001,6,1,2021-06-06,1,0,36501,16587,2021-06-06,1622934000.0
4002,6,1,2021-06-07,84,5,36585,16592,2021-06-07,1623020400.0
4003,6,1,2021-06-08,928,320,37513,16912,2021-06-08,1623106800.0
4004,6,1,2021-06-09,958,421,38471,17333,2021-06-09,1623193200.0
4005,6,1,2021-06-10,664,139,39135,17472,2021-06-10,1623279600.0
4006,6,1,2021-06-11,831,252,39966,17724,2021-06-11,1623366000.0
4007,6,1,2021-06-12,565,214,40531,17938,2021-06-12,1623452400.0
4008,6,1,2021-06-13,0,0,40531,17938,2021-06-13,1623538800.0
4009,6,1,2021-06-14,178,84,40709,18022,2021-06-14,1623625200.0
4010,6,1,2021-06-15,399,764,41108,18786,2021-06-15,1623711600.0
4011,6,1,2021-06-16,880,1306,41988,20092,2021-06-16,1623798000.0
4012,6,1,2021-06-17,757,578,42745,20670,2021-06-17,1623884400.0
4013,6,1,2021-06-18,686,524,43431,21194,2021-06-18,1623970800.0
4014,6,1,2021-06-19,527,591,43958,21785,2021-06-19,1624057200.0
4015,6,1,2021-06-20,0,0,43958,21785,2021-06-20,1624143600.0
4016,6,1,2021-06-21,124,115,44082,21900,2021-06-21,1624230000.0
4017,6,1,2021-06-22,424,1084,44506,22984,2021-06-22,1624316400.0
4018,6,1,2021-06-23,647,1103,45153,24087,2021-06-23,1624402800.0
4019,6,1,2021-06-24,456,494,45609,24581,2021-06-24,1624489200.0
4020,6,1,2021-06-25,523,413,46132,24994,2021-06-25,1624575600.0
4021,6,1,2021-06-26,382,641,46514,25635,2021-06-26,1624662000.0
4022,6,1,2021-06-27,0,0,46514,25635,2021-06-27,1624748400.0
4023,6,1,2021-06-28,99,175,46613,25810,2021-06-28,1624834800.0
4024,6,1,2021-06-29,610,919,47223,26729,2021-06-29,1624921200.0
4025,6,1,2021-06-30,630,879,47853,27608,2021-06-30,1625007600.0
4026,6,1,2021-07-01,541,493,48394,28101,2021-07-01,1625094000.0
4027,6,1,2021-07-02,430,381,48824,28482,2021-07-02,1625180400.0
4028,6,1,2021-07-03,434,371,49258,28853,2021-07-03,1625266800.0
4029,6,1,2021-07-04,0,0,49258,28853,2021-07-04,1625353200.0
4030,6,1,2021-07-05,64,208,49322,29061,2021-07-05,1625439600.0
4031,6,1,2021-07-06,493,796,49815,29857,2021-07-06,1625526000.0
4032,6,2,2020-12-27,0,0,0,0,2020-12-27,1609023600.0
4033,6,2,2020-12-28,0,0,0,0,2020-12-28,1609110000.0
4034,6,2,2020-12-29,0,0,0,0,2020-12-29,1609196400.0
4035,6,2,2020-12-30,0,0,0,0,2020-12-30,1609282800.0
4036,6,2,2020-12-31,0,0,0,0,2020-12-31,1609369200.0
4037,6,2,2021-01-01,0,0,0,0,2021-01-01,1609455600.0
4038,6,2,2021-01-02,0,0,0,0,2021-01-02,1609542000.0
4039,6,2,2021-01-03,0,0,0,0,2021-01-03,1609628400.0
4040,6,2,2021-01-04,0,0,0,0,2021-01-04,1609714800.0
4041,6,2,2021-01-05,0,0,0,0,2021-01-05,1609801200.0
4042,6,2,2021-01-06,0,0,0,0,2021-01-06,1609887600.0
4043,6,2,2021-01-07,0,0,0,0,2021-01-07,1609974000.0
4044,6,2,2021-01-08,0,0,0,0,2021-01-08,1610060400.0
4045,6,2,2021-01-09,0,0,0,0,2021-01-09,1610146800.0
4046,6,2,2021-01-10,0,0,0,0,2021-01-10,1610233200.0
4047,6,2,2021-01-11,0,0,0,0,2021-01-11,1610319600.0
4048,6,2,2021-01-12,0,0,0,0,2021-01-12,1610406000.0
4049,6,2,2021-01-13,0,0,0,0,2021-01-13,1610492400.0
4050,6,2,2021-01-14,0,0,0,0,2021-01-14,1610578800.0
4051,6,2,2021-01-15,0,0,0,0,2021-01-15,1610665200.0
4052,6,2,2021-01-16,0,0,0,0,2021-01-16,1610751600.0
4053,6,2,2021-01-17,0,0,0,0,2021-01-17,1610838000.0
4054,6,2,2021-01-18,0,0,0,0,2021-01-18,1610924400.0
4055,6,2,2021-01-19,0,0,0,0,2021-01-19,1611010800.0
4056,6,2,2021-01-20,0,0,0,0,2021-01-20,1611097200.0
4057,6,2,2021-01-21,0,0,0,0,2021-01-21,1611183600.0
4058,6,2,2021-01-22,0,0,0,0,2021-01-22,1611270000.0
4059,6,2,2021-01-23,0,0,0,0,2021-01-23,1611356400.0
4060,6,2,2021-01-24,0,0,0,0,2021-01-24,1611442800.0
4061,6,2,2021-01-25,0,0,0,0,2021-01-25,1611529200.0
4062,6,2,2021-01-26,0,0,0,0,2021-01-26,1611615600.0
4063,6,2,2021-01-27,0,0,0,0,2021-01-27,1611702000.0
4064,6,2,2021-01-28,0,0,0,0,2021-01-28,1611788400.0
4065,6,2,2021-01-29,0,0,0,0,2021-01-29,1611874800.0
4066,6,2,2021-01-30,0,0,0,0,2021-01-30,1611961200.0
4067,6,2,2021-01-31,0,0,0,0,2021-01-31,1612047600.0
4068,6,2,2021-02-01,0,0,0,0,2021-02-01,1612134000.0
4069,6,2,2021-02-02,0,0,0,0,2021-02-02,1612220400.0
4070,6,2,2021-02-03,0,0,0,0,2021-02-03,1612306800.0
4071,6,2,2021-02-04,0,0,0,0,2021-02-04,1612393200.0
4072,6,2,2021-02-05,0,0,0,0,2021-02-05,1612479600.0
4073,6,2,2021-02-06,0,0,0,0,2021-02-06,1612566000.0
4074,6,2,2021-02-07,0,0,0,0,2021-02-07,1612652400.0
4075,6,2,2021-02-08,0,0,0,0,2021-02-08,1612738800.0
4076,6,2,2021-02-09,0,0,0,0,2021-02-09,1612825200.0
4077,6,2,2021-02-10,0,0,0,0,2021-02-10,1612911600.0
4078,6,2,2021-02-11,0,0,0,0,2021-02-11,1612998000.0
4079,6,2,2021-02-12,0,0,0,0,2021-02-12,1613084400.0
4080,6,2,2021-02-13,0,0,0,0,2021-02-13,1613170800.0
4081,6,2,2021-02-14,0,0,0,0,2021-02-14,1613257200.0
4082,6,2,2021-02-15,0,0,0,0,2021-02-15,1613343600.0
4083,6,2,2021-02-16,0,0,0,0,2021-02-16,1613430000.0
4084,6,2,2021-02-17,0,0,0,0,2021-02-17,1613516400.0
4085,6,2,2021-02-18,0,0,0,0,2021-02-18,1613602800.0
4086,6,2,2021-02-19,0,0,0,0,2021-02-19,1613689200.0
4087,6,2,2021-02-20,0,0,0,0,2021-02-20,1613775600.0
4088,6,2,2021-02-21,0,0,0,0,2021-02-21,1613862000.0
4089,6,2,2021-02-22,0,0,0,0,2021-02-22,1613948400.0
4090,6,2,2021-02-23,0,0,0,0,2021-02-23,1614034800.0
4091,6,2,2021-02-24,0,0,0,0,2021-02-24,1614121200.0
4092,6,2,2021-02-25,0,0,0,0,2021-02-25,1614207600.0
4093,6,2,2021-02-26,0,0,0,0,2021-02-26,1614294000.0
4094,6,2,2021-02-27,0,0,0,0,2021-02-27,1614380400.0
4095,6,2,2021-02-28,0,0,0,0,2021-02-28,1614466800.0
4096,6,2,2021-03-01,0,0,0,0,2021-03-01,1614553200.0
4097,6,2,2021-03-02,0,0,0,0,2021-03-02,1614639600.0
4098,6,2,2021-03-03,0,0,0,0,2021-03-03,1614726000.0
4099,6,2,2021-03-04,0,0,0,0,2021-03-04,1614812400.0
4100,6,2,2021-03-05,0,0,0,0,2021-03-05,1614898800.0
4101,6,2,2021-03-06,0,0,0,0,2021-03-06,1614985200.0
4102,6,2,2021-03-07,0,0,0,0,2021-03-07,1615071600.0
4103,6,2,2021-03-08,0,0,0,0,2021-03-08,1615158000.0
4104,6,2,2021-03-09,0,0,0,0,2021-03-09,1615244400.0
4105,6,2,2021-03-10,0,0,0,0,2021-03-10,1615330800.0
4106,6,2,2021-03-11,0,0,0,0,2021-03-11,1615417200.0
4107,6,2,2021-03-12,0,0,0,0,2021-03-12,1615503600.0
4108,6,2,2021-03-13,0,0,0,0,2021-03-13,1615590000.0
4109,6,2,2021-03-14,0,0,0,0,2021-03-14,1615676400.0
4110,6,2,2021-03-15,0,0,0,0,2021-03-15,1615762800.0
4111,6,2,2021-03-16,0,0,0,0,2021-03-16,1615849200.0
4112,6,2,2021-03-17,0,0,0,0,2021-03-17,1615935600.0
4113,6,2,2021-03-18,0,0,0,0,2021-03-18,1616022000.0
4114,6,2,2021-03-19,0,0,0,0,2021-03-19,1616108400.0
4115,6,2,2021-03-20,0,0,0,0,2021-03-20,1616194800.0
4116,6,2,2021-03-21,0,0,0,0,2021-03-21,1616281200.0
4117,6,2,2021-03-22,0,0,0,0,2021-03-22,1616367600.0
4118,6,2,2021-03-23,0,0,0,0,2021-03-23,1616454000.0
4119,6,2,2021-03-24,0,0,0,0,2021-03-24,1616540400.0
4120,6,2,2021-03-25,0,0,0,0,2021-03-25,1616626800.0
4121,6,2,2021-03-26,0,0,0,0,2021-03-26,1616713200.0
4122,6,2,2021-03-27,0,0,0,0,2021-03-27,1616799600.0
4123,6,2,2021-03-28,0,0,0,0,2021-03-28,1616886000.0
4124,6,2,2021-03-29,0,0,0,0,2021-03-29,1616972400.0
4125,6,2,2021-03-30,0,0,0,0,2021-03-30,1617058800.0
4126,6,2,2021-03-31,0,0,0,0,2021-03-31,1617145200.0
4127,6,2,2021-04-01,0,0,0,0,2021-04-01,1617231600.0
4128,6,2,2021-04-02,0,0,0,0,2021-04-02,1617318000.0
4129,6,2,2021-04-03,0,0,0,0,2021-04-03,1617404400.0
4130,6,2,2021-04-04,0,0,0,0,2021-04-04,1617490800.0
4131,6,2,2021-04-05,0,0,0,0,2021-04-05,1617577200.0
4132,6,2,2021-04-06,0,0,0,0,2021-04-06,1617663600.0
4133,6,2,2021-04-07,0,0,0,0,2021-04-07,1617750000.0
4134,6,2,2021-04-08,0,0,0,0,2021-04-08,1617836400.0
4135,6,2,2021-04-09,0,0,0,0,2021-04-09,1617922800.0
4136,6,2,2021-04-10,0,0,0,0,2021-04-10,1618009200.0
4137,6,2,2021-04-11,0,0,0,0,2021-04-11,1618095600.0
4138,6,2,2021-04-12,0,0,0,0,2021-04-12,1618185600.0
4139,6,2,2021-04-13,0,0,0,0,2021-04-13,1618272000.0
4140,6,2,2021-04-14,0,0,0,0,2021-04-14,1618358400.0
4141,6,2,2021-04-15,0,0,0,0,2021-04-15,1618444800.0
4142,6,2,2021-04-16,0,0,0,0,2021-04-16,1618531200.0
4143,6,2,2021-04-17,0,0,0,0,2021-04-17,1618617600.0
4144,6,2,2021-04-18,0,0,0,0,2021-04-18,1618704000.0
4145,6,2,2021-04-19,0,0,0,0,2021-04-19,1618790400.0
4146,6,2,2021-04-20,0,0,0,0,2021-04-20,1618876800.0
4147,6,2,2021-04-21,0,0,0,0,2021-04-21,1618963200.0
4148,6,2,2021-04-22,0,0,0,0,2021-04-22,1619049600.0
4149,6,2,2021-04-23,0,0,0,0,2021-04-23,1619136000.0
4150,6,2,2021-04-24,0,0,0,0,2021-04-24,1619222400.0
4151,6,2,2021-04-25,0,0,0,0,2021-04-25,1619308800.0
4152,6,2,2021-04-26,0,0,0,0,2021-04-26,1619395200.0
4153,6,2,2021-04-27,0,0,0,0,2021-04-27,1619481600.0
4154,6,2,2021-04-28,0,0,0,0,2021-04-28,1619568000.0
4155,6,2,2021-04-29,0,0,0,0,2021-04-29,1619654400.0
4156,6,2,2021-04-30,0,0,0,0,2021-04-30,1619740800.0
4157,6,2,2021-05-01,0,0,0,0,2021-05-01,1619827200.0
4158,6,2,2021-05-02,0,0,0,0,2021-05-02,1619913600.0
4159,6,2,2021-05-03,0,0,0,0,2021-05-03,1620000000.0
4160,6,2,2021-05-04,0,0,0,0,2021-05-04,1620086400.0
4161,6,2,2021-05-05,0,0,0,0,2021-05-05,1620172800.0
4162,6,2,2021-05-06,0,0,0,0,2021-05-06,1620259200.0
4163,6,2,2021-05-07,0,0,0,0,2021-05-07,1620345600.0
4164,6,2,2021-05-08,0,0,0,0,2021-05-08,1620432000.0
4165,6,2,2021-05-09,0,0,0,0,2021-05-09,1620518400.0
4166,6,2,2021-05-10,0,0,0,0,2021-05-10,1620604800.0
4167,6,2,2021-05-11,0,0,0,0,2021-05-11,1620691200.0
4168,6,2,2021-05-12,0,1,0,1,2021-05-12,1620777600.0
4169,6,2,2021-05-13,0,0,0,1,2021-05-13,1620864000.0
4170,6,2,2021-05-14,0,0,0,1,2021-05-14,1620950400.0
4171,6,2,2021-05-15,0,0,0,1,2021-05-15,1621036800.0
4172,6,2,2021-05-16,0,0,0,1,2021-05-16,1621123200.0
4173,6,2,2021-05-17,1,0,1,1,2021-05-17,1621206000.0
4174,6,2,2021-05-18,0,0,1,1,2021-05-18,1621292400.0
4175,6,2,2021-05-19,0,0,1,1,2021-05-19,1621378800.0
4176,6,2,2021-05-20,0,0,1,1,2021-05-20,1621465200.0
4177,6,2,2021-05-21,0,0,1,1,2021-05-21,1621551600.0
4178,6,2,2021-05-22,0,0,1,1,2021-05-22,1621638000.0
4179,6,2,2021-05-23,0,0,1,1,2021-05-23,1621724400.0
4180,6,2,2021-05-24,0,0,1,1,2021-05-24,1621810800.0
4181,6,2,2021-05-25,0,0,1,1,2021-05-25,1621897200.0
4182,6,2,2021-05-26,0,0,1,1,2021-05-26,1621983600.0
4183,6,2,2021-05-27,0,0,1,1,2021-05-27,1622070000.0
4184,6,2,2021-05-28,0,0,1,1,2021-05-28,1622156400.0
4185,6,2,2021-05-29,0,0,1,1,2021-05-29,1622242800.0
4186,6,2,2021-05-30,0,0,1,1,2021-05-30,1622329200.0
4187,6,2,2021-05-31,0,0,1,1,2021-05-31,1622415600.0
4188,6,2,2021-06-01,0,0,1,1,2021-06-01,1622502000.0
4189,6,2,2021-06-02,0,0,1,1,2021-06-02,1622588400.0
4190,6,2,2021-06-03,0,0,1,1,2021-06-03,1622674800.0
4191,6,2,2021-06-04,0,0,1,1,2021-06-04,1622761200.0
4192,6,2,2021-06-05,0,0,1,1,2021-06-05,1622847600.0
4193,6,2,2021-06-06,0,0,1,1,2021-06-06,1622934000.0
4194,6,2,2021-06-07,0,0,1,1,2021-06-07,1623020400.0
4195,6,2,2021-06-08,0,0,1,1,2021-06-08,1623106800.0
4196,6,2,2021-06-09,0,0,1,1,2021-06-09,1623193200.0
4197,6,2,2021-06-10,0,0,1,1,2021-06-10,1623279600.0
4198,6,2,2021-06-11,0,0,1,1,2021-06-11,1623366000.0
4199,6,2,2021-06-12,0,0,1,1,2021-06-12,1623452400.0
4200,6,2,2021-06-13,0,0,1,1,2021-06-13,1623538800.0
4201,6,2,2021-06-14,0,0,1,1,2021-06-14,1623625200.0
4202,6,2,2021-06-15,0,0,1,1,2021-06-15,1623711600.0
4203,6,2,2021-06-16,0,0,1,1,2021-06-16,1623798000.0
4204,6,2,2021-06-17,0,0,1,1,2021-06-17,1623884400.0
4205,6,2,2021-06-18,0,0,1,1,2021-06-18,1623970800.0
4206,6,2,2021-06-19,0,0,1,1,2021-06-19,1624057200.0
4207,6,2,2021-06-20,0,0,1,1,2021-06-20,1624143600.0
4208,6,2,2021-06-21,0,0,1,1,2021-06-21,1624230000.0
4209,6,2,2021-06-22,0,0,1,1,2021-06-22,1624316400.0
4210,6,2,2021-06-23,0,0,1,1,2021-06-23,1624402800.0
4211,6,2,2021-06-24,0,0,1,1,2021-06-24,1624489200.0
4212,6,2,2021-06-25,0,0,1,1,2021-06-25,1624575600.0
4213,6,2,2021-06-26,0,0,1,1,2021-06-26,1624662000.0
4214,6,2,2021-06-27,0,0,1,1,2021-06-27,1624748400.0
4215,6,2,2021-06-28,0,0,1,1,2021-06-28,1624834800.0
4216,6,2,2021-06-29,0,0,1,1,2021-06-29,1624921200.0
4217,6,2,2021-06-30,0,0,1,1,2021-06-30,1625007600.0
4218,6,2,2021-07-01,0,0,1,1,2021-07-01,1625094000.0
4219,6,2,2021-07-02,0,0,1,1,2021-07-02,1625180400.0
4220,6,2,2021-07-03,0,0,1,1,2021-07-03,1625266800.0
4221,6,2,2021-07-04,0,0,1,1,2021-07-04,1625353200.0
4222,6,2,2021-07-05,0,0,1,1,2021-07-05,1625439600.0
4223,6,2,2021-07-06,0,0,1,1,2021-07-06,1625526000.0
4224,6,3,2020-12-27,0,0,0,0,2020-12-27,1609023600.0
4225,6,3,2020-12-28,0,0,0,0,2020-12-28,1609110000.0
4226,6,3,2020-12-29,0,0,0,0,2020-12-29,1609196400.0
4227,6,3,2020-12-30,0,0,0,0,2020-12-30,1609282800.0
4228,6,3,2020-12-31,0,0,0,0,2020-12-31,1609369200.0
4229,6,3,2021-01-01,0,0,0,0,2021-01-01,1609455600.0
4230,6,3,2021-01-02,0,0,0,0,2021-01-02,1609542000.0
4231,6,3,2021-01-03,0,0,0,0,2021-01-03,1609628400.0
4232,6,3,2021-01-04,0,0,0,0,2021-01-04,1609714800.0
4233,6,3,2021-01-05,0,0,0,0,2021-01-05,1609801200.0
4234,6,3,2021-01-06,0,0,0,0,2021-01-06,1609887600.0
4235,6,3,2021-01-07,0,0,0,0,2021-01-07,1609974000.0
4236,6,3,2021-01-08,0,0,0,0,2021-01-08,1610060400.0
4237,6,3,2021-01-09,0,0,0,0,2021-01-09,1610146800.0
4238,6,3,2021-01-10,0,0,0,0,2021-01-10,1610233200.0
4239,6,3,2021-01-11,0,0,0,0,2021-01-11,1610319600.0
4240,6,3,2021-01-12,0,0,0,0,2021-01-12,1610406000.0
4241,6,3,2021-01-13,0,0,0,0,2021-01-13,1610492400.0
4242,6,3,2021-01-14,0,0,0,0,2021-01-14,1610578800.0
4243,6,3,2021-01-15,0,0,0,0,2021-01-15,1610665200.0
4244,6,3,2021-01-16,0,0,0,0,2021-01-16,1610751600.0
4245,6,3,2021-01-17,0,0,0,0,2021-01-17,1610838000.0
4246,6,3,2021-01-18,0,0,0,0,2021-01-18,1610924400.0
4247,6,3,2021-01-19,0,0,0,0,2021-01-19,1611010800.0
4248,6,3,2021-01-20,0,0,0,0,2021-01-20,1611097200.0
4249,6,3,2021-01-21,0,0,0,0,2021-01-21,1611183600.0
4250,6,3,2021-01-22,0,0,0,0,2021-01-22,1611270000.0
4251,6,3,2021-01-23,0,0,0,0,2021-01-23,1611356400.0
4252,6,3,2021-01-24,0,0,0,0,2021-01-24,1611442800.0
4253,6,3,2021-01-25,0,0,0,0,2021-01-25,1611529200.0
4254,6,3,2021-01-26,0,0,0,0,2021-01-26,1611615600.0
4255,6,3,2021-01-27,0,0,0,0,2021-01-27,1611702000.0
4256,6,3,2021-01-28,0,0,0,0,2021-01-28,1611788400.0
4257,6,3,2021-01-29,0,0,0,0,2021-01-29,1611874800.0
4258,6,3,2021-01-30,0,0,0,0,2021-01-30,1611961200.0
4259,6,3,2021-01-31,0,0,0,0,2021-01-31,1612047600.0
4260,6,3,2021-02-01,0,0,0,0,2021-02-01,1612134000.0
4261,6,3,2021-02-02,0,0,0,0,2021-02-02,1612220400.0
4262,6,3,2021-02-03,0,0,0,0,2021-02-03,1612306800.0
4263,6,3,2021-02-04,0,0,0,0,2021-02-04,1612393200.0
4264,6,3,2021-02-05,0,0,0,0,2021-02-05,1612479600.0
4265,6,3,2021-02-06,0,0,0,0,2021-02-06,1612566000.0
4266,6,3,2021-02-07,0,0,0,0,2021-02-07,1612652400.0
4267,6,3,2021-02-08,0,0,0,0,2021-02-08,1612738800.0
4268,6,3,2021-02-09,0,0,0,0,2021-02-09,1612825200.0
4269,6,3,2021-02-10,0,0,0,0,2021-02-10,1612911600.0
4270,6,3,2021-02-11,0,0,0,0,2021-02-11,1612998000.0
4271,6,3,2021-02-12,0,0,0,0,2021-02-12,1613084400.0
4272,6,3,2021-02-13,0,0,0,0,2021-02-13,1613170800.0
4273,6,3,2021-02-14,0,0,0,0,2021-02-14,1613257200.0
4274,6,3,2021-02-15,0,0,0,0,2021-02-15,1613343600.0
4275,6,3,2021-02-16,0,0,0,0,2021-02-16,1613430000.0
4276,6,3,2021-02-17,0,0,0,0,2021-02-17,1613516400.0
4277,6,3,2021-02-18,0,0,0,0,2021-02-18,1613602800.0
4278,6,3,2021-02-19,0,0,0,0,2021-02-19,1613689200.0
4279,6,3,2021-02-20,0,0,0,0,2021-02-20,1613775600.0
4280,6,3,2021-02-21,0,0,0,0,2021-02-21,1613862000.0
4281,6,3,2021-02-22,0,0,0,0,2021-02-22,1613948400.0
4282,6,3,2021-02-23,0,0,0,0,2021-02-23,1614034800.0
4283,6,3,2021-02-24,0,0,0,0,2021-02-24,1614121200.0
4284,6,3,2021-02-25,0,0,0,0,2021-02-25,1614207600.0
4285,6,3,2021-02-26,0,0,0,0,2021-02-26,1614294000.0
4286,6,3,2021-02-27,0,0,0,0,2021-02-27,1614380400.0
4287,6,3,2021-02-28,0,0,0,0,2021-02-28,1614466800.0
4288,6,3,2021-03-01,0,0,0,0,2021-03-01,1614553200.0
4289,6,3,2021-03-02,0,0,0,0,2021-03-02,1614639600.0
4290,6,3,2021-03-03,0,0,0,0,2021-03-03,1614726000.0
4291,6,3,2021-03-04,0,0,0,0,2021-03-04,1614812400.0
4292,6,3,2021-03-05,0,0,0,0,2021-03-05,1614898800.0
4293,6,3,2021-03-06,0,0,0,0,2021-03-06,1614985200.0
4294,6,3,2021-03-07,0,0,0,0,2021-03-07,1615071600.0
4295,6,3,2021-03-08,0,0,0,0,2021-03-08,1615158000.0
4296,6,3,2021-03-09,0,0,0,0,2021-03-09,1615244400.0
4297,6,3,2021-03-10,0,0,0,0,2021-03-10,1615330800.0
4298,6,3,2021-03-11,0,0,0,0,2021-03-11,1615417200.0
4299,6,3,2021-03-12,0,0,0,0,2021-03-12,1615503600.0
4300,6,3,2021-03-13,1,0,1,0,2021-03-13,1615590000.0
4301,6,3,2021-03-14,0,0,1,0,2021-03-14,1615676400.0
4302,6,3,2021-03-15,0,0,1,0,2021-03-15,1615762800.0
4303,6,3,2021-03-16,0,0,1,0,2021-03-16,1615849200.0
4304,6,3,2021-03-17,0,0,1,0,2021-03-17,1615935600.0
4305,6,3,2021-03-18,0,0,1,0,2021-03-18,1616022000.0
4306,6,3,2021-03-19,0,0,1,0,2021-03-19,1616108400.0
4307,6,3,2021-03-20,0,0,1,0,2021-03-20,1616194800.0
4308,6,3,2021-03-21,0,0,1,0,2021-03-21,1616281200.0
4309,6,3,2021-03-22,0,0,1,0,2021-03-22,1616367600.0
4310,6,3,2021-03-23,0,0,1,0,2021-03-23,1616454000.0
4311,6,3,2021-03-24,0,0,1,0,2021-03-24,1616540400.0
4312,6,3,2021-03-25,0,0,1,0,2021-03-25,1616626800.0
4313,6,3,2021-03-26,0,0,1,0,2021-03-26,1616713200.0
4314,6,3,2021-03-27,0,0,1,0,2021-03-27,1616799600.0
4315,6,3,2021-03-28,0,0,1,0,2021-03-28,1616886000.0
4316,6,3,2021-03-29,0,0,1,0,2021-03-29,1616972400.0
4317,6,3,2021-03-30,0,0,1,0,2021-03-30,1617058800.0
4318,6,3,2021-03-31,0,0,1,0,2021-03-31,1617145200.0
4319,6,3,2021-04-01,0,0,1,0,2021-04-01,1617231600.0
4320,6,3,2021-04-02,0,0,1,0,2021-04-02,1617318000.0
4321,6,3,2021-04-03,0,0,1,0,2021-04-03,1617404400.0
4322,6,3,2021-04-04,0,0,1,0,2021-04-04,1617490800.0
4323,6,3,2021-04-05,0,0,1,0,2021-04-05,1617577200.0
4324,6,3,2021-04-06,0,0,1,0,2021-04-06,1617663600.0
4325,6,3,2021-04-07,0,0,1,0,2021-04-07,1617750000.0
4326,6,3,2021-04-08,0,0,1,0,2021-04-08,1617836400.0
4327,6,3,2021-04-09,0,0,1,0,2021-04-09,1617922800.0
4328,6,3,2021-04-10,0,0,1,0,2021-04-10,1618009200.0
4329,6,3,2021-04-11,0,0,1,0,2021-04-11,1618095600.0
4330,6,3,2021-04-12,0,0,1,0,2021-04-12,1618185600.0
4331,6,3,2021-04-13,0,0,1,0,2021-04-13,1618272000.0
4332,6,3,2021-04-14,0,0,1,0,2021-04-14,1618358400.0
4333,6,3,2021-04-15,0,0,1,0,2021-04-15,1618444800.0
4334,6,3,2021-04-16,0,0,1,0,2021-04-16,1618531200.0
4335,6,3,2021-04-17,0,0,1,0,2021-04-17,1618617600.0
4336,6,3,2021-04-18,0,0,1,0,2021-04-18,1618704000.0
4337,6,3,2021-04-19,0,0,1,0,2021-04-19,1618790400.0
4338,6,3,2021-04-20,0,0,1,0,2021-04-20,1618876800.0
4339,6,3,2021-04-21,0,0,1,0,2021-04-21,1618963200.0
4340,6,3,2021-04-22,0,0,1,0,2021-04-22,1619049600.0
4341,6,3,2021-04-23,0,0,1,0,2021-04-23,1619136000.0
4342,6,3,2021-04-24,0,0,1,0,2021-04-24,1619222400.0
4343,6,3,2021-04-25,0,0,1,0,2021-04-25,1619308800.0
4344,6,3,2021-04-26,0,0,1,0,2021-04-26,1619395200.0
4345,6,3,2021-04-27,0,0,1,0,2021-04-27,1619481600.0
4346,6,3,2021-04-28,1,0,2,0,2021-04-28,1619568000.0
4347,6,3,2021-04-29,0,0,2,0,2021-04-29,1619654400.0
4348,6,3,2021-04-30,0,0,2,0,2021-04-30,1619740800.0
4349,6,3,2021-05-01,0,0,2,0,2021-05-01,1619827200.0
4350,6,3,2021-05-02,0,0,2,0,2021-05-02,1619913600.0
4351,6,3,2021-05-03,0,0,2,0,2021-05-03,1620000000.0
4352,6,3,2021-05-04,0,0,2,0,2021-05-04,1620086400.0
4353,6,3,2021-05-05,0,0,2,0,2021-05-05,1620172800.0
4354,6,3,2021-05-06,0,0,2,0,2021-05-06,1620259200.0
4355,6,3,2021-05-07,0,0,2,0,2021-05-07,1620345600.0
4356,6,3,2021-05-08,0,0,2,0,2021-05-08,1620432000.0
4357,6,3,2021-05-09,0,0,2,0,2021-05-09,1620518400.0
4358,6,3,2021-05-10,0,0,2,0,2021-05-10,1620604800.0
4359,6,3,2021-05-11,0,0,2,0,2021-05-11,1620691200.0
4360,6,3,2021-05-12,0,0,2,0,2021-05-12,1620777600.0
4361,6,3,2021-05-13,0,0,2,0,2021-05-13,1620864000.0
4362,6,3,2021-05-14,0,0,2,0,2021-05-14,1620950400.0
4363,6,3,2021-05-15,0,0,2,0,2021-05-15,1621036800.0
4364,6,3,2021-05-16,0,0,2,0,2021-05-16,1621123200.0
4365,6,3,2021-05-17,0,0,2,0,2021-05-17,1621206000.0
4366,6,3,2021-05-18,0,0,2,0,2021-05-18,1621292400.0
4367,6,3,2021-05-19,0,0,2,0,2021-05-19,1621378800.0
4368,6,3,2021-05-20,0,0,2,0,2021-05-20,1621465200.0
4369,6,3,2021-05-21,0,0,2,0,2021-05-21,1621551600.0
4370,6,3,2021-05-22,0,0,2,0,2021-05-22,1621638000.0
4371,6,3,2021-05-23,0,0,2,0,2021-05-23,1621724400.0
4372,6,3,2021-05-24,0,0,2,0,2021-05-24,1621810800.0
4373,6,3,2021-05-25,1,0,3,0,2021-05-25,1621897200.0
4374,6,3,2021-05-26,0,0,3,0,2021-05-26,1621983600.0
4375,6,3,2021-05-27,0,0,3,0,2021-05-27,1622070000.0
4376,6,3,2021-05-28,0,0,3,0,2021-05-28,1622156400.0
4377,6,3,2021-05-29,0,0,3,0,2021-05-29,1622242800.0
4378,6,3,2021-05-30,0,1,3,1,2021-05-30,1622329200.0
4379,6,3,2021-05-31,0,0,3,1,2021-05-31,1622415600.0
4380,6,3,2021-06-01,0,0,3,1,2021-06-01,1622502000.0
4381,6,3,2021-06-02,0,0,3,1,2021-06-02,1622588400.0
4382,6,3,2021-06-03,0,0,3,1,2021-06-03,1622674800.0
4383,6,3,2021-06-04,0,0,3,1,2021-06-04,1622761200.0
4384,6,3,2021-06-05,0,0,3,1,2021-06-05,1622847600.0
4385,6,3,2021-06-06,0,0,3,1,2021-06-06,1622934000.0
4386,6,3,2021-06-07,0,0,3,1,2021-06-07,1623020400.0
4387,6,3,2021-06-08,0,0,3,1,2021-06-08,1623106800.0
4388,6,3,2021-06-09,0,0,3,1,2021-06-09,1623193200.0
4389,6,3,2021-06-10,0,0,3,1,2021-06-10,1623279600.0
4390,6,3,2021-06-11,0,0,3,1,2021-06-11,1623366000.0
4391,6,3,2021-06-12,0,0,3,1,2021-06-12,1623452400.0
4392,6,3,2021-06-13,0,0,3,1,2021-06-13,1623538800.0
4393,6,3,2021-06-14,0,0,3,1,2021-06-14,1623625200.0
4394,6,3,2021-06-15,0,0,3,1,2021-06-15,1623711600.0
4395,6,3,2021-06-16,0,0,3,1,2021-06-16,1623798000.0
4396,6,3,2021-06-17,0,0,3,1,2021-06-17,1623884400.0
4397,6,3,2021-06-18,0,0,3,1,2021-06-18,1623970800.0
4398,6,3,2021-06-19,0,0,3,1,2021-06-19,1624057200.0
4399,6,3,2021-06-20,0,0,3,1,2021-06-20,1624143600.0
4400,6,3,2021-06-21,0,0,3,1,2021-06-21,1624230000.0
4401,6,3,2021-06-22,0,0,3,1,2021-06-22,1624316400.0
4402,6,3,2021-06-23,0,0,3,1,2021-06-23,1624402800.0
4403,6,3,2021-06-24,0,0,3,1,2021-06-24,1624489200.0
4404,6,3,2021-06-25,0,0,3,1,2021-06-25,1624575600.0
4405,6,3,2021-06-26,0,0,3,1,2021-06-26,1624662000.0
4406,6,3,2021-06-27,0,0,3,1,2021-06-27,1624748400.0
4407,6,3,2021-06-28,0,0,3,1,2021-06-28,1624834800.0
4408,6,3,2021-06-29,0,0,3,1,2021-06-29,1624921200.0
4409,6,3,2021-06-30,0,0,3,1,2021-06-30,1625007600.0
4410,6,3,2021-07-01,0,0,3,1,2021-07-01,1625094000.0
4411,6,3,2021-07-02,0,0,3,1,2021-07-02,1625180400.0
4412,6,3,2021-07-03,0,0,3,1,2021-07-03,1625266800.0
4413,6,3,2021-07-04,0,0,3,1,2021-07-04,1625353200.0
4414,6,3,2021-07-05,0,0,3,1,2021-07-05,1625439600.0
4415,6,3,2021-07-06,0,0,3,1,2021-07-06,1625526000.0
4416,6,4,2020-12-27,0,0,0,0,2020-12-27,1609023600.0
4417,6,4,2020-12-28,0,0,0,0,2020-12-28,1609110000.0
4418,6,4,2020-12-29,0,0,0,0,2020-12-29,1609196400.0
4419,6,4,2020-12-30,0,0,0,0,2020-12-30,1609282800.0
4420,6,4,2020-12-31,0,0,0,0,2020-12-31,1609369200.0
4421,6,4,2021-01-01,0,0,0,0,2021-01-01,1609455600.0
4422,6,4,2021-01-02,0,0,0,0,2021-01-02,1609542000.0
4423,6,4,2021-01-03,0,0,0,0,2021-01-03,1609628400.0
4424,6,4,2021-01-04,0,0,0,0,2021-01-04,1609714800.0
4425,6,4,2021-01-05,0,0,0,0,2021-01-05,1609801200.0
4426,6,4,2021-01-06,0,0,0,0,2021-01-06,1609887600.0
4427,6,4,2021-01-07,0,0,0,0,2021-01-07,1609974000.0
4428,6,4,2021-01-08,0,0,0,0,2021-01-08,1610060400.0
4429,6,4,2021-01-09,0,0,0,0,2021-01-09,1610146800.0
4430,6,4,2021-01-10,0,0,0,0,2021-01-10,1610233200.0
4431,6,4,2021-01-11,0,0,0,0,2021-01-11,1610319600.0
4432,6,4,2021-01-12,0,0,0,0,2021-01-12,1610406000.0
4433,6,4,2021-01-13,0,0,0,0,2021-01-13,1610492400.0
4434,6,4,2021-01-14,0,0,0,0,2021-01-14,1610578800.0
4435,6,4,2021-01-15,0,0,0,0,2021-01-15,1610665200.0
4436,6,4,2021-01-16,0,0,0,0,2021-01-16,1610751600.0
4437,6,4,2021-01-17,0,0,0,0,2021-01-17,1610838000.0
4438,6,4,2021-01-18,0,0,0,0,2021-01-18,1610924400.0
4439,6,4,2021-01-19,0,0,0,0,2021-01-19,1611010800.0
4440,6,4,2021-01-20,0,0,0,0,2021-01-20,1611097200.0
4441,6,4,2021-01-21,0,0,0,0,2021-01-21,1611183600.0
4442,6,4,2021-01-22,0,0,0,0,2021-01-22,1611270000.0
4443,6,4,2021-01-23,0,0,0,0,2021-01-23,1611356400.0
4444,6,4,2021-01-24,0,0,0,0,2021-01-24,1611442800.0
4445,6,4,2021-01-25,0,0,0,0,2021-01-25,1611529200.0
4446,6,4,2021-01-26,0,0,0,0,2021-01-26,1611615600.0
4447,6,4,2021-01-27,0,0,0,0,2021-01-27,1611702000.0
4448,6,4,2021-01-28,0,0,0,0,2021-01-28,1611788400.0
4449,6,4,2021-01-29,0,0,0,0,2021-01-29,1611874800.0
4450,6,4,2021-01-30,0,0,0,0,2021-01-30,1611961200.0
4451,6,4,2021-01-31,0,0,0,0,2021-01-31,1612047600.0
4452,6,4,2021-02-01,0,0,0,0,2021-02-01,1612134000.0
4453,6,4,2021-02-02,0,0,0,0,2021-02-02,1612220400.0
4454,6,4,2021-02-03,0,0,0,0,2021-02-03,1612306800.0
4455,6,4,2021-02-04,0,0,0,0,2021-02-04,1612393200.0
4456,6,4,2021-02-05,0,0,0,0,2021-02-05,1612479600.0
4457,6,4,2021-02-06,0,0,0,0,2021-02-06,1612566000.0
4458,6,4,2021-02-07,0,0,0,0,2021-02-07,1612652400.0
4459,6,4,2021-02-08,0,0,0,0,2021-02-08,1612738800.0
4460,6,4,2021-02-09,0,0,0,0,2021-02-09,1612825200.0
4461,6,4,2021-02-10,0,0,0,0,2021-02-10,1612911600.0
4462,6,4,2021-02-11,0,0,0,0,2021-02-11,1612998000.0
4463,6,4,2021-02-12,0,0,0,0,2021-02-12,1613084400.0
4464,6,4,2021-02-13,0,0,0,0,2021-02-13,1613170800.0
4465,6,4,2021-02-14,0,0,0,0,2021-02-14,1613257200.0
4466,6,4,2021-02-15,0,0,0,0,2021-02-15,1613343600.0
4467,6,4,2021-02-16,0,0,0,0,2021-02-16,1613430000.0
4468,6,4,2021-02-17,0,0,0,0,2021-02-17,1613516400.0
4469,6,4,2021-02-18,0,0,0,0,2021-02-18,1613602800.0
4470,6,4,2021-02-19,0,0,0,0,2021-02-19,1613689200.0
4471,6,4,2021-02-20,0,0,0,0,2021-02-20,1613775600.0
4472,6,4,2021-02-21,0,0,0,0,2021-02-21,1613862000.0
4473,6,4,2021-02-22,0,0,0,0,2021-02-22,1613948400.0
4474,6,4,2021-02-23,0,0,0,0,2021-02-23,1614034800.0
4475,6,4,2021-02-24,0,0,0,0,2021-02-24,1614121200.0
4476,6,4,2021-02-25,0,0,0,0,2021-02-25,1614207600.0
4477,6,4,2021-02-26,0,0,0,0,2021-02-26,1614294000.0
4478,6,4,2021-02-27,0,0,0,0,2021-02-27,1614380400.0
4479,6,4,2021-02-28,0,0,0,0,2021-02-28,1614466800.0
4480,6,4,2021-03-01,0,0,0,0,2021-03-01,1614553200.0
4481,6,4,2021-03-02,0,0,0,0,2021-03-02,1614639600.0
4482,6,4,2021-03-03,0,0,0,0,2021-03-03,1614726000.0
4483,6,4,2021-03-04,0,0,0,0,2021-03-04,1614812400.0
4484,6,4,2021-03-05,0,0,0,0,2021-03-05,1614898800.0
4485,6,4,2021-03-06,0,0,0,0,2021-03-06,1614985200.0
4486,6,4,2021-03-07,0,0,0,0,2021-03-07,1615071600.0
4487,6,4,2021-03-08,0,0,0,0,2021-03-08,1615158000.0
4488,6,4,2021-03-09,0,0,0,0,2021-03-09,1615244400.0
4489,6,4,2021-03-10,0,0,0,0,2021-03-10,1615330800.0
4490,6,4,2021-03-11,0,0,0,0,2021-03-11,1615417200.0
4491,6,4,2021-03-12,0,0,0,0,2021-03-12,1615503600.0
4492,6,4,2021-03-13,0,0,0,0,2021-03-13,1615590000.0
4493,6,4,2021-03-14,0,0,0,0,2021-03-14,1615676400.0
4494,6,4,2021-03-15,0,0,0,0,2021-03-15,1615762800.0
4495,6,4,2021-03-16,0,0,0,0,2021-03-16,1615849200.0
4496,6,4,2021-03-17,0,0,0,0,2021-03-17,1615935600.0
4497,6,4,2021-03-18,0,0,0,0,2021-03-18,1616022000.0
4498,6,4,2021-03-19,0,0,0,0,2021-03-19,1616108400.0
4499,6,4,2021-03-20,0,0,0,0,2021-03-20,1616194800.0
4500,6,4,2021-03-21,0,0,0,0,2021-03-21,1616281200.0
4501,6,4,2021-03-22,0,0,0,0,2021-03-22,1616367600.0
4502,6,4,2021-03-23,0,0,0,0,2021-03-23,1616454000.0
4503,6,4,2021-03-24,0,0,0,0,2021-03-24,1616540400.0
4504,6,4,2021-03-25,0,0,0,0,2021-03-25,1616626800.0
4505,6,4,2021-03-26,0,0,0,0,2021-03-26,1616713200.0
4506,6,4,2021-03-27,0,0,0,0,2021-03-27,1616799600.0
4507,6,4,2021-03-28,0,0,0,0,2021-03-28,1616886000.0
4508,6,4,2021-03-29,0,0,0,0,2021-03-29,1616972400.0
4509,6,4,2021-03-30,0,0,0,0,2021-03-30,1617058800.0
4510,6,4,2021-03-31,0,0,0,0,2021-03-31,1617145200.0
4511,6,4,2021-04-01,0,0,0,0,2021-04-01,1617231600.0
4512,6,4,2021-04-02,0,0,0,0,2021-04-02,1617318000.0
4513,6,4,2021-04-03,0,0,0,0,2021-04-03,1617404400.0
4514,6,4,2021-04-04,0,0,0,0,2021-04-04,1617490800.0
4515,6,4,2021-04-05,0,0,0,0,2021-04-05,1617577200.0
4516,6,4,2021-04-06,0,0,0,0,2021-04-06,1617663600.0
4517,6,4,2021-04-07,0,0,0,0,2021-04-07,1617750000.0
4518,6,4,2021-04-08,0,0,0,0,2021-04-08,1617836400.0
4519,6,4,2021-04-09,0,0,0,0,2021-04-09,1617922800.0
4520,6,4,2021-04-10,0,0,0,0,2021-04-10,1618009200.0
4521,6,4,2021-04-11,0,0,0,0,2021-04-11,1618095600.0
4522,6,4,2021-04-12,0,0,0,0,2021-04-12,1618185600.0
4523,6,4,2021-04-13,0,0,0,0,2021-04-13,1618272000.0
4524,6,4,2021-04-14,0,0,0,0,2021-04-14,1618358400.0
4525,6,4,2021-04-15,0,0,0,0,2021-04-15,1618444800.0
4526,6,4,2021-04-16,0,0,0,0,2021-04-16,1618531200.0
4527,6,4,2021-04-17,0,0,0,0,2021-04-17,1618617600.0
4528,6,4,2021-04-18,0,0,0,0,2021-04-18,1618704000.0
4529,6,4,2021-04-19,0,0,0,0,2021-04-19,1618790400.0
4530,6,4,2021-04-20,0,0,0,0,2021-04-20,1618876800.0
4531,6,4,2021-04-21,0,0,0,0,2021-04-21,1618963200.0
4532,6,4,2021-04-22,0,0,0,0,2021-04-22,1619049600.0
4533,6,4,2021-04-23,0,0,0,0,2021-04-23,1619136000.0
4534,6,4,2021-04-24,0,0,0,0,2021-04-24,1619222400.0
4535,6,4,2021-04-25,0,0,0,0,2021-04-25,1619308800.0
4536,6,4,2021-04-26,0,0,0,0,2021-04-26,1619395200.0
4537,6,4,2021-04-27,0,0,0,0,2021-04-27,1619481600.0
4538,6,4,2021-04-28,0,0,0,0,2021-04-28,1619568000.0
4539,6,4,2021-04-29,0,0,0,0,2021-04-29,1619654400.0
4540,6,4,2021-04-30,0,0,0,0,2021-04-30,1619740800.0
4541,6,4,2021-05-01,0,0,0,0,2021-05-01,1619827200.0
4542,6,4,2021-05-02,0,0,0,0,2021-05-02,1619913600.0
4543,6,4,2021-05-03,0,0,0,0,2021-05-03,1620000000.0
4544,6,4,2021-05-04,0,0,0,0,2021-05-04,1620086400.0
4545,6,4,2021-05-05,0,0,0,0,2021-05-05,1620172800.0
4546,6,4,2021-05-06,0,0,0,0,2021-05-06,1620259200.0
4547,6,4,2021-05-07,0,0,0,0,2021-05-07,1620345600.0
4548,6,4,2021-05-08,0,0,0,0,2021-05-08,1620432000.0
4549,6,4,2021-05-09,0,0,0,0,2021-05-09,1620518400.0
4550,6,4,2021-05-10,0,0,0,0,2021-05-10,1620604800.0
4551,6,4,2021-05-11,0,0,0,0,2021-05-11,1620691200.0
4552,6,4,2021-05-12,0,0,0,0,2021-05-12,1620777600.0
4553,6,4,2021-05-13,0,0,0,0,2021-05-13,1620864000.0
4554,6,4,2021-05-14,0,0,0,0,2021-05-14,1620950400.0
4555,6,4,2021-05-15,0,0,0,0,2021-05-15,1621036800.0
4556,6,4,2021-05-16,0,0,0,0,2021-05-16,1621123200.0
4557,6,4,2021-05-17,0,0,0,0,2021-05-17,1621206000.0
4558,6,4,2021-05-18,1,0,1,0,2021-05-18,1621292400.0
4559,6,4,2021-05-19,0,0,1,0,2021-05-19,1621378800.0
4560,6,4,2021-05-20,0,0,1,0,2021-05-20,1621465200.0
4561,6,4,2021-05-21,0,0,1,0,2021-05-21,1621551600.0
4562,6,4,2021-05-22,0,0,1,0,2021-05-22,1621638000.0
4563,6,4,2021-05-23,0,0,1,0,2021-05-23,1621724400.0
4564,6,4,2021-05-24,0,0,1,0,2021-05-24,1621810800.0
4565,6,4,2021-05-25,0,0,1,0,2021-05-25,1621897200.0
4566,6,4,2021-05-26,0,0,1,0,2021-05-26,1621983600.0
4567,6,4,2021-05-27,0,0,1,0,2021-05-27,1622070000.0
4568,6,4,2021-05-28,0,0,1,0,2021-05-28,1622156400.0
4569,6,4,2021-05-29,0,0,1,0,2021-05-29,1622242800.0
4570,6,4,2021-05-30,0,0,1,0,2021-05-30,1622329200.0
4571,6,4,2021-05-31,0,0,1,0,2021-05-31,1622415600.0
4572,6,4,2021-06-01,0,0,1,0,2021-06-01,1622502000.0
4573,6,4,2021-06-02,0,0,1,0,2021-06-02,1622588400.0
4574,6,4,2021-06-03,0,0,1,0,2021-06-03,1622674800.0
4575,6,4,2021-06-04,0,0,1,0,2021-06-04,1622761200.0
4576,6,4,2021-06-05,0,0,1,0,2021-06-05,1622847600.0
4577,6,4,2021-06-06,0,0,1,0,2021-06-06,1622934000.0
4578,6,4,2021-06-07,0,0,1,0,2021-06-07,1623020400.0
4579,6,4,2021-06-08,0,0,1,0,2021-06-08,1623106800.0
4580,6,4,2021-06-09,0,0,1,0,2021-06-09,1623193200.0
4581,6,4,2021-06-10,0,0,1,0,2021-06-10,1623279600.0
4582,6,4,2021-06-11,0,0,1,0,2021-06-11,1623366000.0
4583,6,4,2021-06-12,0,0,1,0,2021-06-12,1623452400.0
4584,6,4,2021-06-13,0,0,1,0,2021-06-13,1623538800.0
4585,6,4,2021-06-14,0,0,1,0,2021-06-14,1623625200.0
4586,6,4,2021-06-15,0,0,1,0,2021-06-15,1623711600.0
4587,6,4,2021-06-16,0,0,1,0,2021-06-16,1623798000.0
4588,6,4,2021-06-17,0,0,1,0,2021-06-17,1623884400.0
4589,6,4,2021-06-18,0,0,1,0,2021-06-18,1623970800.0
4590,6,4,2021-06-19,0,0,1,0,2021-06-19,1624057200.0
4591,6,4,2021-06-20,0,0,1,0,2021-06-20,1624143600.0
4592,6,4,2021-06-21,0,0,1,0,2021-06-21,1624230000.0
4593,6,4,2021-06-22,0,0,1,0,2021-06-22,1624316400.0
4594,6,4,2021-06-23,0,0,1,0,2021-06-23,1624402800.0
4595,6,4,2021-06-24,0,0,1,0,2021-06-24,1624489200.0
4596,6,4,2021-06-25,0,0,1,0,2021-06-25,1624575600.0
4597,6,4,2021-06-26,0,0,1,0,2021-06-26,1624662000.0
4598,6,4,2021-06-27,0,0,1,0,2021-06-27,1624748400.0
4599,6,4,2021-06-28,0,0,1,0,2021-06-28,1624834800.0
4600,6,4,2021-06-29,0,0,1,0,2021-06-29,1624921200.0
4601,6,4,2021-06-30,0,0,1,0,2021-06-30,1625007600.0
4602,6,4,2021-07-01,0,0,1,0,2021-07-01,1625094000.0
4603,6,4,2021-07-02,0,0,1,0,2021-07-02,1625180400.0
4604,6,4,2021-07-03,0,0,1,0,2021-07-03,1625266800.0
4605,6,4,2021-07-04,0,0,1,0,2021-07-04,1625353200.0
4606,6,4,2021-07-05,0,0,1,0,2021-07-05,1625439600.0
4607,6,4,2021-07-06,0,0,1,0,2021-07-06,1625526000.0
4608,7,1,2020-12-27,0,0,0,0,2020-12-27,1609023600.0
4609,7,1,2020-12-28,0,0,0,0,2020-12-28,1609110000.0
4610,7,1,2020-12-29,0,0,0,0,2020-12-29,1609196400.0
4611,7,1,2020-12-30,0,0,0,0,2020-12-30,1609282800.0
4612,7,1,2020-12-31,0,0,0,0,2020-12-31,1609369200.0
4613,7,1,2021-01-01,0,0,0,0,2021-01-01,1609455600.0
4614,7,1,2021-01-02,0,0,0,0,2021-01-02,1609542000.0
4615,7,1,2021-01-03,0,0,0,0,2021-01-03,1609628400.0
4616,7,1,2021-01-04,0,0,0,0,2021-01-04,1609714800.0
4617,7,1,2021-01-05,0,0,0,0,2021-01-05,1609801200.0
4618,7,1,2021-01-06,0,0,0,0,2021-01-06,1609887600.0
4619,7,1,2021-01-07,0,0,0,0,2021-01-07,1609974000.0
4620,7,1,2021-01-08,0,0,0,0,2021-01-08,1610060400.0
4621,7,1,2021-01-09,0,0,0,0,2021-01-09,1610146800.0
4622,7,1,2021-01-10,0,0,0,0,2021-01-10,1610233200.0
4623,7,1,2021-01-11,0,0,0,0,2021-01-11,1610319600.0
4624,7,1,2021-01-12,0,0,0,0,2021-01-12,1610406000.0
4625,7,1,2021-01-13,0,0,0,0,2021-01-13,1610492400.0
4626,7,1,2021-01-14,0,0,0,0,2021-01-14,1610578800.0
4627,7,1,2021-01-15,0,0,0,0,2021-01-15,1610665200.0
4628,7,1,2021-01-16,0,0,0,0,2021-01-16,1610751600.0
4629,7,1,2021-01-17,0,0,0,0,2021-01-17,1610838000.0
4630,7,1,2021-01-18,1,0,1,0,2021-01-18,1610924400.0
4631,7,1,2021-01-19,0,0,1,0,2021-01-19,1611010800.0
4632,7,1,2021-01-20,0,0,1,0,2021-01-20,1611097200.0
4633,7,1,2021-01-21,12,0,13,0,2021-01-21,1611183600.0
4634,7,1,2021-01-22,12,0,25,0,2021-01-22,1611270000.0
4635,7,1,2021-01-23,0,0,25,0,2021-01-23,1611356400.0
4636,7,1,2021-01-24,0,0,25,0,2021-01-24,1611442800.0
4637,7,1,2021-01-25,0,0,25,0,2021-01-25,1611529200.0
4638,7,1,2021-01-26,0,0,25,0,2021-01-26,1611615600.0
4639,7,1,2021-01-27,12,0,37,0,2021-01-27,1611702000.0
4640,7,1,2021-01-28,1,0,38,0,2021-01-28,1611788400.0
4641,7,1,2021-01-29,6,0,44,0,2021-01-29,1611874800.0
4642,7,1,2021-01-30,0,0,44,0,2021-01-30,1611961200.0
4643,7,1,2021-01-31,0,0,44,0,2021-01-31,1612047600.0
4644,7,1,2021-02-01,0,0,44,0,2021-02-01,1612134000.0
4645,7,1,2021-02-02,0,0,44,0,2021-02-02,1612220400.0
4646,7,1,2021-02-03,11,0,55,0,2021-02-03,1612306800.0
4647,7,1,2021-02-04,12,0,67,0,2021-02-04,1612393200.0
4648,7,1,2021-02-05,11,0,78,0,2021-02-05,1612479600.0
4649,7,1,2021-02-06,0,0,78,0,2021-02-06,1612566000.0
4650,7,1,2021-02-07,0,0,78,0,2021-02-07,1612652400.0
4651,7,1,2021-02-08,0,0,78,0,2021-02-08,1612738800.0
4652,7,1,2021-02-09,13,0,91,0,2021-02-09,1612825200.0
4653,7,1,2021-02-10,0,0,91,0,2021-02-10,1612911600.0
4654,7,1,2021-02-11,17,0,108,0,2021-02-11,1612998000.0
4655,7,1,2021-02-12,45,0,153,0,2021-02-12,1613084400.0
4656,7,1,2021-02-13,0,0,153,0,2021-02-13,1613170800.0
4657,7,1,2021-02-14,0,0,153,0,2021-02-14,1613257200.0
4658,7,1,2021-02-15,0,0,153,0,2021-02-15,1613343600.0
4659,7,1,2021-02-16,0,0,153,0,2021-02-16,1613430000.0
4660,7,1,2021-02-17,0,0,153,0,2021-02-17,1613516400.0
4661,7,1,2021-02-18,18,0,171,0,2021-02-18,1613602800.0
4662,7,1,2021-02-19,34,0,205,0,2021-02-19,1613689200.0
4663,7,1,2021-02-20,0,0,205,0,2021-02-20,1613775600.0
4664,7,1,2021-02-21,0,0,205,0,2021-02-21,1613862000.0
4665,7,1,2021-02-22,0,0,205,0,2021-02-22,1613948400.0
4666,7,1,2021-02-23,0,22,205,22,2021-02-23,1614034800.0
4667,7,1,2021-02-24,0,0,205,22,2021-02-24,1614121200.0
4668,7,1,2021-02-25,15,10,220,32,2021-02-25,1614207600.0
4669,7,1,2021-02-26,33,19,253,51,2021-02-26,1614294000.0
4670,7,1,2021-02-27,0,0,253,51,2021-02-27,1614380400.0
4671,7,1,2021-02-28,0,0,253,51,2021-02-28,1614466800.0
4672,7,1,2021-03-01,0,0,253,51,2021-03-01,1614553200.0
4673,7,1,2021-03-02,17,11,270,62,2021-03-02,1614639600.0
4674,7,1,2021-03-03,0,0,270,62,2021-03-03,1614726000.0
4675,7,1,2021-03-04,16,11,286,73,2021-03-04,1614812400.0
4676,7,1,2021-03-05,31,19,317,92,2021-03-05,1614898800.0
4677,7,1,2021-03-06,0,0,317,92,2021-03-06,1614985200.0
4678,7,1,2021-03-07,0,0,317,92,2021-03-07,1615071600.0
4679,7,1,2021-03-08,0,0,317,92,2021-03-08,1615158000.0
4680,7,1,2021-03-09,1,0,318,92,2021-03-09,1615244400.0
4681,7,1,2021-03-10,0,0,318,92,2021-03-10,1615330800.0
4682,7,1,2021-03-11,20,30,338,122,2021-03-11,1615417200.0
4683,7,1,2021-03-12,62,42,400,164,2021-03-12,1615503600.0
4684,7,1,2021-03-13,0,0,400,164,2021-03-13,1615590000.0
4685,7,1,2021-03-14,0,0,400,164,2021-03-14,1615676400.0
4686,7,1,2021-03-15,0,0,400,164,2021-03-15,1615762800.0
4687,7,1,2021-03-16,30,9,430,173,2021-03-16,1615849200.0
4688,7,1,2021-03-17,0,0,430,173,2021-03-17,1615935600.0
4689,7,1,2021-03-18,29,16,459,189,2021-03-18,1616022000.0
4690,7,1,2021-03-19,56,31,515,220,2021-03-19,1616108400.0
4691,7,1,2021-03-20,0,0,515,220,2021-03-20,1616194800.0
4692,7,1,2021-03-21,0,0,515,220,2021-03-21,1616281200.0
4693,7,1,2021-03-22,0,0,515,220,2021-03-22,1616367600.0
4694,7,1,2021-03-23,0,0,515,220,2021-03-23,1616454000.0
4695,7,1,2021-03-24,0,0,515,220,2021-03-24,1616540400.0
4696,7,1,2021-03-25,65,13,580,233,2021-03-25,1616626800.0
4697,7,1,2021-03-26,73,24,653,257,2021-03-26,1616713200.0
4698,7,1,2021-03-27,0,0,653,257,2021-03-27,1616799600.0
4699,7,1,2021-03-28,0,0,653,257,2021-03-28,1616886000.0
4700,7,1,2021-03-29,0,0,653,257,2021-03-29,1616972400.0
4701,7,1,2021-03-30,40,17,693,274,2021-03-30,1617058800.0
4702,7,1,2021-03-31,26,14,719,288,2021-03-31,1617145200.0
4703,7,1,2021-04-01,25,30,744,318,2021-04-01,1617231600.0
4704,7,1,2021-04-02,0,0,744,318,2021-04-02,1617318000.0
4705,7,1,2021-04-03,0,0,744,318,2021-04-03,1617404400.0
4706,7,1,2021-04-04,0,0,744,318,2021-04-04,1617490800.0
4707,7,1,2021-04-05,0,0,744,318,2021-04-05,1617577200.0
4708,7,1,2021-04-06,0,0,744,318,2021-04-06,1617663600.0
4709,7,1,2021-04-07,0,0,744,318,2021-04-07,1617750000.0
4710,7,1,2021-04-08,57,46,801,364,2021-04-08,1617836400.0
4711,7,1,2021-04-09,59,31,860,395,2021-04-09,1617922800.0
4712,7,1,2021-04-10,0,0,860,395,2021-04-10,1618009200.0
4713,7,1,2021-04-11,0,0,860,395,2021-04-11,1618095600.0
4714,7,1,2021-04-12,0,0,860,395,2021-04-12,1618185600.0
4715,7,1,2021-04-13,0,0,860,395,2021-04-13,1618272000.0
4716,7,1,2021-04-14,3,6,863,401,2021-04-14,1618358400.0
4717,7,1,2021-04-15,55,67,918,468,2021-04-15,1618444800.0
4718,7,1,2021-04-16,90,33,1008,501,2021-04-16,1618531200.0
4719,7,1,2021-04-17,0,1,1008,502,2021-04-17,1618617600.0
4720,7,1,2021-04-18,0,0,1008,502,2021-04-18,1618704000.0
4721,7,1,2021-04-19,1,0,1009,502,2021-04-19,1618790400.0
4722,7,1,2021-04-20,333,53,1342,555,2021-04-20,1618876800.0
4723,7,1,2021-04-21,337,11,1679,566,2021-04-21,1618963200.0
4724,7,1,2021-04-22,284,27,1963,593,2021-04-22,1619049600.0
4725,7,1,2021-04-23,258,38,2221,631,2021-04-23,1619136000.0
4726,7,1,2021-04-24,231,1,2452,632,2021-04-24,1619222400.0
4727,7,1,2021-04-25,0,0,2452,632,2021-04-25,1619308800.0
4728,7,1,2021-04-26,282,9,2734,641,2021-04-26,1619395200.0
4729,7,1,2021-04-27,223,41,2957,682,2021-04-27,1619481600.0
4730,7,1,2021-04-28,192,9,3149,691,2021-04-28,1619568000.0
4731,7,1,2021-04-29,170,14,3319,705,2021-04-29,1619654400.0
4732,7,1,2021-04-30,172,11,3491,716,2021-04-30,1619740800.0
4733,7,1,2021-05-01,201,9,3692,725,2021-05-01,1619827200.0
4734,7,1,2021-05-02,0,0,3692,725,2021-05-02,1619913600.0
4735,7,1,2021-05-03,135,6,3827,731,2021-05-03,1620000000.0
4736,7,1,2021-05-04,161,36,3988,767,2021-05-04,1620086400.0
4737,7,1,2021-05-05,221,10,4209,777,2021-05-05,1620172800.0
4738,7,1,2021-05-06,175,25,4384,802,2021-05-06,1620259200.0
4739,7,1,2021-05-07,149,21,4533,823,2021-05-07,1620345600.0
4740,7,1,2021-05-08,1,0,4534,823,2021-05-08,1620432000.0
4741,7,1,2021-05-09,0,0,4534,823,2021-05-09,1620518400.0
4742,7,1,2021-05-10,0,0,4534,823,2021-05-10,1620604800.0
4743,7,1,2021-05-11,2,41,4536,864,2021-05-11,1620691200.0
4744,7,1,2021-05-12,6,36,4542,900,2021-05-12,1620777600.0
4745,7,1,2021-05-13,0,0,4542,900,2021-05-13,1620864000.0
4746,7,1,2021-05-14,28,97,4570,997,2021-05-14,1620950400.0
4747,7,1,2021-05-15,0,0,4570,997,2021-05-15,1621036800.0
4748,7,1,2021-05-16,1,0,4571,997,2021-05-16,1621123200.0
4749,7,1,2021-05-17,1,13,4572,1010,2021-05-17,1621206000.0
4750,7,1,2021-05-18,17,28,4589,1038,2021-05-18,1621292400.0
4751,7,1,2021-05-19,0,1,4589,1039,2021-05-19,1621378800.0
4752,7,1,2021-05-20,0,8,4589,1047,2021-05-20,1621465200.0
4753,7,1,2021-05-21,12,30,4601,1077,2021-05-21,1621551600.0
4754,7,1,2021-05-22,0,0,4601,1077,2021-05-22,1621638000.0
4755,7,1,2021-05-23,0,0,4601,1077,2021-05-23,1621724400.0
4756,7,1,2021-05-24,0,0,4601,1077,2021-05-24,1621810800.0
4757,7,1,2021-05-25,50,327,4651,1404,2021-05-25,1621897200.0
4758,7,1,2021-05-26,54,348,4705,1752,2021-05-26,1621983600.0
4759,7,1,2021-05-27,34,316,4739,2068,2021-05-27,1622070000.0
4760,7,1,2021-05-28,27,251,4766,2319,2021-05-28,1622156400.0
4761,7,1,2021-05-29,35,371,4801,2690,2021-05-29,1622242800.0
4762,7,1,2021-05-30,0,0,4801,2690,2021-05-30,1622329200.0
4763,7,1,2021-05-31,45,213,4846,2903,2021-05-31,1622415600.0
4764,7,1,2021-06-01,46,221,4892,3124,2021-06-01,1622502000.0
4765,7,1,2021-06-02,69,262,4961,3386,2021-06-02,1622588400.0
4766,7,1,2021-06-03,41,243,5002,3629,2021-06-03,1622674800.0
4767,7,1,2021-06-04,70,262,5072,3891,2021-06-04,1622761200.0
4768,7,1,2021-06-05,0,0,5072,3891,2021-06-05,1622847600.0
4769,7,1,2021-06-06,0,0,5072,3891,2021-06-06,1622934000.0
4770,7,1,2021-06-07,0,1,5072,3892,2021-06-07,1623020400.0
4771,7,1,2021-06-08,0,0,5072,3892,2021-06-08,1623106800.0
4772,7,1,2021-06-09,0,0,5072,3892,2021-06-09,1623193200.0
4773,7,1,2021-06-10,0,1,5072,3893,2021-06-10,1623279600.0
4774,7,1,2021-06-11,0,1,5072,3894,2021-06-11,1623366000.0
4775,7,1,2021-06-12,16,56,5088,3950,2021-06-12,1623452400.0
4776,7,1,2021-06-13,0,0,5088,3950,2021-06-13,1623538800.0
4777,7,1,2021-06-14,0,0,5088,3950,2021-06-14,1623625200.0
4778,7,1,2021-06-15,0,1,5088,3951,2021-06-15,1623711600.0
4779,7,1,2021-06-16,0,0,5088,3951,2021-06-16,1623798000.0
4780,7,1,2021-06-17,2,5,5090,3956,2021-06-17,1623884400.0
4781,7,1,2021-06-18,0,0,5090,3956,2021-06-18,1623970800.0
4782,7,1,2021-06-19,25,47,5115,4003,2021-06-19,1624057200.0
4783,7,1,2021-06-20,0,0,5115,4003,2021-06-20,1624143600.0
4784,7,1,2021-06-21,0,2,5115,4005,2021-06-21,1624230000.0
4785,7,1,2021-06-22,0,0,5115,4005,2021-06-22,1624316400.0
4786,7,1,2021-06-23,5,0,5120,4005,2021-06-23,1624402800.0
4787,7,1,2021-06-24,0,4,5120,4009,2021-06-24,1624489200.0
4788,7,1,2021-06-25,0,0,5120,4009,2021-06-25,1624575600.0
4789,7,1,2021-06-26,28,39,5148,4048,2021-06-26,1624662000.0
4790,7,1,2021-06-27,0,0,5148,4048,2021-06-27,1624748400.0
4791,7,1,2021-06-28,0,1,5148,4049,2021-06-28,1624834800.0
4792,7,1,2021-06-29,0,0,5148,4049,2021-06-29,1624921200.0
4793,7,1,2021-06-30,0,0,5148,4049,2021-06-30,1625007600.0
4794,7,1,2021-07-01,26,22,5174,4071,2021-07-01,1625094000.0
4795,7,1,2021-07-02,26,22,5200,4093,2021-07-02,1625180400.0
4796,7,1,2021-07-03,27,206,5227,4299,2021-07-03,1625266800.0
4797,7,1,2021-07-04,0,0,5227,4299,2021-07-04,1625353200.0
4798,7,1,2021-07-05,0,3,5227,4302,2021-07-05,1625439600.0
4799,7,1,2021-07-06,0,0,5227,4302,2021-07-06,1625526000.0
4800,7,2,2020-12-27,0,0,0,0,2020-12-27,1609023600.0
4801,7,2,2020-12-28,0,0,0,0,2020-12-28,1609110000.0
4802,7,2,2020-12-29,0,0,0,0,2020-12-29,1609196400.0
4803,7,2,2020-12-30,0,0,0,0,2020-12-30,1609282800.0
4804,7,2,2020-12-31,0,0,0,0,2020-12-31,1609369200.0
4805,7,2,2021-01-01,0,0,0,0,2021-01-01,1609455600.0
4806,7,2,2021-01-02,0,0,0,0,2021-01-02,1609542000.0
4807,7,2,2021-01-03,0,0,0,0,2021-01-03,1609628400.0
4808,7,2,2021-01-04,0,0,0,0,2021-01-04,1609714800.0
4809,7,2,2021-01-05,0,0,0,0,2021-01-05,1609801200.0
4810,7,2,2021-01-06,0,0,0,0,2021-01-06,1609887600.0
4811,7,2,2021-01-07,0,0,0,0,2021-01-07,1609974000.0
4812,7,2,2021-01-08,0,0,0,0,2021-01-08,1610060400.0
4813,7,2,2021-01-09,0,0,0,0,2021-01-09,1610146800.0
4814,7,2,2021-01-10,0,0,0,0,2021-01-10,1610233200.0
4815,7,2,2021-01-11,0,0,0,0,2021-01-11,1610319600.0
4816,7,2,2021-01-12,0,0,0,0,2021-01-12,1610406000.0
4817,7,2,2021-01-13,0,0,0,0,2021-01-13,1610492400.0
4818,7,2,2021-01-14,0,0,0,0,2021-01-14,1610578800.0
4819,7,2,2021-01-15,0,0,0,0,2021-01-15,1610665200.0
4820,7,2,2021-01-16,0,0,0,0,2021-01-16,1610751600.0
4821,7,2,2021-01-17,0,0,0,0,2021-01-17,1610838000.0
4822,7,2,2021-01-18,0,0,0,0,2021-01-18,1610924400.0
4823,7,2,2021-01-19,0,0,0,0,2021-01-19,1611010800.0
4824,7,2,2021-01-20,0,0,0,0,2021-01-20,1611097200.0
4825,7,2,2021-01-21,0,0,0,0,2021-01-21,1611183600.0
4826,7,2,2021-01-22,0,0,0,0,2021-01-22,1611270000.0
4827,7,2,2021-01-23,0,0,0,0,2021-01-23,1611356400.0
4828,7,2,2021-01-24,0,0,0,0,2021-01-24,1611442800.0
4829,7,2,2021-01-25,0,0,0,0,2021-01-25,1611529200.0
4830,7,2,2021-01-26,0,0,0,0,2021-01-26,1611615600.0
4831,7,2,2021-01-27,0,0,0,0,2021-01-27,1611702000.0
4832,7,2,2021-01-28,0,0,0,0,2021-01-28,1611788400.0
4833,7,2,2021-01-29,0,0,0,0,2021-01-29,1611874800.0
4834,7,2,2021-01-30,0,0,0,0,2021-01-30,1611961200.0
4835,7,2,2021-01-31,0,0,0,0,2021-01-31,1612047600.0
4836,7,2,2021-02-01,0,0,0,0,2021-02-01,1612134000.0
4837,7,2,2021-02-02,0,0,0,0,2021-02-02,1612220400.0
4838,7,2,2021-02-03,0,0,0,0,2021-02-03,1612306800.0
4839,7,2,2021-02-04,0,0,0,0,2021-02-04,1612393200.0
4840,7,2,2021-02-05,0,0,0,0,2021-02-05,1612479600.0
4841,7,2,2021-02-06,0,0,0,0,2021-02-06,1612566000.0
4842,7,2,2021-02-07,0,0,0,0,2021-02-07,1612652400.0
4843,7,2,2021-02-08,0,0,0,0,2021-02-08,1612738800.0
4844,7,2,2021-02-09,0,0,0,0,2021-02-09,1612825200.0
4845,7,2,2021-02-10,0,0,0,0,2021-02-10,1612911600.0
4846,7,2,2021-02-11,0,0,0,0,2021-02-11,1612998000.0
4847,7,2,2021-02-12,0,0,0,0,2021-02-12,1613084400.0
4848,7,2,2021-02-13,0,0,0,0,2021-02-13,1613170800.0
4849,7,2,2021-02-14,0,0,0,0,2021-02-14,1613257200.0
4850,7,2,2021-02-15,0,0,0,0,2021-02-15,1613343600.0
4851,7,2,2021-02-16,0,0,0,0,2021-02-16,1613430000.0
4852,7,2,2021-02-17,0,0,0,0,2021-02-17,1613516400.0
4853,7,2,2021-02-18,0,0,0,0,2021-02-18,1613602800.0
4854,7,2,2021-02-19,0,0,0,0,2021-02-19,1613689200.0
4855,7,2,2021-02-20,0,0,0,0,2021-02-20,1613775600.0
4856,7,2,2021-02-21,0,0,0,0,2021-02-21,1613862000.0
4857,7,2,2021-02-22,0,0,0,0,2021-02-22,1613948400.0
4858,7,2,2021-02-23,0,0,0,0,2021-02-23,1614034800.0
4859,7,2,2021-02-24,0,0,0,0,2021-02-24,1614121200.0
4860,7,2,2021-02-25,0,0,0,0,2021-02-25,1614207600.0
4861,7,2,2021-02-26,0,0,0,0,2021-02-26,1614294000.0
4862,7,2,2021-02-27,0,0,0,0,2021-02-27,1614380400.0
4863,7,2,2021-02-28,0,0,0,0,2021-02-28,1614466800.0
4864,7,2,2021-03-01,0,0,0,0,2021-03-01,1614553200.0
4865,7,2,2021-03-02,0,0,0,0,2021-03-02,1614639600.0
4866,7,2,2021-03-03,0,0,0,0,2021-03-03,1614726000.0
4867,7,2,2021-03-04,0,0,0,0,2021-03-04,1614812400.0
4868,7,2,2021-03-05,0,0,0,0,2021-03-05,1614898800.0
4869,7,2,2021-03-06,0,0,0,0,2021-03-06,1614985200.0
4870,7,2,2021-03-07,0,0,0,0,2021-03-07,1615071600.0
4871,7,2,2021-03-08,0,0,0,0,2021-03-08,1615158000.0
4872,7,2,2021-03-09,0,0,0,0,2021-03-09,1615244400.0
4873,7,2,2021-03-10,0,0,0,0,2021-03-10,1615330800.0
4874,7,2,2021-03-11,0,0,0,0,2021-03-11,1615417200.0
4875,7,2,2021-03-12,0,0,0,0,2021-03-12,1615503600.0
4876,7,2,2021-03-13,0,0,0,0,2021-03-13,1615590000.0
4877,7,2,2021-03-14,0,0,0,0,2021-03-14,1615676400.0
4878,7,2,2021-03-15,0,0,0,0,2021-03-15,1615762800.0
4879,7,2,2021-03-16,0,0,0,0,2021-03-16,1615849200.0
4880,7,2,2021-03-17,0,0,0,0,2021-03-17,1615935600.0
4881,7,2,2021-03-18,0,0,0,0,2021-03-18,1616022000.0
4882,7,2,2021-03-19,0,0,0,0,2021-03-19,1616108400.0
4883,7,2,2021-03-20,0,0,0,0,2021-03-20,1616194800.0
4884,7,2,2021-03-21,0,0,0,0,2021-03-21,1616281200.0
4885,7,2,2021-03-22,0,0,0,0,2021-03-22,1616367600.0
4886,7,2,2021-03-23,0,0,0,0,2021-03-23,1616454000.0
4887,7,2,2021-03-24,0,0,0,0,2021-03-24,1616540400.0
4888,7,2,2021-03-25,0,0,0,0,2021-03-25,1616626800.0
4889,7,2,2021-03-26,0,0,0,0,2021-03-26,1616713200.0
4890,7,2,2021-03-27,0,0,0,0,2021-03-27,1616799600.0
4891,7,2,2021-03-28,0,0,0,0,2021-03-28,1616886000.0
4892,7,2,2021-03-29,0,0,0,0,2021-03-29,1616972400.0
4893,7,2,2021-03-30,0,0,0,0,2021-03-30,1617058800.0
4894,7,2,2021-03-31,0,0,0,0,2021-03-31,1617145200.0
4895,7,2,2021-04-01,0,0,0,0,2021-04-01,1617231600.0
4896,7,2,2021-04-02,0,0,0,0,2021-04-02,1617318000.0
4897,7,2,2021-04-03,0,0,0,0,2021-04-03,1617404400.0
4898,7,2,2021-04-04,0,0,0,0,2021-04-04,1617490800.0
4899,7,2,2021-04-05,0,0,0,0,2021-04-05,1617577200.0
4900,7,2,2021-04-06,0,0,0,0,2021-04-06,1617663600.0
4901,7,2,2021-04-07,0,0,0,0,2021-04-07,1617750000.0
4902,7,2,2021-04-08,0,0,0,0,2021-04-08,1617836400.0
4903,7,2,2021-04-09,0,0,0,0,2021-04-09,1617922800.0
4904,7,2,2021-04-10,0,0,0,0,2021-04-10,1618009200.0
4905,7,2,2021-04-11,0,0,0,0,2021-04-11,1618095600.0
4906,7,2,2021-04-12,0,0,0,0,2021-04-12,1618185600.0
4907,7,2,2021-04-13,0,0,0,0,2021-04-13,1618272000.0
4908,7,2,2021-04-14,1,0,1,0,2021-04-14,1618358400.0
4909,7,2,2021-04-15,0,0,1,0,2021-04-15,1618444800.0
4910,7,2,2021-04-16,0,0,1,0,2021-04-16,1618531200.0
4911,7,2,2021-04-17,0,0,1,0,2021-04-17,1618617600.0
4912,7,2,2021-04-18,0,0,1,0,2021-04-18,1618704000.0
4913,7,2,2021-04-19,0,0,1,0,2021-04-19,1618790400.0
4914,7,2,2021-04-20,0,0,1,0,2021-04-20,1618876800.0
4915,7,2,2021-04-21,0,0,1,0,2021-04-21,1618963200.0
4916,7,2,2021-04-22,0,0,1,0,2021-04-22,1619049600.0
4917,7,2,2021-04-23,0,0,1,0,2021-04-23,1619136000.0
4918,7,2,2021-04-24,0,0,1,0,2021-04-24,1619222400.0
4919,7,2,2021-04-25,0,0,1,0,2021-04-25,1619308800.0
4920,7,2,2021-04-26,0,0,1,0,2021-04-26,1619395200.0
4921,7,2,2021-04-27,0,0,1,0,2021-04-27,1619481600.0
4922,7,2,2021-04-28,0,0,1,0,2021-04-28,1619568000.0
4923,7,2,2021-04-29,0,0,1,0,2021-04-29,1619654400.0
4924,7,2,2021-04-30,0,0,1,0,2021-04-30,1619740800.0
4925,7,2,2021-05-01,0,0,1,0,2021-05-01,1619827200.0
4926,7,2,2021-05-02,0,0,1,0,2021-05-02,1619913600.0
4927,7,2,2021-05-03,0,0,1,0,2021-05-03,1620000000.0
4928,7,2,2021-05-04,0,0,1,0,2021-05-04,1620086400.0
4929,7,2,2021-05-05,0,0,1,0,2021-05-05,1620172800.0
4930,7,2,2021-05-06,0,0,1,0,2021-05-06,1620259200.0
4931,7,2,2021-05-07,0,0,1,0,2021-05-07,1620345600.0
4932,7,2,2021-05-08,0,0,1,0,2021-05-08,1620432000.0
4933,7,2,2021-05-09,0,0,1,0,2021-05-09,1620518400.0
4934,7,2,2021-05-10,0,0,1,0,2021-05-10,1620604800.0
4935,7,2,2021-05-11,0,0,1,0,2021-05-11,1620691200.0
4936,7,2,2021-05-12,0,0,1,0,2021-05-12,1620777600.0
4937,7,2,2021-05-13,0,0,1,0,2021-05-13,1620864000.0
4938,7,2,2021-05-14,0,0,1,0,2021-05-14,1620950400.0
4939,7,2,2021-05-15,0,0,1,0,2021-05-15,1621036800.0
4940,7,2,2021-05-16,0,0,1,0,2021-05-16,1621123200.0
4941,7,2,2021-05-17,0,0,1,0,2021-05-17,1621206000.0
4942,7,2,2021-05-18,0,0,1,0,2021-05-18,1621292400.0
4943,7,2,2021-05-19,0,0,1,0,2021-05-19,1621378800.0
4944,7,2,2021-05-20,0,0,1,0,2021-05-20,1621465200.0
4945,7,2,2021-05-21,0,0,1,0,2021-05-21,1621551600.0
4946,7,2,2021-05-22,0,0,1,0,2021-05-22,1621638000.0
4947,7,2,2021-05-23,0,0,1,0,2021-05-23,1621724400.0
4948,7,2,2021-05-24,0,0,1,0,2021-05-24,1621810800.0
4949,7,2,2021-05-25,0,0,1,0,2021-05-25,1621897200.0
4950,7,2,2021-05-26,0,0,1,0,2021-05-26,1621983600.0
4951,7,2,2021-05-27,0,0,1,0,2021-05-27,1622070000.0
4952,7,2,2021-05-28,0,0,1,0,2021-05-28,1622156400.0
4953,7,2,2021-05-29,0,0,1,0,2021-05-29,1622242800.0
4954,7,2,2021-05-30,0,0,1,0,2021-05-30,1622329200.0
4955,7,2,2021-05-31,0,0,1,0,2021-05-31,1622415600.0
4956,7,2,2021-06-01,0,0,1,0,2021-06-01,1622502000.0
4957,7,2,2021-06-02,0,0,1,0,2021-06-02,1622588400.0
4958,7,2,2021-06-03,0,0,1,0,2021-06-03,1622674800.0
4959,7,2,2021-06-04,4,0,5,0,2021-06-04,1622761200.0
4960,7,2,2021-06-05,0,0,5,0,2021-06-05,1622847600.0
4961,7,2,2021-06-06,0,0,5,0,2021-06-06,1622934000.0
4962,7,2,2021-06-07,0,0,5,0,2021-06-07,1623020400.0
4963,7,2,2021-06-08,0,0,5,0,2021-06-08,1623106800.0
4964,7,2,2021-06-09,0,0,5,0,2021-06-09,1623193200.0
4965,7,2,2021-06-10,6,0,11,0,2021-06-10,1623279600.0
4966,7,2,2021-06-11,0,0,11,0,2021-06-11,1623366000.0
4967,7,2,2021-06-12,0,0,11,0,2021-06-12,1623452400.0
4968,7,2,2021-06-13,0,0,11,0,2021-06-13,1623538800.0
4969,7,2,2021-06-14,0,0,11,0,2021-06-14,1623625200.0
4970,7,2,2021-06-15,0,0,11,0,2021-06-15,1623711600.0
4971,7,2,2021-06-16,0,0,11,0,2021-06-16,1623798000.0
4972,7,2,2021-06-17,0,0,11,0,2021-06-17,1623884400.0
4973,7,2,2021-06-18,0,0,11,0,2021-06-18,1623970800.0
4974,7,2,2021-06-19,0,0,11,0,2021-06-19,1624057200.0
4975,7,2,2021-06-20,0,0,11,0,2021-06-20,1624143600.0
4976,7,2,2021-06-21,0,0,11,0,2021-06-21,1624230000.0
4977,7,2,2021-06-22,8,0,19,0,2021-06-22,1624316400.0
4978,7,2,2021-06-23,10,0,29,0,2021-06-23,1624402800.0
4979,7,2,2021-06-24,0,0,29,0,2021-06-24,1624489200.0
4980,7,2,2021-06-25,0,0,29,0,2021-06-25,1624575600.0
4981,7,2,2021-06-26,0,0,29,0,2021-06-26,1624662000.0
4982,7,2,2021-06-27,0,0,29,0,2021-06-27,1624748400.0
4983,7,2,2021-06-28,0,0,29,0,2021-06-28,1624834800.0
4984,7,2,2021-06-29,0,0,29,0,2021-06-29,1624921200.0
4985,7,2,2021-06-30,0,0,29,0,2021-06-30,1625007600.0
4986,7,2,2021-07-01,0,0,29,0,2021-07-01,1625094000.0
4987,7,2,2021-07-02,0,0,29,0,2021-07-02,1625180400.0
4988,7,2,2021-07-03,0,0,29,0,2021-07-03,1625266800.0
4989,7,2,2021-07-04,0,0,29,0,2021-07-04,1625353200.0
4990,7,2,2021-07-05,4,5,33,5,2021-07-05,1625439600.0
4991,7,2,2021-07-06,0,0,33,5,2021-07-06,1625526000.0
4992,7,3,2020-12-27,0,0,0,0,2020-12-27,1609023600.0
4993,7,3,2020-12-28,0,0,0,0,2020-12-28,1609110000.0
4994,7,3,2020-12-29,0,0,0,0,2020-12-29,1609196400.0
4995,7,3,2020-12-30,0,0,0,0,2020-12-30,1609282800.0
4996,7,3,2020-12-31,0,0,0,0,2020-12-31,1609369200.0
4997,7,3,2021-01-01,0,0,0,0,2021-01-01,1609455600.0
4998,7,3,2021-01-02,0,0,0,0,2021-01-02,1609542000.0
4999,7,3,2021-01-03,0,0,0,0,2021-01-03,1609628400.0
5000,7,3,2021-01-04,0,0,0,0,2021-01-04,1609714800.0
5001,7,3,2021-01-05,0,0,0,0,2021-01-05,1609801200.0
5002,7,3,2021-01-06,0,0,0,0,2021-01-06,1609887600.0
5003,7,3,2021-01-07,0,0,0,0,2021-01-07,1609974000.0
5004,7,3,2021-01-08,0,0,0,0,2021-01-08,1610060400.0
5005,7,3,2021-01-09,0,0,0,0,2021-01-09,1610146800.0
5006,7,3,2021-01-10,0,0,0,0,2021-01-10,1610233200.0
5007,7,3,2021-01-11,0,0,0,0,2021-01-11,1610319600.0
5008,7,3,2021-01-12,0,0,0,0,2021-01-12,1610406000.0
5009,7,3,2021-01-13,0,0,0,0,2021-01-13,1610492400.0
5010,7,3,2021-01-14,0,0,0,0,2021-01-14,1610578800.0
5011,7,3,2021-01-15,0,0,0,0,2021-01-15,1610665200.0
5012,7,3,2021-01-16,0,0,0,0,2021-01-16,1610751600.0
5013,7,3,2021-01-17,0,0,0,0,2021-01-17,1610838000.0
5014,7,3,2021-01-18,0,0,0,0,2021-01-18,1610924400.0
5015,7,3,2021-01-19,0,0,0,0,2021-01-19,1611010800.0
5016,7,3,2021-01-20,0,0,0,0,2021-01-20,1611097200.0
5017,7,3,2021-01-21,0,0,0,0,2021-01-21,1611183600.0
5018,7,3,2021-01-22,0,0,0,0,2021-01-22,1611270000.0
5019,7,3,2021-01-23,0,0,0,0,2021-01-23,1611356400.0
5020,7,3,2021-01-24,0,0,0,0,2021-01-24,1611442800.0
5021,7,3,2021-01-25,0,0,0,0,2021-01-25,1611529200.0
5022,7,3,2021-01-26,0,0,0,0,2021-01-26,1611615600.0
5023,7,3,2021-01-27,0,0,0,0,2021-01-27,1611702000.0
5024,7,3,2021-01-28,0,0,0,0,2021-01-28,1611788400.0
5025,7,3,2021-01-29,0,0,0,0,2021-01-29,1611874800.0
5026,7,3,2021-01-30,0,0,0,0,2021-01-30,1611961200.0
5027,7,3,2021-01-31,0,0,0,0,2021-01-31,1612047600.0
5028,7,3,2021-02-01,0,0,0,0,2021-02-01,1612134000.0
5029,7,3,2021-02-02,0,0,0,0,2021-02-02,1612220400.0
5030,7,3,2021-02-03,0,0,0,0,2021-02-03,1612306800.0
5031,7,3,2021-02-04,0,0,0,0,2021-02-04,1612393200.0
5032,7,3,2021-02-05,0,0,0,0,2021-02-05,1612479600.0
5033,7,3,2021-02-06,0,0,0,0,2021-02-06,1612566000.0
5034,7,3,2021-02-07,0,0,0,0,2021-02-07,1612652400.0
5035,7,3,2021-02-08,0,0,0,0,2021-02-08,1612738800.0
5036,7,3,2021-02-09,0,0,0,0,2021-02-09,1612825200.0
5037,7,3,2021-02-10,0,0,0,0,2021-02-10,1612911600.0
5038,7,3,2021-02-11,0,0,0,0,2021-02-11,1612998000.0
5039,7,3,2021-02-12,0,0,0,0,2021-02-12,1613084400.0
5040,7,3,2021-02-13,0,0,0,0,2021-02-13,1613170800.0
5041,7,3,2021-02-14,0,0,0,0,2021-02-14,1613257200.0
5042,7,3,2021-02-15,0,0,0,0,2021-02-15,1613343600.0
5043,7,3,2021-02-16,0,0,0,0,2021-02-16,1613430000.0
5044,7,3,2021-02-17,0,0,0,0,2021-02-17,1613516400.0
5045,7,3,2021-02-18,0,0,0,0,2021-02-18,1613602800.0
5046,7,3,2021-02-19,0,0,0,0,2021-02-19,1613689200.0
5047,7,3,2021-02-20,0,0,0,0,2021-02-20,1613775600.0
5048,7,3,2021-02-21,0,0,0,0,2021-02-21,1613862000.0
5049,7,3,2021-02-22,0,0,0,0,2021-02-22,1613948400.0
5050,7,3,2021-02-23,0,0,0,0,2021-02-23,1614034800.0
5051,7,3,2021-02-24,0,0,0,0,2021-02-24,1614121200.0
5052,7,3,2021-02-25,0,0,0,0,2021-02-25,1614207600.0
5053,7,3,2021-02-26,0,0,0,0,2021-02-26,1614294000.0
5054,7,3,2021-02-27,0,0,0,0,2021-02-27,1614380400.0
5055,7,3,2021-02-28,0,0,0,0,2021-02-28,1614466800.0
5056,7,3,2021-03-01,0,0,0,0,2021-03-01,1614553200.0
5057,7,3,2021-03-02,0,0,0,0,2021-03-02,1614639600.0
5058,7,3,2021-03-03,0,0,0,0,2021-03-03,1614726000.0
5059,7,3,2021-03-04,0,0,0,0,2021-03-04,1614812400.0
5060,7,3,2021-03-05,2,0,2,0,2021-03-05,1614898800.0
5061,7,3,2021-03-06,0,0,2,0,2021-03-06,1614985200.0
5062,7,3,2021-03-07,0,0,2,0,2021-03-07,1615071600.0
5063,7,3,2021-03-08,0,0,2,0,2021-03-08,1615158000.0
5064,7,3,2021-03-09,0,0,2,0,2021-03-09,1615244400.0
5065,7,3,2021-03-10,0,0,2,0,2021-03-10,1615330800.0
5066,7,3,2021-03-11,0,0,2,0,2021-03-11,1615417200.0
5067,7,3,2021-03-12,0,0,2,0,2021-03-12,1615503600.0
5068,7,3,2021-03-13,0,0,2,0,2021-03-13,1615590000.0
5069,7,3,2021-03-14,0,0,2,0,2021-03-14,1615676400.0
5070,7,3,2021-03-15,0,0,2,0,2021-03-15,1615762800.0
5071,7,3,2021-03-16,0,0,2,0,2021-03-16,1615849200.0
5072,7,3,2021-03-17,0,0,2,0,2021-03-17,1615935600.0
5073,7,3,2021-03-18,0,0,2,0,2021-03-18,1616022000.0
5074,7,3,2021-03-19,0,0,2,0,2021-03-19,1616108400.0
5075,7,3,2021-03-20,0,0,2,0,2021-03-20,1616194800.0
5076,7,3,2021-03-21,0,0,2,0,2021-03-21,1616281200.0
5077,7,3,2021-03-22,0,0,2,0,2021-03-22,1616367600.0
5078,7,3,2021-03-23,0,0,2,0,2021-03-23,1616454000.0
5079,7,3,2021-03-24,0,0,2,0,2021-03-24,1616540400.0
5080,7,3,2021-03-25,0,0,2,0,2021-03-25,1616626800.0
5081,7,3,2021-03-26,0,0,2,0,2021-03-26,1616713200.0
5082,7,3,2021-03-27,0,0,2,0,2021-03-27,1616799600.0
5083,7,3,2021-03-28,0,0,2,0,2021-03-28,1616886000.0
5084,7,3,2021-03-29,0,0,2,0,2021-03-29,1616972400.0
5085,7,3,2021-03-30,0,0,2,0,2021-03-30,1617058800.0
5086,7,3,2021-03-31,0,0,2,0,2021-03-31,1617145200.0
5087,7,3,2021-04-01,0,0,2,0,2021-04-01,1617231600.0
5088,7,3,2021-04-02,0,0,2,0,2021-04-02,1617318000.0
5089,7,3,2021-04-03,0,0,2,0,2021-04-03,1617404400.0
5090,7,3,2021-04-04,0,0,2,0,2021-04-04,1617490800.0
5091,7,3,2021-04-05,9,0,11,0,2021-04-05,1617577200.0
5092,7,3,2021-04-06,0,0,11,0,2021-04-06,1617663600.0
5093,7,3,2021-04-07,0,0,11,0,2021-04-07,1617750000.0
5094,7,3,2021-04-08,0,0,11,0,2021-04-08,1617836400.0
5095,7,3,2021-04-09,0,0,11,0,2021-04-09,1617922800.0
5096,7,3,2021-04-10,0,0,11,0,2021-04-10,1618009200.0
5097,7,3,2021-04-11,0,0,11,0,2021-04-11,1618095600.0
5098,7,3,2021-04-12,0,0,11,0,2021-04-12,1618185600.0
5099,7,3,2021-04-13,0,0,11,0,2021-04-13,1618272000.0
5100,7,3,2021-04-14,1,0,12,0,2021-04-14,1618358400.0
5101,7,3,2021-04-15,1,0,13,0,2021-04-15,1618444800.0
5102,7,3,2021-04-16,0,0,13,0,2021-04-16,1618531200.0
5103,7,3,2021-04-17,0,0,13,0,2021-04-17,1618617600.0
5104,7,3,2021-04-18,0,0,13,0,2021-04-18,1618704000.0
5105,7,3,2021-04-19,0,0,13,0,2021-04-19,1618790400.0
5106,7,3,2021-04-20,2,0,15,0,2021-04-20,1618876800.0
5107,7,3,2021-04-21,0,0,15,0,2021-04-21,1618963200.0
5108,7,3,2021-04-22,0,0,15,0,2021-04-22,1619049600.0
5109,7,3,2021-04-23,0,0,15,0,2021-04-23,1619136000.0
5110,7,3,2021-04-24,0,0,15,0,2021-04-24,1619222400.0
5111,7,3,2021-04-25,0,0,15,0,2021-04-25,1619308800.0
5112,7,3,2021-04-26,1,0,16,0,2021-04-26,1619395200.0
5113,7,3,2021-04-27,1,0,17,0,2021-04-27,1619481600.0
5114,7,3,2021-04-28,0,0,17,0,2021-04-28,1619568000.0
5115,7,3,2021-04-29,0,0,17,0,2021-04-29,1619654400.0
5116,7,3,2021-04-30,0,1,17,1,2021-04-30,1619740800.0
5117,7,3,2021-05-01,0,0,17,1,2021-05-01,1619827200.0
5118,7,3,2021-05-02,0,0,17,1,2021-05-02,1619913600.0
5119,7,3,2021-05-03,0,0,17,1,2021-05-03,1620000000.0
5120,7,3,2021-05-04,0,0,17,1,2021-05-04,1620086400.0
5121,7,3,2021-05-05,0,0,17,1,2021-05-05,1620172800.0
5122,7,3,2021-05-06,0,0,17,1,2021-05-06,1620259200.0
5123,7,3,2021-05-07,0,0,17,1,2021-05-07,1620345600.0
5124,7,3,2021-05-08,0,0,17,1,2021-05-08,1620432000.0
5125,7,3,2021-05-09,0,2,17,3,2021-05-09,1620518400.0
5126,7,3,2021-05-10,0,0,17,3,2021-05-10,1620604800.0
5127,7,3,2021-05-11,0,0,17,3,2021-05-11,1620691200.0
5128,7,3,2021-05-12,0,0,17,3,2021-05-12,1620777600.0
5129,7,3,2021-05-13,0,0,17,3,2021-05-13,1620864000.0
5130,7,3,2021-05-14,0,0,17,3,2021-05-14,1620950400.0
5131,7,3,2021-05-15,0,0,17,3,2021-05-15,1621036800.0
5132,7,3,2021-05-16,0,0,17,3,2021-05-16,1621123200.0
5133,7,3,2021-05-17,0,0,17,3,2021-05-17,1621206000.0
5134,7,3,2021-05-18,0,0,17,3,2021-05-18,1621292400.0
5135,7,3,2021-05-19,0,0,17,3,2021-05-19,1621378800.0
5136,7,3,2021-05-20,0,0,17,3,2021-05-20,1621465200.0
5137,7,3,2021-05-21,0,0,17,3,2021-05-21,1621551600.0
5138,7,3,2021-05-22,0,0,17,3,2021-05-22,1621638000.0
5139,7,3,2021-05-23,0,0,17,3,2021-05-23,1621724400.0
5140,7,3,2021-05-24,0,0,17,3,2021-05-24,1621810800.0
5141,7,3,2021-05-25,0,0,17,3,2021-05-25,1621897200.0
5142,7,3,2021-05-26,0,1,17,4,2021-05-26,1621983600.0
5143,7,3,2021-05-27,0,0,17,4,2021-05-27,1622070000.0
5144,7,3,2021-05-28,0,0,17,4,2021-05-28,1622156400.0
5145,7,3,2021-05-29,0,0,17,4,2021-05-29,1622242800.0
5146,7,3,2021-05-30,0,0,17,4,2021-05-30,1622329200.0
5147,7,3,2021-05-31,0,0,17,4,2021-05-31,1622415600.0
5148,7,3,2021-06-01,1,2,18,6,2021-06-01,1622502000.0
5149,7,3,2021-06-02,0,0,18,6,2021-06-02,1622588400.0
5150,7,3,2021-06-03,0,0,18,6,2021-06-03,1622674800.0
5151,7,3,2021-06-04,0,0,18,6,2021-06-04,1622761200.0
5152,7,3,2021-06-05,1,0,19,6,2021-06-05,1622847600.0
5153,7,3,2021-06-06,0,0,19,6,2021-06-06,1622934000.0
5154,7,3,2021-06-07,1,0,20,6,2021-06-07,1623020400.0
5155,7,3,2021-06-08,3,2,23,8,2021-06-08,1623106800.0
5156,7,3,2021-06-09,0,3,23,11,2021-06-09,1623193200.0
5157,7,3,2021-06-10,2,0,25,11,2021-06-10,1623279600.0
5158,7,3,2021-06-11,3,5,28,16,2021-06-11,1623366000.0
5159,7,3,2021-06-12,0,0,28,16,2021-06-12,1623452400.0
5160,7,3,2021-06-13,0,0,28,16,2021-06-13,1623538800.0
5161,7,3,2021-06-14,0,0,28,16,2021-06-14,1623625200.0
5162,7,3,2021-06-15,0,0,28,16,2021-06-15,1623711600.0
5163,7,3,2021-06-16,0,0,28,16,2021-06-16,1623798000.0
5164,7,3,2021-06-17,0,1,28,17,2021-06-17,1623884400.0
5165,7,3,2021-06-18,0,2,28,19,2021-06-18,1623970800.0
5166,7,3,2021-06-19,0,0,28,19,2021-06-19,1624057200.0
5167,7,3,2021-06-20,0,0,28,19,2021-06-20,1624143600.0
5168,7,3,2021-06-21,0,0,28,19,2021-06-21,1624230000.0
5169,7,3,2021-06-22,0,0,28,19,2021-06-22,1624316400.0
5170,7,3,2021-06-23,0,2,28,21,2021-06-23,1624402800.0
5171,7,3,2021-06-24,10,1,38,22,2021-06-24,1624489200.0
5172,7,3,2021-06-25,0,0,38,22,2021-06-25,1624575600.0
5173,7,3,2021-06-26,0,0,38,22,2021-06-26,1624662000.0
5174,7,3,2021-06-27,0,0,38,22,2021-06-27,1624748400.0
5175,7,3,2021-06-28,0,0,38,22,2021-06-28,1624834800.0
5176,7,3,2021-06-29,0,0,38,22,2021-06-29,1624921200.0
5177,7,3,2021-06-30,0,0,38,22,2021-06-30,1625007600.0
5178,7,3,2021-07-01,0,0,38,22,2021-07-01,1625094000.0
5179,7,3,2021-07-02,0,0,38,22,2021-07-02,1625180400.0
5180,7,3,2021-07-03,0,0,38,22,2021-07-03,1625266800.0
5181,7,3,2021-07-04,0,0,38,22,2021-07-04,1625353200.0
5182,7,3,2021-07-05,0,0,38,22,2021-07-05,1625439600.0
5183,7,3,2021-07-06,0,0,38,22,2021-07-06,1625526000.0
5184,7,4,2020-12-27,0,0,0,0,2020-12-27,1609023600.0
5185,7,4,2020-12-28,0,0,0,0,2020-12-28,1609110000.0
5186,7,4,2020-12-29,0,0,0,0,2020-12-29,1609196400.0
5187,7,4,2020-12-30,0,0,0,0,2020-12-30,1609282800.0
5188,7,4,2020-12-31,0,0,0,0,2020-12-31,1609369200.0
5189,7,4,2021-01-01,0,0,0,0,2021-01-01,1609455600.0
5190,7,4,2021-01-02,0,0,0,0,2021-01-02,1609542000.0
5191,7,4,2021-01-03,0,0,0,0,2021-01-03,1609628400.0
5192,7,4,2021-01-04,0,0,0,0,2021-01-04,1609714800.0
5193,7,4,2021-01-05,0,0,0,0,2021-01-05,1609801200.0
5194,7,4,2021-01-06,0,0,0,0,2021-01-06,1609887600.0
5195,7,4,2021-01-07,0,0,0,0,2021-01-07,1609974000.0
5196,7,4,2021-01-08,0,0,0,0,2021-01-08,1610060400.0
5197,7,4,2021-01-09,0,0,0,0,2021-01-09,1610146800.0
5198,7,4,2021-01-10,0,0,0,0,2021-01-10,1610233200.0
5199,7,4,2021-01-11,0,0,0,0,2021-01-11,1610319600.0
5200,7,4,2021-01-12,0,0,0,0,2021-01-12,1610406000.0
5201,7,4,2021-01-13,0,0,0,0,2021-01-13,1610492400.0
5202,7,4,2021-01-14,0,0,0,0,2021-01-14,1610578800.0
5203,7,4,2021-01-15,0,0,0,0,2021-01-15,1610665200.0
5204,7,4,2021-01-16,0,0,0,0,2021-01-16,1610751600.0
5205,7,4,2021-01-17,0,0,0,0,2021-01-17,1610838000.0
5206,7,4,2021-01-18,0,0,0,0,2021-01-18,1610924400.0
5207,7,4,2021-01-19,0,0,0,0,2021-01-19,1611010800.0
5208,7,4,2021-01-20,0,0,0,0,2021-01-20,1611097200.0
5209,7,4,2021-01-21,0,0,0,0,2021-01-21,1611183600.0
5210,7,4,2021-01-22,0,0,0,0,2021-01-22,1611270000.0
5211,7,4,2021-01-23,0,0,0,0,2021-01-23,1611356400.0
5212,7,4,2021-01-24,0,0,0,0,2021-01-24,1611442800.0
5213,7,4,2021-01-25,0,0,0,0,2021-01-25,1611529200.0
5214,7,4,2021-01-26,0,0,0,0,2021-01-26,1611615600.0
5215,7,4,2021-01-27,0,0,0,0,2021-01-27,1611702000.0
5216,7,4,2021-01-28,0,0,0,0,2021-01-28,1611788400.0
5217,7,4,2021-01-29,0,0,0,0,2021-01-29,1611874800.0
5218,7,4,2021-01-30,0,0,0,0,2021-01-30,1611961200.0
5219,7,4,2021-01-31,0,0,0,0,2021-01-31,1612047600.0
5220,7,4,2021-02-01,0,0,0,0,2021-02-01,1612134000.0
5221,7,4,2021-02-02,0,0,0,0,2021-02-02,1612220400.0
5222,7,4,2021-02-03,0,0,0,0,2021-02-03,1612306800.0
5223,7,4,2021-02-04,0,0,0,0,2021-02-04,1612393200.0
5224,7,4,2021-02-05,0,0,0,0,2021-02-05,1612479600.0
5225,7,4,2021-02-06,0,0,0,0,2021-02-06,1612566000.0
5226,7,4,2021-02-07,0,0,0,0,2021-02-07,1612652400.0
5227,7,4,2021-02-08,0,0,0,0,2021-02-08,1612738800.0
5228,7,4,2021-02-09,0,0,0,0,2021-02-09,1612825200.0
5229,7,4,2021-02-10,0,0,0,0,2021-02-10,1612911600.0
5230,7,4,2021-02-11,0,0,0,0,2021-02-11,1612998000.0
5231,7,4,2021-02-12,0,0,0,0,2021-02-12,1613084400.0
5232,7,4,2021-02-13,0,0,0,0,2021-02-13,1613170800.0
5233,7,4,2021-02-14,0,0,0,0,2021-02-14,1613257200.0
5234,7,4,2021-02-15,0,0,0,0,2021-02-15,1613343600.0
5235,7,4,2021-02-16,0,0,0,0,2021-02-16,1613430000.0
5236,7,4,2021-02-17,0,0,0,0,2021-02-17,1613516400.0
5237,7,4,2021-02-18,0,0,0,0,2021-02-18,1613602800.0
5238,7,4,2021-02-19,0,0,0,0,2021-02-19,1613689200.0
5239,7,4,2021-02-20,0,0,0,0,2021-02-20,1613775600.0
5240,7,4,2021-02-21,0,0,0,0,2021-02-21,1613862000.0
5241,7,4,2021-02-22,0,0,0,0,2021-02-22,1613948400.0
5242,7,4,2021-02-23,0,0,0,0,2021-02-23,1614034800.0
5243,7,4,2021-02-24,0,0,0,0,2021-02-24,1614121200.0
5244,7,4,2021-02-25,0,0,0,0,2021-02-25,1614207600.0
5245,7,4,2021-02-26,0,0,0,0,2021-02-26,1614294000.0
5246,7,4,2021-02-27,0,0,0,0,2021-02-27,1614380400.0
5247,7,4,2021-02-28,0,0,0,0,2021-02-28,1614466800.0
5248,7,4,2021-03-01,0,0,0,0,2021-03-01,1614553200.0
5249,7,4,2021-03-02,0,0,0,0,2021-03-02,1614639600.0
5250,7,4,2021-03-03,0,0,0,0,2021-03-03,1614726000.0
5251,7,4,2021-03-04,0,0,0,0,2021-03-04,1614812400.0
5252,7,4,2021-03-05,0,0,0,0,2021-03-05,1614898800.0
5253,7,4,2021-03-06,0,0,0,0,2021-03-06,1614985200.0
5254,7,4,2021-03-07,0,0,0,0,2021-03-07,1615071600.0
5255,7,4,2021-03-08,0,0,0,0,2021-03-08,1615158000.0
5256,7,4,2021-03-09,0,0,0,0,2021-03-09,1615244400.0
5257,7,4,2021-03-10,0,0,0,0,2021-03-10,1615330800.0
5258,7,4,2021-03-11,0,0,0,0,2021-03-11,1615417200.0
5259,7,4,2021-03-12,0,0,0,0,2021-03-12,1615503600.0
5260,7,4,2021-03-13,0,0,0,0,2021-03-13,1615590000.0
5261,7,4,2021-03-14,0,0,0,0,2021-03-14,1615676400.0
5262,7,4,2021-03-15,0,0,0,0,2021-03-15,1615762800.0
5263,7,4,2021-03-16,0,0,0,0,2021-03-16,1615849200.0
5264,7,4,2021-03-17,0,0,0,0,2021-03-17,1615935600.0
5265,7,4,2021-03-18,0,0,0,0,2021-03-18,1616022000.0
5266,7,4,2021-03-19,0,0,0,0,2021-03-19,1616108400.0
5267,7,4,2021-03-20,0,0,0,0,2021-03-20,1616194800.0
5268,7,4,2021-03-21,0,0,0,0,2021-03-21,1616281200.0
5269,7,4,2021-03-22,0,0,0,0,2021-03-22,1616367600.0
5270,7,4,2021-03-23,0,0,0,0,2021-03-23,1616454000.0
5271,7,4,2021-03-24,0,0,0,0,2021-03-24,1616540400.0
5272,7,4,2021-03-25,0,0,0,0,2021-03-25,1616626800.0
5273,7,4,2021-03-26,0,0,0,0,2021-03-26,1616713200.0
5274,7,4,2021-03-27,0,0,0,0,2021-03-27,1616799600.0
5275,7,4,2021-03-28,0,0,0,0,2021-03-28,1616886000.0
5276,7,4,2021-03-29,0,0,0,0,2021-03-29,1616972400.0
5277,7,4,2021-03-30,0,0,0,0,2021-03-30,1617058800.0
5278,7,4,2021-03-31,0,0,0,0,2021-03-31,1617145200.0
5279,7,4,2021-04-01,0,0,0,0,2021-04-01,1617231600.0
5280,7,4,2021-04-02,0,0,0,0,2021-04-02,1617318000.0
5281,7,4,2021-04-03,0,0,0,0,2021-04-03,1617404400.0
5282,7,4,2021-04-04,0,0,0,0,2021-04-04,1617490800.0
5283,7,4,2021-04-05,0,0,0,0,2021-04-05,1617577200.0
5284,7,4,2021-04-06,0,0,0,0,2021-04-06,1617663600.0
5285,7,4,2021-04-07,0,0,0,0,2021-04-07,1617750000.0
5286,7,4,2021-04-08,0,0,0,0,2021-04-08,1617836400.0
5287,7,4,2021-04-09,0,0,0,0,2021-04-09,1617922800.0
5288,7,4,2021-04-10,0,0,0,0,2021-04-10,1618009200.0
5289,7,4,2021-04-11,0,0,0,0,2021-04-11,1618095600.0
5290,7,4,2021-04-12,0,0,0,0,2021-04-12,1618185600.0
5291,7,4,2021-04-13,0,0,0,0,2021-04-13,1618272000.0
5292,7,4,2021-04-14,0,0,0,0,2021-04-14,1618358400.0
5293,7,4,2021-04-15,0,0,0,0,2021-04-15,1618444800.0
5294,7,4,2021-04-16,0,0,0,0,2021-04-16,1618531200.0
5295,7,4,2021-04-17,0,0,0,0,2021-04-17,1618617600.0
5296,7,4,2021-04-18,0,0,0,0,2021-04-18,1618704000.0
5297,7,4,2021-04-19,0,0,0,0,2021-04-19,1618790400.0
5298,7,4,2021-04-20,0,0,0,0,2021-04-20,1618876800.0
5299,7,4,2021-04-21,0,0,0,0,2021-04-21,1618963200.0
5300,7,4,2021-04-22,0,0,0,0,2021-04-22,1619049600.0
5301,7,4,2021-04-23,0,0,0,0,2021-04-23,1619136000.0
5302,7,4,2021-04-24,0,0,0,0,2021-04-24,1619222400.0
5303,7,4,2021-04-25,0,0,0,0,2021-04-25,1619308800.0
5304,7,4,2021-04-26,0,0,0,0,2021-04-26,1619395200.0
5305,7,4,2021-04-27,0,0,0,0,2021-04-27,1619481600.0
5306,7,4,2021-04-28,0,0,0,0,2021-04-28,1619568000.0
5307,7,4,2021-04-29,0,0,0,0,2021-04-29,1619654400.0
5308,7,4,2021-04-30,0,0,0,0,2021-04-30,1619740800.0
5309,7,4,2021-05-01,0,0,0,0,2021-05-01,1619827200.0
5310,7,4,2021-05-02,0,0,0,0,2021-05-02,1619913600.0
5311,7,4,2021-05-03,0,0,0,0,2021-05-03,1620000000.0
5312,7,4,2021-05-04,0,0,0,0,2021-05-04,1620086400.0
5313,7,4,2021-05-05,0,0,0,0,2021-05-05,1620172800.0
5314,7,4,2021-05-06,0,0,0,0,2021-05-06,1620259200.0
5315,7,4,2021-05-07,0,0,0,0,2021-05-07,1620345600.0
5316,7,4,2021-05-08,0,0,0,0,2021-05-08,1620432000.0
5317,7,4,2021-05-09,0,0,0,0,2021-05-09,1620518400.0
5318,7,4,2021-05-10,0,0,0,0,2021-05-10,1620604800.0
5319,7,4,2021-05-11,0,0,0,0,2021-05-11,1620691200.0
5320,7,4,2021-05-12,0,0,0,0,2021-05-12,1620777600.0
5321,7,4,2021-05-13,0,0,0,0,2021-05-13,1620864000.0
5322,7,4,2021-05-14,0,0,0,0,2021-05-14,1620950400.0
5323,7,4,2021-05-15,0,0,0,0,2021-05-15,1621036800.0
5324,7,4,2021-05-16,0,0,0,0,2021-05-16,1621123200.0
5325,7,4,2021-05-17,0,0,0,0,2021-05-17,1621206000.0
5326,7,4,2021-05-18,0,0,0,0,2021-05-18,1621292400.0
5327,7,4,2021-05-19,0,0,0,0,2021-05-19,1621378800.0
5328,7,4,2021-05-20,0,0,0,0,2021-05-20,1621465200.0
5329,7,4,2021-05-21,0,0,0,0,2021-05-21,1621551600.0
5330,7,4,2021-05-22,0,0,0,0,2021-05-22,1621638000.0
5331,7,4,2021-05-23,0,0,0,0,2021-05-23,1621724400.0
5332,7,4,2021-05-24,0,0,0,0,2021-05-24,1621810800.0
5333,7,4,2021-05-25,0,0,0,0,2021-05-25,1621897200.0
5334,7,4,2021-05-26,0,0,0,0,2021-05-26,1621983600.0
5335,7,4,2021-05-27,0,0,0,0,2021-05-27,1622070000.0
5336,7,4,2021-05-28,0,0,0,0,2021-05-28,1622156400.0
5337,7,4,2021-05-29,0,0,0,0,2021-05-29,1622242800.0
5338,7,4,2021-05-30,0,0,0,0,2021-05-30,1622329200.0
5339,7,4,2021-05-31,0,0,0,0,2021-05-31,1622415600.0
5340,7,4,2021-06-01,0,0,0,0,2021-06-01,1622502000.0
5341,7,4,2021-06-02,0,0,0,0,2021-06-02,1622588400.0
5342,7,4,2021-06-03,0,0,0,0,2021-06-03,1622674800.0
5343,7,4,2021-06-04,0,0,0,0,2021-06-04,1622761200.0
5344,7,4,2021-06-05,0,0,0,0,2021-06-05,1622847600.0
5345,7,4,2021-06-06,0,0,0,0,2021-06-06,1622934000.0
5346,7,4,2021-06-07,0,0,0,0,2021-06-07,1623020400.0
5347,7,4,2021-06-08,0,0,0,0,2021-06-08,1623106800.0
5348,7,4,2021-06-09,0,0,0,0,2021-06-09,1623193200.0
5349,7,4,2021-06-10,0,0,0,0,2021-06-10,1623279600.0
5350,7,4,2021-06-11,0,0,0,0,2021-06-11,1623366000.0
5351,7,4,2021-06-12,0,0,0,0,2021-06-12,1623452400.0
5352,7,4,2021-06-13,0,0,0,0,2021-06-13,1623538800.0
5353,7,4,2021-06-14,0,0,0,0,2021-06-14,1623625200.0
5354,7,4,2021-06-15,0,0,0,0,2021-06-15,1623711600.0
5355,7,4,2021-06-16,0,0,0,0,2021-06-16,1623798000.0
5356,7,4,2021-06-17,0,0,0,0,2021-06-17,1623884400.0
5357,7,4,2021-06-18,0,0,0,0,2021-06-18,1623970800.0
5358,7,4,2021-06-19,0,0,0,0,2021-06-19,1624057200.0
5359,7,4,2021-06-20,0,0,0,0,2021-06-20,1624143600.0
5360,7,4,2021-06-21,0,0,0,0,2021-06-21,1624230000.0
5361,7,4,2021-06-22,0,0,0,0,2021-06-22,1624316400.0
5362,7,4,2021-06-23,0,0,0,0,2021-06-23,1624402800.0
5363,7,4,2021-06-24,0,0,0,0,2021-06-24,1624489200.0
5364,7,4,2021-06-25,0,0,0,0,2021-06-25,1624575600.0
5365,7,4,2021-06-26,0,0,0,0,2021-06-26,1624662000.0
5366,7,4,2021-06-27,0,0,0,0,2021-06-27,1624748400.0
5367,7,4,2021-06-28,0,0,0,0,2021-06-28,1624834800.0
5368,7,4,2021-06-29,0,0,0,0,2021-06-29,1624921200.0
5369,7,4,2021-06-30,0,0,0,0,2021-06-30,1625007600.0
5370,7,4,2021-07-01,0,0,0,0,2021-07-01,1625094000.0
5371,7,4,2021-07-02,0,0,0,0,2021-07-02,1625180400.0
5372,7,4,2021-07-03,0,0,0,0,2021-07-03,1625266800.0
5373,7,4,2021-07-04,0,0,0,0,2021-07-04,1625353200.0
5374,7,4,2021-07-05,0,0,0,0,2021-07-05,1625439600.0
5375,7,4,2021-07-06,0,0,0,0,2021-07-06,1625526000.0
5376,8,1,2020-12-27,0,0,0,0,2020-12-27,1609023600.0
5377,8,1,2020-12-28,0,0,0,0,2020-12-28,1609110000.0
5378,8,1,2020-12-29,0,0,0,0,2020-12-29,1609196400.0
5379,8,1,2020-12-30,0,0,0,0,2020-12-30,1609282800.0
5380,8,1,2020-12-31,0,0,0,0,2020-12-31,1609369200.0
5381,8,1,2021-01-01,0,0,0,0,2021-01-01,1609455600.0
5382,8,1,2021-01-02,0,0,0,0,2021-01-02,1609542000.0
5383,8,1,2021-01-03,0,0,0,0,2021-01-03,1609628400.0
5384,8,1,2021-01-04,0,0,0,0,2021-01-04,1609714800.0
5385,8,1,2021-01-05,0,0,0,0,2021-01-05,1609801200.0
5386,8,1,2021-01-06,0,0,0,0,2021-01-06,1609887600.0
5387,8,1,2021-01-07,0,0,0,0,2021-01-07,1609974000.0
5388,8,1,2021-01-08,0,0,0,0,2021-01-08,1610060400.0
5389,8,1,2021-01-09,0,0,0,0,2021-01-09,1610146800.0
5390,8,1,2021-01-10,0,0,0,0,2021-01-10,1610233200.0
5391,8,1,2021-01-11,0,0,0,0,2021-01-11,1610319600.0
5392,8,1,2021-01-12,0,0,0,0,2021-01-12,1610406000.0
5393,8,1,2021-01-13,10,0,10,0,2021-01-13,1610492400.0
5394,8,1,2021-01-14,12,0,22,0,2021-01-14,1610578800.0
5395,8,1,2021-01-15,8,0,30,0,2021-01-15,1610665200.0
5396,8,1,2021-01-16,0,0,30,0,2021-01-16,1610751600.0
5397,8,1,2021-01-17,0,0,30,0,2021-01-17,1610838000.0
5398,8,1,2021-01-18,0,0,30,0,2021-01-18,1610924400.0
5399,8,1,2021-01-19,12,0,42,0,2021-01-19,1611010800.0
5400,8,1,2021-01-20,12,0,54,0,2021-01-20,1611097200.0
5401,8,1,2021-01-21,6,0,60,0,2021-01-21,1611183600.0
5402,8,1,2021-01-22,0,0,60,0,2021-01-22,1611270000.0
5403,8,1,2021-01-23,0,0,60,0,2021-01-23,1611356400.0
5404,8,1,2021-01-24,0,0,60,0,2021-01-24,1611442800.0
5405,8,1,2021-01-25,0,0,60,0,2021-01-25,1611529200.0
5406,8,1,2021-01-26,9,0,69,0,2021-01-26,1611615600.0
5407,8,1,2021-01-27,10,0,79,0,2021-01-27,1611702000.0
5408,8,1,2021-01-28,6,0,85,0,2021-01-28,1611788400.0
5409,8,1,2021-01-29,0,0,85,0,2021-01-29,1611874800.0
5410,8,1,2021-01-30,0,0,85,0,2021-01-30,1611961200.0
5411,8,1,2021-01-31,0,0,85,0,2021-01-31,1612047600.0
5412,8,1,2021-02-01,0,0,85,0,2021-02-01,1612134000.0
5413,8,1,2021-02-02,38,0,123,0,2021-02-02,1612220400.0
5414,8,1,2021-02-03,10,0,133,0,2021-02-03,1612306800.0
5415,8,1,2021-02-04,29,1,162,1,2021-02-04,1612393200.0
5416,8,1,2021-02-05,6,0,168,1,2021-02-05,1612479600.0
5417,8,1,2021-02-06,0,0,168,1,2021-02-06,1612566000.0
5418,8,1,2021-02-07,0,0,168,1,2021-02-07,1612652400.0
5419,8,1,2021-02-08,0,0,168,1,2021-02-08,1612738800.0
5420,8,1,2021-02-09,38,0,206,1,2021-02-09,1612825200.0
5421,8,1,2021-02-10,27,0,233,1,2021-02-10,1612911600.0
5422,8,1,2021-02-11,0,0,233,1,2021-02-11,1612998000.0
5423,8,1,2021-02-12,36,0,269,1,2021-02-12,1613084400.0
5424,8,1,2021-02-13,0,0,269,1,2021-02-13,1613170800.0
5425,8,1,2021-02-14,0,0,269,1,2021-02-14,1613257200.0
5426,8,1,2021-02-15,50,0,319,1,2021-02-15,1613343600.0
5427,8,1,2021-02-16,0,0,319,1,2021-02-16,1613430000.0
5428,8,1,2021-02-17,0,0,319,1,2021-02-17,1613516400.0
5429,8,1,2021-02-18,27,0,346,1,2021-02-18,1613602800.0
5430,8,1,2021-02-19,44,0,390,1,2021-02-19,1613689200.0
5431,8,1,2021-02-20,0,0,390,1,2021-02-20,1613775600.0
5432,8,1,2021-02-21,0,0,390,1,2021-02-21,1613862000.0
5433,8,1,2021-02-22,45,2,435,3,2021-02-22,1613948400.0
5434,8,1,2021-02-23,41,29,476,32,2021-02-23,1614034800.0
5435,8,1,2021-02-24,35,1,511,33,2021-02-24,1614121200.0
5436,8,1,2021-02-25,55,35,566,68,2021-02-25,1614207600.0
5437,8,1,2021-02-26,39,2,605,70,2021-02-26,1614294000.0
5438,8,1,2021-02-27,0,0,605,70,2021-02-27,1614380400.0
5439,8,1,2021-02-28,0,0,605,70,2021-02-28,1614466800.0
5440,8,1,2021-03-01,48,5,653,75,2021-03-01,1614553200.0
5441,8,1,2021-03-02,6,27,659,102,2021-03-02,1614639600.0
5442,8,1,2021-03-03,38,27,697,129,2021-03-03,1614726000.0
5443,8,1,2021-03-04,30,26,727,155,2021-03-04,1614812400.0
5444,8,1,2021-03-05,46,9,773,164,2021-03-05,1614898800.0
5445,8,1,2021-03-06,0,0,773,164,2021-03-06,1614985200.0
5446,8,1,2021-03-07,0,0,773,164,2021-03-07,1615071600.0
5447,8,1,2021-03-08,30,7,803,171,2021-03-08,1615158000.0
5448,8,1,2021-03-09,19,27,822,198,2021-03-09,1615244400.0
5449,8,1,2021-03-10,22,27,844,225,2021-03-10,1615330800.0
5450,8,1,2021-03-11,0,0,844,225,2021-03-11,1615417200.0
5451,8,1,2021-03-12,51,21,895,246,2021-03-12,1615503600.0
5452,8,1,2021-03-13,0,0,895,246,2021-03-13,1615590000.0
5453,8,1,2021-03-14,0,0,895,246,2021-03-14,1615676400.0
5454,8,1,2021-03-15,31,42,926,288,2021-03-15,1615762800.0
5455,8,1,2021-03-16,73,3,999,291,2021-03-16,1615849200.0
5456,8,1,2021-03-17,67,13,1066,304,2021-03-17,1615935600.0
5457,8,1,2021-03-18,82,39,1148,343,2021-03-18,1616022000.0
5458,8,1,2021-03-19,30,46,1178,389,2021-03-19,1616108400.0
5459,8,1,2021-03-20,0,0,1178,389,2021-03-20,1616194800.0
5460,8,1,2021-03-21,0,0,1178,389,2021-03-21,1616281200.0
5461,8,1,2021-03-22,33,45,1211,434,2021-03-22,1616367600.0
5462,8,1,2021-03-23,30,43,1241,477,2021-03-23,1616454000.0
5463,8,1,2021-03-24,38,42,1279,519,2021-03-24,1616540400.0
5464,8,1,2021-03-25,66,31,1345,550,2021-03-25,1616626800.0
5465,8,1,2021-03-26,44,32,1389,582,2021-03-26,1616713200.0
5466,8,1,2021-03-27,0,0,1389,582,2021-03-27,1616799600.0
5467,8,1,2021-03-28,0,0,1389,582,2021-03-28,1616886000.0
5468,8,1,2021-03-29,61,47,1450,629,2021-03-29,1616972400.0
5469,8,1,2021-03-30,93,19,1543,648,2021-03-30,1617058800.0
5470,8,1,2021-03-31,73,44,1616,692,2021-03-31,1617145200.0
5471,8,1,2021-04-01,56,45,1672,737,2021-04-01,1617231600.0
5472,8,1,2021-04-02,0,0,1672,737,2021-04-02,1617318000.0
5473,8,1,2021-04-03,0,0,1672,737,2021-04-03,1617404400.0
5474,8,1,2021-04-04,0,0,1672,737,2021-04-04,1617490800.0
5475,8,1,2021-04-05,0,0,1672,737,2021-04-05,1617577200.0
5476,8,1,2021-04-06,49,61,1721,798,2021-04-06,1617663600.0
5477,8,1,2021-04-07,91,28,1812,826,2021-04-07,1617750000.0
5478,8,1,2021-04-08,119,3,1931,829,2021-04-08,1617836400.0
5479,8,1,2021-04-09,89,27,2020,856,2021-04-09,1617922800.0
5480,8,1,2021-04-10,0,0,2020,856,2021-04-10,1618009200.0
5481,8,1,2021-04-11,0,0,2020,856,2021-04-11,1618095600.0
5482,8,1,2021-04-12,41,72,2061,928,2021-04-12,1618185600.0
5483,8,1,2021-04-13,46,71,2107,999,2021-04-13,1618272000.0
5484,8,1,2021-04-14,73,43,2180,1042,2021-04-14,1618358400.0
5485,8,1,2021-04-15,89,20,2269,1062,2021-04-15,1618444800.0
5486,8,1,2021-04-16,75,38,2344,1100,2021-04-16,1618531200.0
5487,8,1,2021-04-17,0,0,2344,1100,2021-04-17,1618617600.0
5488,8,1,2021-04-18,0,0,2344,1100,2021-04-18,1618704000.0
5489,8,1,2021-04-19,48,64,2392,1164,2021-04-19,1618790400.0
5490,8,1,2021-04-20,81,27,2473,1191,2021-04-20,1618876800.0
5491,8,1,2021-04-21,91,24,2564,1215,2021-04-21,1618963200.0
5492,8,1,2021-04-22,100,18,2664,1233,2021-04-22,1619049600.0
5493,8,1,2021-04-23,44,65,2708,1298,2021-04-23,1619136000.0
5494,8,1,2021-04-24,0,0,2708,1298,2021-04-24,1619222400.0
5495,8,1,2021-04-25,0,0,2708,1298,2021-04-25,1619308800.0
5496,8,1,2021-04-26,27,88,2735,1386,2021-04-26,1619395200.0
5497,8,1,2021-04-27,59,61,2794,1447,2021-04-27,1619481600.0
5498,8,1,2021-04-28,88,34,2882,1481,2021-04-28,1619568000.0
5499,8,1,2021-04-29,89,30,2971,1511,2021-04-29,1619654400.0
5500,8,1,2021-04-30,104,9,3075,1520,2021-04-30,1619740800.0
5501,8,1,2021-05-01,0,0,3075,1520,2021-05-01,1619827200.0
5502,8,1,2021-05-02,0,0,3075,1520,2021-05-02,1619913600.0
5503,8,1,2021-05-03,24,92,3099,1612,2021-05-03,1620000000.0
5504,8,1,2021-05-04,157,93,3256,1705,2021-05-04,1620086400.0
5505,8,1,2021-05-05,140,49,3396,1754,2021-05-05,1620172800.0
5506,8,1,2021-05-06,199,30,3595,1784,2021-05-06,1620259200.0
5507,8,1,2021-05-07,127,64,3722,1848,2021-05-07,1620345600.0
5508,8,1,2021-05-08,58,0,3780,1848,2021-05-08,1620432000.0
5509,8,1,2021-05-09,0,0,3780,1848,2021-05-09,1620518400.0
5510,8,1,2021-05-10,124,92,3904,1940,2021-05-10,1620604800.0
5511,8,1,2021-05-11,132,73,4036,2013,2021-05-11,1620691200.0
5512,8,1,2021-05-12,156,56,4192,2069,2021-05-12,1620777600.0
5513,8,1,2021-05-13,83,0,4275,2069,2021-05-13,1620864000.0
5514,8,1,2021-05-14,129,49,4404,2118,2021-05-14,1620950400.0
5515,8,1,2021-05-15,86,2,4490,2120,2021-05-15,1621036800.0
5516,8,1,2021-05-16,0,0,4490,2120,2021-05-16,1621123200.0
5517,8,1,2021-05-17,146,100,4636,2220,2021-05-17,1621206000.0
5518,8,1,2021-05-18,151,83,4787,2303,2021-05-18,1621292400.0
5519,8,1,2021-05-19,84,52,4871,2355,2021-05-19,1621378800.0
5520,8,1,2021-05-20,104,19,4975,2374,2021-05-20,1621465200.0
5521,8,1,2021-05-21,95,36,5070,2410,2021-05-21,1621551600.0
5522,8,1,2021-05-22,100,0,5170,2410,2021-05-22,1621638000.0
5523,8,1,2021-05-23,0,0,5170,2410,2021-05-23,1621724400.0
5524,8,1,2021-05-24,33,0,5203,2410,2021-05-24,1621810800.0
5525,8,1,2021-05-25,119,66,5322,2476,2021-05-25,1621897200.0
5526,8,1,2021-05-26,108,33,5430,2509,2021-05-26,1621983600.0
5527,8,1,2021-05-27,111,25,5541,2534,2021-05-27,1622070000.0
5528,8,1,2021-05-28,33,1,5574,2535,2021-05-28,1622156400.0
5529,8,1,2021-05-29,58,5,5632,2540,2021-05-29,1622242800.0
5530,8,1,2021-05-30,0,0,5632,2540,2021-05-30,1622329200.0
5531,8,1,2021-05-31,109,55,5741,2595,2021-05-31,1622415600.0
5532,8,1,2021-06-01,112,50,5853,2645,2021-06-01,1622502000.0
5533,8,1,2021-06-02,131,24,5984,2669,2021-06-02,1622588400.0
5534,8,1,2021-06-03,100,28,6084,2697,2021-06-03,1622674800.0
5535,8,1,2021-06-04,127,59,6211,2756,2021-06-04,1622761200.0
5536,8,1,2021-06-05,82,10,6293,2766,2021-06-05,1622847600.0
5537,8,1,2021-06-06,0,0,6293,2766,2021-06-06,1622934000.0
5538,8,1,2021-06-07,96,86,6389,2852,2021-06-07,1623020400.0
5539,8,1,2021-06-08,70,80,6459,2932,2021-06-08,1623106800.0
5540,8,1,2021-06-09,97,65,6556,2997,2021-06-09,1623193200.0
5541,8,1,2021-06-10,111,43,6667,3040,2021-06-10,1623279600.0
5542,8,1,2021-06-11,110,84,6777,3124,2021-06-11,1623366000.0
5543,8,1,2021-06-12,57,23,6834,3147,2021-06-12,1623452400.0
5544,8,1,2021-06-13,0,0,6834,3147,2021-06-13,1623538800.0
5545,8,1,2021-06-14,106,107,6940,3254,2021-06-14,1623625200.0
5546,8,1,2021-06-15,86,108,7026,3362,2021-06-15,1623711600.0
5547,8,1,2021-06-16,103,139,7129,3501,2021-06-16,1623798000.0
5548,8,1,2021-06-17,84,62,7213,3563,2021-06-17,1623884400.0
5549,8,1,2021-06-18,66,92,7279,3655,2021-06-18,1623970800.0
5550,8,1,2021-06-19,62,69,7341,3724,2021-06-19,1624057200.0
5551,8,1,2021-06-20,0,0,7341,3724,2021-06-20,1624143600.0
5552,8,1,2021-06-21,73,138,7414,3862,2021-06-21,1624230000.0
5553,8,1,2021-06-22,70,94,7484,3956,2021-06-22,1624316400.0
5554,8,1,2021-06-23,68,108,7552,4064,2021-06-23,1624402800.0
5555,8,1,2021-06-24,42,69,7594,4133,2021-06-24,1624489200.0
5556,8,1,2021-06-25,63,88,7657,4221,2021-06-25,1624575600.0
5557,8,1,2021-06-26,35,58,7692,4279,2021-06-26,1624662000.0
5558,8,1,2021-06-27,0,0,7692,4279,2021-06-27,1624748400.0
5559,8,1,2021-06-28,70,125,7762,4404,2021-06-28,1624834800.0
5560,8,1,2021-06-29,55,91,7817,4495,2021-06-29,1624921200.0
5561,8,1,2021-06-30,56,105,7873,4600,2021-06-30,1625007600.0
5562,8,1,2021-07-01,41,80,7914,4680,2021-07-01,1625094000.0
5563,8,1,2021-07-02,52,89,7966,4769,2021-07-02,1625180400.0
5564,8,1,2021-07-03,40,86,8006,4855,2021-07-03,1625266800.0
5565,8,1,2021-07-04,0,0,8006,4855,2021-07-04,1625353200.0
5566,8,1,2021-07-05,66,90,8072,4945,2021-07-05,1625439600.0
5567,8,1,2021-07-06,55,71,8127,5016,2021-07-06,1625526000.0
5568,8,2,2020-12-27,0,0,0,0,2020-12-27,1609023600.0
5569,8,2,2020-12-28,0,0,0,0,2020-12-28,1609110000.0
5570,8,2,2020-12-29,0,0,0,0,2020-12-29,1609196400.0
5571,8,2,2020-12-30,0,0,0,0,2020-12-30,1609282800.0
5572,8,2,2020-12-31,0,0,0,0,2020-12-31,1609369200.0
5573,8,2,2021-01-01,0,0,0,0,2021-01-01,1609455600.0
5574,8,2,2021-01-02,0,0,0,0,2021-01-02,1609542000.0
5575,8,2,2021-01-03,0,0,0,0,2021-01-03,1609628400.0
5576,8,2,2021-01-04,0,0,0,0,2021-01-04,1609714800.0
5577,8,2,2021-01-05,0,0,0,0,2021-01-05,1609801200.0
5578,8,2,2021-01-06,0,0,0,0,2021-01-06,1609887600.0
5579,8,2,2021-01-07,0,0,0,0,2021-01-07,1609974000.0
5580,8,2,2021-01-08,0,0,0,0,2021-01-08,1610060400.0
5581,8,2,2021-01-09,0,0,0,0,2021-01-09,1610146800.0
5582,8,2,2021-01-10,0,0,0,0,2021-01-10,1610233200.0
5583,8,2,2021-01-11,0,0,0,0,2021-01-11,1610319600.0
5584,8,2,2021-01-12,0,0,0,0,2021-01-12,1610406000.0
5585,8,2,2021-01-13,0,0,0,0,2021-01-13,1610492400.0
5586,8,2,2021-01-14,0,0,0,0,2021-01-14,1610578800.0
5587,8,2,2021-01-15,0,0,0,0,2021-01-15,1610665200.0
5588,8,2,2021-01-16,0,0,0,0,2021-01-16,1610751600.0
5589,8,2,2021-01-17,0,0,0,0,2021-01-17,1610838000.0
5590,8,2,2021-01-18,0,0,0,0,2021-01-18,1610924400.0
5591,8,2,2021-01-19,0,0,0,0,2021-01-19,1611010800.0
5592,8,2,2021-01-20,0,0,0,0,2021-01-20,1611097200.0
5593,8,2,2021-01-21,0,0,0,0,2021-01-21,1611183600.0
5594,8,2,2021-01-22,0,0,0,0,2021-01-22,1611270000.0
5595,8,2,2021-01-23,0,0,0,0,2021-01-23,1611356400.0
5596,8,2,2021-01-24,0,0,0,0,2021-01-24,1611442800.0
5597,8,2,2021-01-25,0,0,0,0,2021-01-25,1611529200.0
5598,8,2,2021-01-26,0,0,0,0,2021-01-26,1611615600.0
5599,8,2,2021-01-27,0,0,0,0,2021-01-27,1611702000.0
5600,8,2,2021-01-28,0,0,0,0,2021-01-28,1611788400.0
5601,8,2,2021-01-29,0,0,0,0,2021-01-29,1611874800.0
5602,8,2,2021-01-30,0,0,0,0,2021-01-30,1611961200.0
5603,8,2,2021-01-31,0,0,0,0,2021-01-31,1612047600.0
5604,8,2,2021-02-01,0,0,0,0,2021-02-01,1612134000.0
5605,8,2,2021-02-02,0,0,0,0,2021-02-02,1612220400.0
5606,8,2,2021-02-03,0,0,0,0,2021-02-03,1612306800.0
5607,8,2,2021-02-04,0,0,0,0,2021-02-04,1612393200.0
5608,8,2,2021-02-05,0,0,0,0,2021-02-05,1612479600.0
5609,8,2,2021-02-06,0,0,0,0,2021-02-06,1612566000.0
5610,8,2,2021-02-07,0,0,0,0,2021-02-07,1612652400.0
5611,8,2,2021-02-08,0,0,0,0,2021-02-08,1612738800.0
5612,8,2,2021-02-09,0,0,0,0,2021-02-09,1612825200.0
5613,8,2,2021-02-10,0,0,0,0,2021-02-10,1612911600.0
5614,8,2,2021-02-11,0,0,0,0,2021-02-11,1612998000.0
5615,8,2,2021-02-12,0,0,0,0,2021-02-12,1613084400.0
5616,8,2,2021-02-13,0,0,0,0,2021-02-13,1613170800.0
5617,8,2,2021-02-14,0,0,0,0,2021-02-14,1613257200.0
5618,8,2,2021-02-15,0,0,0,0,2021-02-15,1613343600.0
5619,8,2,2021-02-16,0,0,0,0,2021-02-16,1613430000.0
5620,8,2,2021-02-17,0,0,0,0,2021-02-17,1613516400.0
5621,8,2,2021-02-18,0,0,0,0,2021-02-18,1613602800.0
5622,8,2,2021-02-19,0,0,0,0,2021-02-19,1613689200.0
5623,8,2,2021-02-20,0,0,0,0,2021-02-20,1613775600.0
5624,8,2,2021-02-21,0,0,0,0,2021-02-21,1613862000.0
5625,8,2,2021-02-22,0,0,0,0,2021-02-22,1613948400.0
5626,8,2,2021-02-23,0,0,0,0,2021-02-23,1614034800.0
5627,8,2,2021-02-24,0,0,0,0,2021-02-24,1614121200.0
5628,8,2,2021-02-25,0,0,0,0,2021-02-25,1614207600.0
5629,8,2,2021-02-26,0,0,0,0,2021-02-26,1614294000.0
5630,8,2,2021-02-27,0,0,0,0,2021-02-27,1614380400.0
5631,8,2,2021-02-28,0,0,0,0,2021-02-28,1614466800.0
5632,8,2,2021-03-01,0,0,0,0,2021-03-01,1614553200.0
5633,8,2,2021-03-02,0,0,0,0,2021-03-02,1614639600.0
5634,8,2,2021-03-03,0,0,0,0,2021-03-03,1614726000.0
5635,8,2,2021-03-04,0,0,0,0,2021-03-04,1614812400.0
5636,8,2,2021-03-05,0,0,0,0,2021-03-05,1614898800.0
5637,8,2,2021-03-06,0,0,0,0,2021-03-06,1614985200.0
5638,8,2,2021-03-07,0,0,0,0,2021-03-07,1615071600.0
5639,8,2,2021-03-08,0,0,0,0,2021-03-08,1615158000.0
5640,8,2,2021-03-09,0,0,0,0,2021-03-09,1615244400.0
5641,8,2,2021-03-10,0,0,0,0,2021-03-10,1615330800.0
5642,8,2,2021-03-11,0,0,0,0,2021-03-11,1615417200.0
5643,8,2,2021-03-12,0,0,0,0,2021-03-12,1615503600.0
5644,8,2,2021-03-13,0,0,0,0,2021-03-13,1615590000.0
5645,8,2,2021-03-14,0,0,0,0,2021-03-14,1615676400.0
5646,8,2,2021-03-15,0,0,0,0,2021-03-15,1615762800.0
5647,8,2,2021-03-16,0,0,0,0,2021-03-16,1615849200.0
5648,8,2,2021-03-17,0,0,0,0,2021-03-17,1615935600.0
5649,8,2,2021-03-18,0,0,0,0,2021-03-18,1616022000.0
5650,8,2,2021-03-19,0,0,0,0,2021-03-19,1616108400.0
5651,8,2,2021-03-20,0,0,0,0,2021-03-20,1616194800.0
5652,8,2,2021-03-21,0,0,0,0,2021-03-21,1616281200.0
5653,8,2,2021-03-22,1,0,1,0,2021-03-22,1616367600.0
5654,8,2,2021-03-23,0,0,1,0,2021-03-23,1616454000.0
5655,8,2,2021-03-24,0,0,1,0,2021-03-24,1616540400.0
5656,8,2,2021-03-25,0,0,1,0,2021-03-25,1616626800.0
5657,8,2,2021-03-26,0,0,1,0,2021-03-26,1616713200.0
5658,8,2,2021-03-27,87,0,88,0,2021-03-27,1616799600.0
5659,8,2,2021-03-28,0,0,88,0,2021-03-28,1616886000.0
5660,8,2,2021-03-29,0,0,88,0,2021-03-29,1616972400.0
5661,8,2,2021-03-30,0,0,88,0,2021-03-30,1617058800.0
5662,8,2,2021-03-31,0,0,88,0,2021-03-31,1617145200.0
5663,8,2,2021-04-01,0,0,88,0,2021-04-01,1617231600.0
5664,8,2,2021-04-02,0,0,88,0,2021-04-02,1617318000.0
5665,8,2,2021-04-03,0,0,88,0,2021-04-03,1617404400.0
5666,8,2,2021-04-04,0,0,88,0,2021-04-04,1617490800.0
5667,8,2,2021-04-05,0,0,88,0,2021-04-05,1617577200.0
5668,8,2,2021-04-06,0,0,88,0,2021-04-06,1617663600.0
5669,8,2,2021-04-07,0,0,88,0,2021-04-07,1617750000.0
5670,8,2,2021-04-08,1,0,89,0,2021-04-08,1617836400.0
5671,8,2,2021-04-09,0,0,89,0,2021-04-09,1617922800.0
5672,8,2,2021-04-10,164,1,253,1,2021-04-10,1618009200.0
5673,8,2,2021-04-11,0,0,253,1,2021-04-11,1618095600.0
5674,8,2,2021-04-12,0,0,253,1,2021-04-12,1618185600.0
5675,8,2,2021-04-13,0,0,253,1,2021-04-13,1618272000.0
5676,8,2,2021-04-14,1,0,254,1,2021-04-14,1618358400.0
5677,8,2,2021-04-15,0,0,254,1,2021-04-15,1618444800.0
5678,8,2,2021-04-16,0,0,254,1,2021-04-16,1618531200.0
5679,8,2,2021-04-17,165,0,419,1,2021-04-17,1618617600.0
5680,8,2,2021-04-18,0,0,419,1,2021-04-18,1618704000.0
5681,8,2,2021-04-19,0,0,419,1,2021-04-19,1618790400.0
5682,8,2,2021-04-20,0,0,419,1,2021-04-20,1618876800.0
5683,8,2,2021-04-21,0,0,419,1,2021-04-21,1618963200.0
5684,8,2,2021-04-22,0,0,419,1,2021-04-22,1619049600.0
5685,8,2,2021-04-23,0,0,419,1,2021-04-23,1619136000.0
5686,8,2,2021-04-24,99,72,518,73,2021-04-24,1619222400.0
5687,8,2,2021-04-25,0,0,518,73,2021-04-25,1619308800.0
5688,8,2,2021-04-26,1,0,519,73,2021-04-26,1619395200.0
5689,8,2,2021-04-27,0,0,519,73,2021-04-27,1619481600.0
5690,8,2,2021-04-28,0,0,519,73,2021-04-28,1619568000.0
5691,8,2,2021-04-29,0,0,519,73,2021-04-29,1619654400.0
5692,8,2,2021-04-30,0,0,519,73,2021-04-30,1619740800.0
5693,8,2,2021-05-01,0,0,519,73,2021-05-01,1619827200.0
5694,8,2,2021-05-02,0,0,519,73,2021-05-02,1619913600.0
5695,8,2,2021-05-03,0,0,519,73,2021-05-03,1620000000.0
5696,8,2,2021-05-04,0,0,519,73,2021-05-04,1620086400.0
5697,8,2,2021-05-05,1,0,520,73,2021-05-05,1620172800.0
5698,8,2,2021-05-06,0,0,520,73,2021-05-06,1620259200.0
5699,8,2,2021-05-07,0,0,520,73,2021-05-07,1620345600.0
5700,8,2,2021-05-08,11,120,531,193,2021-05-08,1620432000.0
5701,8,2,2021-05-09,0,0,531,193,2021-05-09,1620518400.0
5702,8,2,2021-05-10,0,0,531,193,2021-05-10,1620604800.0
5703,8,2,2021-05-11,0,0,531,193,2021-05-11,1620691200.0
5704,8,2,2021-05-12,0,2,531,195,2021-05-12,1620777600.0
5705,8,2,2021-05-13,0,0,531,195,2021-05-13,1620864000.0
5706,8,2,2021-05-14,0,0,531,195,2021-05-14,1620950400.0
5707,8,2,2021-05-15,0,0,531,195,2021-05-15,1621036800.0
5708,8,2,2021-05-16,0,0,531,195,2021-05-16,1621123200.0
5709,8,2,2021-05-17,0,0,531,195,2021-05-17,1621206000.0
5710,8,2,2021-05-18,0,0,531,195,2021-05-18,1621292400.0
5711,8,2,2021-05-19,0,16,531,211,2021-05-19,1621378800.0
5712,8,2,2021-05-20,0,0,531,211,2021-05-20,1621465200.0
5713,8,2,2021-05-21,0,0,531,211,2021-05-21,1621551600.0
5714,8,2,2021-05-22,0,0,531,211,2021-05-22,1621638000.0
5715,8,2,2021-05-23,0,0,531,211,2021-05-23,1621724400.0
5716,8,2,2021-05-24,0,0,531,211,2021-05-24,1621810800.0
5717,8,2,2021-05-25,0,0,531,211,2021-05-25,1621897200.0
5718,8,2,2021-05-26,0,0,531,211,2021-05-26,1621983600.0
5719,8,2,2021-05-27,0,10,531,221,2021-05-27,1622070000.0
5720,8,2,2021-05-28,0,0,531,221,2021-05-28,1622156400.0
5721,8,2,2021-05-29,1,206,532,427,2021-05-29,1622242800.0
5722,8,2,2021-05-30,0,0,532,427,2021-05-30,1622329200.0
5723,8,2,2021-05-31,0,0,532,427,2021-05-31,1622415600.0
5724,8,2,2021-06-01,0,0,532,427,2021-06-01,1622502000.0
5725,8,2,2021-06-02,0,0,532,427,2021-06-02,1622588400.0
5726,8,2,2021-06-03,0,0,532,427,2021-06-03,1622674800.0
5727,8,2,2021-06-04,0,0,532,427,2021-06-04,1622761200.0
5728,8,2,2021-06-05,0,7,532,434,2021-06-05,1622847600.0
5729,8,2,2021-06-06,0,0,532,434,2021-06-06,1622934000.0
5730,8,2,2021-06-07,0,0,532,434,2021-06-07,1623020400.0
5731,8,2,2021-06-08,10,2,542,436,2021-06-08,1623106800.0
5732,8,2,2021-06-09,1,1,543,437,2021-06-09,1623193200.0
5733,8,2,2021-06-10,0,0,543,437,2021-06-10,1623279600.0
5734,8,2,2021-06-11,1,1,544,438,2021-06-11,1623366000.0
5735,8,2,2021-06-12,0,0,544,438,2021-06-12,1623452400.0
5736,8,2,2021-06-13,0,0,544,438,2021-06-13,1623538800.0
5737,8,2,2021-06-14,0,0,544,438,2021-06-14,1623625200.0
5738,8,2,2021-06-15,0,0,544,438,2021-06-15,1623711600.0
5739,8,2,2021-06-16,0,1,544,439,2021-06-16,1623798000.0
5740,8,2,2021-06-17,0,0,544,439,2021-06-17,1623884400.0
5741,8,2,2021-06-18,0,0,544,439,2021-06-18,1623970800.0
5742,8,2,2021-06-19,0,1,544,440,2021-06-19,1624057200.0
5743,8,2,2021-06-20,0,0,544,440,2021-06-20,1624143600.0
5744,8,2,2021-06-21,5,2,549,442,2021-06-21,1624230000.0
5745,8,2,2021-06-22,0,1,549,443,2021-06-22,1624316400.0
5746,8,2,2021-06-23,0,0,549,443,2021-06-23,1624402800.0
5747,8,2,2021-06-24,0,0,549,443,2021-06-24,1624489200.0
5748,8,2,2021-06-25,0,0,549,443,2021-06-25,1624575600.0
5749,8,2,2021-06-26,0,0,549,443,2021-06-26,1624662000.0
5750,8,2,2021-06-27,0,0,549,443,2021-06-27,1624748400.0
5751,8,2,2021-06-28,0,0,549,443,2021-06-28,1624834800.0
5752,8,2,2021-06-29,4,4,553,447,2021-06-29,1624921200.0
5753,8,2,2021-06-30,0,1,553,448,2021-06-30,1625007600.0
5754,8,2,2021-07-01,0,0,553,448,2021-07-01,1625094000.0
5755,8,2,2021-07-02,0,0,553,448,2021-07-02,1625180400.0
5756,8,2,2021-07-03,0,0,553,448,2021-07-03,1625266800.0
5757,8,2,2021-07-04,0,1,553,449,2021-07-04,1625353200.0
5758,8,2,2021-07-05,0,0,553,449,2021-07-05,1625439600.0
5759,8,2,2021-07-06,0,0,553,449,2021-07-06,1625526000.0
5760,8,3,2020-12-27,0,0,0,0,2020-12-27,1609023600.0
5761,8,3,2020-12-28,0,0,0,0,2020-12-28,1609110000.0
5762,8,3,2020-12-29,0,0,0,0,2020-12-29,1609196400.0
5763,8,3,2020-12-30,0,0,0,0,2020-12-30,1609282800.0
5764,8,3,2020-12-31,0,0,0,0,2020-12-31,1609369200.0
5765,8,3,2021-01-01,0,0,0,0,2021-01-01,1609455600.0
5766,8,3,2021-01-02,0,0,0,0,2021-01-02,1609542000.0
5767,8,3,2021-01-03,0,0,0,0,2021-01-03,1609628400.0
5768,8,3,2021-01-04,0,0,0,0,2021-01-04,1609714800.0
5769,8,3,2021-01-05,0,0,0,0,2021-01-05,1609801200.0
5770,8,3,2021-01-06,0,0,0,0,2021-01-06,1609887600.0
5771,8,3,2021-01-07,0,0,0,0,2021-01-07,1609974000.0
5772,8,3,2021-01-08,0,0,0,0,2021-01-08,1610060400.0
5773,8,3,2021-01-09,0,0,0,0,2021-01-09,1610146800.0
5774,8,3,2021-01-10,0,0,0,0,2021-01-10,1610233200.0
5775,8,3,2021-01-11,0,0,0,0,2021-01-11,1610319600.0
5776,8,3,2021-01-12,0,0,0,0,2021-01-12,1610406000.0
5777,8,3,2021-01-13,0,0,0,0,2021-01-13,1610492400.0
5778,8,3,2021-01-14,0,0,0,0,2021-01-14,1610578800.0
5779,8,3,2021-01-15,0,0,0,0,2021-01-15,1610665200.0
5780,8,3,2021-01-16,0,0,0,0,2021-01-16,1610751600.0
5781,8,3,2021-01-17,0,0,0,0,2021-01-17,1610838000.0
5782,8,3,2021-01-18,0,0,0,0,2021-01-18,1610924400.0
5783,8,3,2021-01-19,0,0,0,0,2021-01-19,1611010800.0
5784,8,3,2021-01-20,0,0,0,0,2021-01-20,1611097200.0
5785,8,3,2021-01-21,0,0,0,0,2021-01-21,1611183600.0
5786,8,3,2021-01-22,0,0,0,0,2021-01-22,1611270000.0
5787,8,3,2021-01-23,0,0,0,0,2021-01-23,1611356400.0
5788,8,3,2021-01-24,0,0,0,0,2021-01-24,1611442800.0
5789,8,3,2021-01-25,0,0,0,0,2021-01-25,1611529200.0
5790,8,3,2021-01-26,0,0,0,0,2021-01-26,1611615600.0
5791,8,3,2021-01-27,0,0,0,0,2021-01-27,1611702000.0
5792,8,3,2021-01-28,0,0,0,0,2021-01-28,1611788400.0
5793,8,3,2021-01-29,0,0,0,0,2021-01-29,1611874800.0
5794,8,3,2021-01-30,0,0,0,0,2021-01-30,1611961200.0
5795,8,3,2021-01-31,0,0,0,0,2021-01-31,1612047600.0
5796,8,3,2021-02-01,0,0,0,0,2021-02-01,1612134000.0
5797,8,3,2021-02-02,0,0,0,0,2021-02-02,1612220400.0
5798,8,3,2021-02-03,0,0,0,0,2021-02-03,1612306800.0
5799,8,3,2021-02-04,0,0,0,0,2021-02-04,1612393200.0
5800,8,3,2021-02-05,0,0,0,0,2021-02-05,1612479600.0
5801,8,3,2021-02-06,0,0,0,0,2021-02-06,1612566000.0
5802,8,3,2021-02-07,0,0,0,0,2021-02-07,1612652400.0
5803,8,3,2021-02-08,0,0,0,0,2021-02-08,1612738800.0
5804,8,3,2021-02-09,0,0,0,0,2021-02-09,1612825200.0
5805,8,3,2021-02-10,0,0,0,0,2021-02-10,1612911600.0
5806,8,3,2021-02-11,0,0,0,0,2021-02-11,1612998000.0
5807,8,3,2021-02-12,0,0,0,0,2021-02-12,1613084400.0
5808,8,3,2021-02-13,0,0,0,0,2021-02-13,1613170800.0
5809,8,3,2021-02-14,0,0,0,0,2021-02-14,1613257200.0
5810,8,3,2021-02-15,0,0,0,0,2021-02-15,1613343600.0
5811,8,3,2021-02-16,0,0,0,0,2021-02-16,1613430000.0
5812,8,3,2021-02-17,0,0,0,0,2021-02-17,1613516400.0
5813,8,3,2021-02-18,0,0,0,0,2021-02-18,1613602800.0
5814,8,3,2021-02-19,0,0,0,0,2021-02-19,1613689200.0
5815,8,3,2021-02-20,0,0,0,0,2021-02-20,1613775600.0
5816,8,3,2021-02-21,0,0,0,0,2021-02-21,1613862000.0
5817,8,3,2021-02-22,0,0,0,0,2021-02-22,1613948400.0
5818,8,3,2021-02-23,0,0,0,0,2021-02-23,1614034800.0
5819,8,3,2021-02-24,0,0,0,0,2021-02-24,1614121200.0
5820,8,3,2021-02-25,0,0,0,0,2021-02-25,1614207600.0
5821,8,3,2021-02-26,0,0,0,0,2021-02-26,1614294000.0
5822,8,3,2021-02-27,0,0,0,0,2021-02-27,1614380400.0
5823,8,3,2021-02-28,0,0,0,0,2021-02-28,1614466800.0
5824,8,3,2021-03-01,0,0,0,0,2021-03-01,1614553200.0
5825,8,3,2021-03-02,1,0,1,0,2021-03-02,1614639600.0
5826,8,3,2021-03-03,0,0,1,0,2021-03-03,1614726000.0
5827,8,3,2021-03-04,0,0,1,0,2021-03-04,1614812400.0
5828,8,3,2021-03-05,0,0,1,0,2021-03-05,1614898800.0
5829,8,3,2021-03-06,0,0,1,0,2021-03-06,1614985200.0
5830,8,3,2021-03-07,0,0,1,0,2021-03-07,1615071600.0
5831,8,3,2021-03-08,0,0,1,0,2021-03-08,1615158000.0
5832,8,3,2021-03-09,0,0,1,0,2021-03-09,1615244400.0
5833,8,3,2021-03-10,10,0,11,0,2021-03-10,1615330800.0
5834,8,3,2021-03-11,2,0,13,0,2021-03-11,1615417200.0
5835,8,3,2021-03-12,1,0,14,0,2021-03-12,1615503600.0
5836,8,3,2021-03-13,11,0,25,0,2021-03-13,1615590000.0
5837,8,3,2021-03-14,0,0,25,0,2021-03-14,1615676400.0
5838,8,3,2021-03-15,0,0,25,0,2021-03-15,1615762800.0
5839,8,3,2021-03-16,0,0,25,0,2021-03-16,1615849200.0
5840,8,3,2021-03-17,0,0,25,0,2021-03-17,1615935600.0
5841,8,3,2021-03-18,0,0,25,0,2021-03-18,1616022000.0
5842,8,3,2021-03-19,0,0,25,0,2021-03-19,1616108400.0
5843,8,3,2021-03-20,0,0,25,0,2021-03-20,1616194800.0
5844,8,3,2021-03-21,0,0,25,0,2021-03-21,1616281200.0
5845,8,3,2021-03-22,0,0,25,0,2021-03-22,1616367600.0
5846,8,3,2021-03-23,0,0,25,0,2021-03-23,1616454000.0
5847,8,3,2021-03-24,0,0,25,0,2021-03-24,1616540400.0
5848,8,3,2021-03-25,26,0,51,0,2021-03-25,1616626800.0
5849,8,3,2021-03-26,1,0,52,0,2021-03-26,1616713200.0
5850,8,3,2021-03-27,7,0,59,0,2021-03-27,1616799600.0
5851,8,3,2021-03-28,0,0,59,0,2021-03-28,1616886000.0
5852,8,3,2021-03-29,8,0,67,0,2021-03-29,1616972400.0
5853,8,3,2021-03-30,5,0,72,0,2021-03-30,1617058800.0
5854,8,3,2021-03-31,16,0,88,0,2021-03-31,1617145200.0
5855,8,3,2021-04-01,0,0,88,0,2021-04-01,1617231600.0
5856,8,3,2021-04-02,0,0,88,0,2021-04-02,1617318000.0
5857,8,3,2021-04-03,0,0,88,0,2021-04-03,1617404400.0
5858,8,3,2021-04-04,0,0,88,0,2021-04-04,1617490800.0
5859,8,3,2021-04-05,0,0,88,0,2021-04-05,1617577200.0
5860,8,3,2021-04-06,0,0,88,0,2021-04-06,1617663600.0
5861,8,3,2021-04-07,0,0,88,0,2021-04-07,1617750000.0
5862,8,3,2021-04-08,0,0,88,0,2021-04-08,1617836400.0
5863,8,3,2021-04-09,0,0,88,0,2021-04-09,1617922800.0
5864,8,3,2021-04-10,0,0,88,0,2021-04-10,1618009200.0
5865,8,3,2021-04-11,0,0,88,0,2021-04-11,1618095600.0
5866,8,3,2021-04-12,0,0,88,0,2021-04-12,1618185600.0
5867,8,3,2021-04-13,2,0,90,0,2021-04-13,1618272000.0
5868,8,3,2021-04-14,7,0,97,0,2021-04-14,1618358400.0
5869,8,3,2021-04-15,3,0,100,0,2021-04-15,1618444800.0
5870,8,3,2021-04-16,2,0,102,0,2021-04-16,1618531200.0
5871,8,3,2021-04-17,0,0,102,0,2021-04-17,1618617600.0
5872,8,3,2021-04-18,0,0,102,0,2021-04-18,1618704000.0
5873,8,3,2021-04-19,4,0,106,0,2021-04-19,1618790400.0
5874,8,3,2021-04-20,2,0,108,0,2021-04-20,1618876800.0
5875,8,3,2021-04-21,0,0,108,0,2021-04-21,1618963200.0
5876,8,3,2021-04-22,1,0,109,0,2021-04-22,1619049600.0
5877,8,3,2021-04-23,0,0,109,0,2021-04-23,1619136000.0
5878,8,3,2021-04-24,0,0,109,0,2021-04-24,1619222400.0
5879,8,3,2021-04-25,0,0,109,0,2021-04-25,1619308800.0
5880,8,3,2021-04-26,0,0,109,0,2021-04-26,1619395200.0
5881,8,3,2021-04-27,0,0,109,0,2021-04-27,1619481600.0
5882,8,3,2021-04-28,2,0,111,0,2021-04-28,1619568000.0
5883,8,3,2021-04-29,0,0,111,0,2021-04-29,1619654400.0
5884,8,3,2021-04-30,0,0,111,0,2021-04-30,1619740800.0
5885,8,3,2021-05-01,0,8,111,8,2021-05-01,1619827200.0
5886,8,3,2021-05-02,0,0,111,8,2021-05-02,1619913600.0
5887,8,3,2021-05-03,0,4,111,12,2021-05-03,1620000000.0
5888,8,3,2021-05-04,0,4,111,16,2021-05-04,1620086400.0
5889,8,3,2021-05-05,0,1,111,17,2021-05-05,1620172800.0
5890,8,3,2021-05-06,0,0,111,17,2021-05-06,1620259200.0
5891,8,3,2021-05-07,0,0,111,17,2021-05-07,1620345600.0
5892,8,3,2021-05-08,0,0,111,17,2021-05-08,1620432000.0
5893,8,3,2021-05-09,0,0,111,17,2021-05-09,1620518400.0
5894,8,3,2021-05-10,0,0,111,17,2021-05-10,1620604800.0
5895,8,3,2021-05-11,0,0,111,17,2021-05-11,1620691200.0
5896,8,3,2021-05-12,0,0,111,17,2021-05-12,1620777600.0
5897,8,3,2021-05-13,0,0,111,17,2021-05-13,1620864000.0
5898,8,3,2021-05-14,0,0,111,17,2021-05-14,1620950400.0
5899,8,3,2021-05-15,0,0,111,17,2021-05-15,1621036800.0
5900,8,3,2021-05-16,0,0,111,17,2021-05-16,1621123200.0
5901,8,3,2021-05-17,0,0,111,17,2021-05-17,1621206000.0
5902,8,3,2021-05-18,0,0,111,17,2021-05-18,1621292400.0
5903,8,3,2021-05-19,0,0,111,17,2021-05-19,1621378800.0
5904,8,3,2021-05-20,0,0,111,17,2021-05-20,1621465200.0
5905,8,3,2021-05-21,3,2,114,19,2021-05-21,1621551600.0
5906,8,3,2021-05-22,0,2,114,21,2021-05-22,1621638000.0
5907,8,3,2021-05-23,0,0,114,21,2021-05-23,1621724400.0
5908,8,3,2021-05-24,0,0,114,21,2021-05-24,1621810800.0
5909,8,3,2021-05-25,0,0,114,21,2021-05-25,1621897200.0
5910,8,3,2021-05-26,0,0,114,21,2021-05-26,1621983600.0
5911,8,3,2021-05-27,0,0,114,21,2021-05-27,1622070000.0
5912,8,3,2021-05-28,0,0,114,21,2021-05-28,1622156400.0
5913,8,3,2021-05-29,0,0,114,21,2021-05-29,1622242800.0
5914,8,3,2021-05-30,0,0,114,21,2021-05-30,1622329200.0
5915,8,3,2021-05-31,0,0,114,21,2021-05-31,1622415600.0
5916,8,3,2021-06-01,0,0,114,21,2021-06-01,1622502000.0
5917,8,3,2021-06-02,0,0,114,21,2021-06-02,1622588400.0
5918,8,3,2021-06-03,0,3,114,24,2021-06-03,1622674800.0
5919,8,3,2021-06-04,1,1,115,25,2021-06-04,1622761200.0
5920,8,3,2021-06-05,0,2,115,27,2021-06-05,1622847600.0
5921,8,3,2021-06-06,0,0,115,27,2021-06-06,1622934000.0
5922,8,3,2021-06-07,0,0,115,27,2021-06-07,1623020400.0
5923,8,3,2021-06-08,1,0,116,27,2021-06-08,1623106800.0
5924,8,3,2021-06-09,0,0,116,27,2021-06-09,1623193200.0
5925,8,3,2021-06-10,0,6,116,33,2021-06-10,1623279600.0
5926,8,3,2021-06-11,5,0,121,33,2021-06-11,1623366000.0
5927,8,3,2021-06-12,0,2,121,35,2021-06-12,1623452400.0
5928,8,3,2021-06-13,0,0,121,35,2021-06-13,1623538800.0
5929,8,3,2021-06-14,0,0,121,35,2021-06-14,1623625200.0
5930,8,3,2021-06-15,0,1,121,36,2021-06-15,1623711600.0
5931,8,3,2021-06-16,0,2,121,38,2021-06-16,1623798000.0
5932,8,3,2021-06-17,0,2,121,40,2021-06-17,1623884400.0
5933,8,3,2021-06-18,0,4,121,44,2021-06-18,1623970800.0
5934,8,3,2021-06-19,2,3,123,47,2021-06-19,1624057200.0
5935,8,3,2021-06-20,0,0,123,47,2021-06-20,1624143600.0
5936,8,3,2021-06-21,0,0,123,47,2021-06-21,1624230000.0
5937,8,3,2021-06-22,0,0,123,47,2021-06-22,1624316400.0
5938,8,3,2021-06-23,0,0,123,47,2021-06-23,1624402800.0
5939,8,3,2021-06-24,0,0,123,47,2021-06-24,1624489200.0
5940,8,3,2021-06-25,0,0,123,47,2021-06-25,1624575600.0
5941,8,3,2021-06-26,0,0,123,47,2021-06-26,1624662000.0
5942,8,3,2021-06-27,0,0,123,47,2021-06-27,1624748400.0
5943,8,3,2021-06-28,0,0,123,47,2021-06-28,1624834800.0
5944,8,3,2021-06-29,0,0,123,47,2021-06-29,1624921200.0
5945,8,3,2021-06-30,0,0,123,47,2021-06-30,1625007600.0
5946,8,3,2021-07-01,0,0,123,47,2021-07-01,1625094000.0
5947,8,3,2021-07-02,0,0,123,47,2021-07-02,1625180400.0
5948,8,3,2021-07-03,0,0,123,47,2021-07-03,1625266800.0
5949,8,3,2021-07-04,0,0,123,47,2021-07-04,1625353200.0
5950,8,3,2021-07-05,0,0,123,47,2021-07-05,1625439600.0
5951,8,3,2021-07-06,0,0,123,47,2021-07-06,1625526000.0
5952,8,4,2020-12-27,0,0,0,0,2020-12-27,1609023600.0
5953,8,4,2020-12-28,0,0,0,0,2020-12-28,1609110000.0
5954,8,4,2020-12-29,0,0,0,0,2020-12-29,1609196400.0
5955,8,4,2020-12-30,0,0,0,0,2020-12-30,1609282800.0
5956,8,4,2020-12-31,0,0,0,0,2020-12-31,1609369200.0
5957,8,4,2021-01-01,0,0,0,0,2021-01-01,1609455600.0
5958,8,4,2021-01-02,0,0,0,0,2021-01-02,1609542000.0
5959,8,4,2021-01-03,0,0,0,0,2021-01-03,1609628400.0
5960,8,4,2021-01-04,0,0,0,0,2021-01-04,1609714800.0
5961,8,4,2021-01-05,0,0,0,0,2021-01-05,1609801200.0
5962,8,4,2021-01-06,0,0,0,0,2021-01-06,1609887600.0
5963,8,4,2021-01-07,0,0,0,0,2021-01-07,1609974000.0
5964,8,4,2021-01-08,0,0,0,0,2021-01-08,1610060400.0
5965,8,4,2021-01-09,0,0,0,0,2021-01-09,1610146800.0
5966,8,4,2021-01-10,0,0,0,0,2021-01-10,1610233200.0
5967,8,4,2021-01-11,0,0,0,0,2021-01-11,1610319600.0
5968,8,4,2021-01-12,0,0,0,0,2021-01-12,1610406000.0
5969,8,4,2021-01-13,0,0,0,0,2021-01-13,1610492400.0
5970,8,4,2021-01-14,0,0,0,0,2021-01-14,1610578800.0
5971,8,4,2021-01-15,0,0,0,0,2021-01-15,1610665200.0
5972,8,4,2021-01-16,0,0,0,0,2021-01-16,1610751600.0
5973,8,4,2021-01-17,0,0,0,0,2021-01-17,1610838000.0
5974,8,4,2021-01-18,0,0,0,0,2021-01-18,1610924400.0
5975,8,4,2021-01-19,0,0,0,0,2021-01-19,1611010800.0
5976,8,4,2021-01-20,0,0,0,0,2021-01-20,1611097200.0
5977,8,4,2021-01-21,0,0,0,0,2021-01-21,1611183600.0
5978,8,4,2021-01-22,0,0,0,0,2021-01-22,1611270000.0
5979,8,4,2021-01-23,0,0,0,0,2021-01-23,1611356400.0
5980,8,4,2021-01-24,0,0,0,0,2021-01-24,1611442800.0
5981,8,4,2021-01-25,0,0,0,0,2021-01-25,1611529200.0
5982,8,4,2021-01-26,0,0,0,0,2021-01-26,1611615600.0
5983,8,4,2021-01-27,0,0,0,0,2021-01-27,1611702000.0
5984,8,4,2021-01-28,0,0,0,0,2021-01-28,1611788400.0
5985,8,4,2021-01-29,0,0,0,0,2021-01-29,1611874800.0
5986,8,4,2021-01-30,0,0,0,0,2021-01-30,1611961200.0
5987,8,4,2021-01-31,0,0,0,0,2021-01-31,1612047600.0
5988,8,4,2021-02-01,0,0,0,0,2021-02-01,1612134000.0
5989,8,4,2021-02-02,0,0,0,0,2021-02-02,1612220400.0
5990,8,4,2021-02-03,0,0,0,0,2021-02-03,1612306800.0
5991,8,4,2021-02-04,0,0,0,0,2021-02-04,1612393200.0
5992,8,4,2021-02-05,0,0,0,0,2021-02-05,1612479600.0
5993,8,4,2021-02-06,0,0,0,0,2021-02-06,1612566000.0
5994,8,4,2021-02-07,0,0,0,0,2021-02-07,1612652400.0
5995,8,4,2021-02-08,0,0,0,0,2021-02-08,1612738800.0
5996,8,4,2021-02-09,0,0,0,0,2021-02-09,1612825200.0
5997,8,4,2021-02-10,0,0,0,0,2021-02-10,1612911600.0
5998,8,4,2021-02-11,0,0,0,0,2021-02-11,1612998000.0
5999,8,4,2021-02-12,0,0,0,0,2021-02-12,1613084400.0
6000,8,4,2021-02-13,0,0,0,0,2021-02-13,1613170800.0
6001,8,4,2021-02-14,0,0,0,0,2021-02-14,1613257200.0
6002,8,4,2021-02-15,0,0,0,0,2021-02-15,1613343600.0
6003,8,4,2021-02-16,0,0,0,0,2021-02-16,1613430000.0
6004,8,4,2021-02-17,0,0,0,0,2021-02-17,1613516400.0
6005,8,4,2021-02-18,0,0,0,0,2021-02-18,1613602800.0
6006,8,4,2021-02-19,0,0,0,0,2021-02-19,1613689200.0
6007,8,4,2021-02-20,0,0,0,0,2021-02-20,1613775600.0
6008,8,4,2021-02-21,0,0,0,0,2021-02-21,1613862000.0
6009,8,4,2021-02-22,0,0,0,0,2021-02-22,1613948400.0
6010,8,4,2021-02-23,0,0,0,0,2021-02-23,1614034800.0
6011,8,4,2021-02-24,0,0,0,0,2021-02-24,1614121200.0
6012,8,4,2021-02-25,0,0,0,0,2021-02-25,1614207600.0
6013,8,4,2021-02-26,0,0,0,0,2021-02-26,1614294000.0
6014,8,4,2021-02-27,0,0,0,0,2021-02-27,1614380400.0
6015,8,4,2021-02-28,0,0,0,0,2021-02-28,1614466800.0
6016,8,4,2021-03-01,0,0,0,0,2021-03-01,1614553200.0
6017,8,4,2021-03-02,0,0,0,0,2021-03-02,1614639600.0
6018,8,4,2021-03-03,0,0,0,0,2021-03-03,1614726000.0
6019,8,4,2021-03-04,0,0,0,0,2021-03-04,1614812400.0
6020,8,4,2021-03-05,0,0,0,0,2021-03-05,1614898800.0
6021,8,4,2021-03-06,0,0,0,0,2021-03-06,1614985200.0
6022,8,4,2021-03-07,0,0,0,0,2021-03-07,1615071600.0
6023,8,4,2021-03-08,0,0,0,0,2021-03-08,1615158000.0
6024,8,4,2021-03-09,0,0,0,0,2021-03-09,1615244400.0
6025,8,4,2021-03-10,0,0,0,0,2021-03-10,1615330800.0
6026,8,4,2021-03-11,0,0,0,0,2021-03-11,1615417200.0
6027,8,4,2021-03-12,0,0,0,0,2021-03-12,1615503600.0
6028,8,4,2021-03-13,0,0,0,0,2021-03-13,1615590000.0
6029,8,4,2021-03-14,0,0,0,0,2021-03-14,1615676400.0
6030,8,4,2021-03-15,0,0,0,0,2021-03-15,1615762800.0
6031,8,4,2021-03-16,0,0,0,0,2021-03-16,1615849200.0
6032,8,4,2021-03-17,0,0,0,0,2021-03-17,1615935600.0
6033,8,4,2021-03-18,0,0,0,0,2021-03-18,1616022000.0
6034,8,4,2021-03-19,0,0,0,0,2021-03-19,1616108400.0
6035,8,4,2021-03-20,0,0,0,0,2021-03-20,1616194800.0
6036,8,4,2021-03-21,0,0,0,0,2021-03-21,1616281200.0
6037,8,4,2021-03-22,0,0,0,0,2021-03-22,1616367600.0
6038,8,4,2021-03-23,0,0,0,0,2021-03-23,1616454000.0
6039,8,4,2021-03-24,0,0,0,0,2021-03-24,1616540400.0
6040,8,4,2021-03-25,0,0,0,0,2021-03-25,1616626800.0
6041,8,4,2021-03-26,0,0,0,0,2021-03-26,1616713200.0
6042,8,4,2021-03-27,0,0,0,0,2021-03-27,1616799600.0
6043,8,4,2021-03-28,0,0,0,0,2021-03-28,1616886000.0
6044,8,4,2021-03-29,0,0,0,0,2021-03-29,1616972400.0
6045,8,4,2021-03-30,0,0,0,0,2021-03-30,1617058800.0
6046,8,4,2021-03-31,0,0,0,0,2021-03-31,1617145200.0
6047,8,4,2021-04-01,0,0,0,0,2021-04-01,1617231600.0
6048,8,4,2021-04-02,0,0,0,0,2021-04-02,1617318000.0
6049,8,4,2021-04-03,0,0,0,0,2021-04-03,1617404400.0
6050,8,4,2021-04-04,0,0,0,0,2021-04-04,1617490800.0
6051,8,4,2021-04-05,0,0,0,0,2021-04-05,1617577200.0
6052,8,4,2021-04-06,0,0,0,0,2021-04-06,1617663600.0
6053,8,4,2021-04-07,0,0,0,0,2021-04-07,1617750000.0
6054,8,4,2021-04-08,0,0,0,0,2021-04-08,1617836400.0
6055,8,4,2021-04-09,0,0,0,0,2021-04-09,1617922800.0
6056,8,4,2021-04-10,0,0,0,0,2021-04-10,1618009200.0
6057,8,4,2021-04-11,0,0,0,0,2021-04-11,1618095600.0
6058,8,4,2021-04-12,0,0,0,0,2021-04-12,1618185600.0
6059,8,4,2021-04-13,0,0,0,0,2021-04-13,1618272000.0
6060,8,4,2021-04-14,0,0,0,0,2021-04-14,1618358400.0
6061,8,4,2021-04-15,0,0,0,0,2021-04-15,1618444800.0
6062,8,4,2021-04-16,0,0,0,0,2021-04-16,1618531200.0
6063,8,4,2021-04-17,0,0,0,0,2021-04-17,1618617600.0
6064,8,4,2021-04-18,0,0,0,0,2021-04-18,1618704000.0
6065,8,4,2021-04-19,0,0,0,0,2021-04-19,1618790400.0
6066,8,4,2021-04-20,0,0,0,0,2021-04-20,1618876800.0
6067,8,4,2021-04-21,0,0,0,0,2021-04-21,1618963200.0
6068,8,4,2021-04-22,0,0,0,0,2021-04-22,1619049600.0
6069,8,4,2021-04-23,0,0,0,0,2021-04-23,1619136000.0
6070,8,4,2021-04-24,0,0,0,0,2021-04-24,1619222400.0
6071,8,4,2021-04-25,0,0,0,0,2021-04-25,1619308800.0
6072,8,4,2021-04-26,0,0,0,0,2021-04-26,1619395200.0
6073,8,4,2021-04-27,0,0,0,0,2021-04-27,1619481600.0
6074,8,4,2021-04-28,0,0,0,0,2021-04-28,1619568000.0
6075,8,4,2021-04-29,0,0,0,0,2021-04-29,1619654400.0
6076,8,4,2021-04-30,0,0,0,0,2021-04-30,1619740800.0
6077,8,4,2021-05-01,0,0,0,0,2021-05-01,1619827200.0
6078,8,4,2021-05-02,0,0,0,0,2021-05-02,1619913600.0
6079,8,4,2021-05-03,0,0,0,0,2021-05-03,1620000000.0
6080,8,4,2021-05-04,0,0,0,0,2021-05-04,1620086400.0
6081,8,4,2021-05-05,0,0,0,0,2021-05-05,1620172800.0
6082,8,4,2021-05-06,0,0,0,0,2021-05-06,1620259200.0
6083,8,4,2021-05-07,0,0,0,0,2021-05-07,1620345600.0
6084,8,4,2021-05-08,0,0,0,0,2021-05-08,1620432000.0
6085,8,4,2021-05-09,0,0,0,0,2021-05-09,1620518400.0
6086,8,4,2021-05-10,0,0,0,0,2021-05-10,1620604800.0
6087,8,4,2021-05-11,0,0,0,0,2021-05-11,1620691200.0
6088,8,4,2021-05-12,0,0,0,0,2021-05-12,1620777600.0
6089,8,4,2021-05-13,0,0,0,0,2021-05-13,1620864000.0
6090,8,4,2021-05-14,0,0,0,0,2021-05-14,1620950400.0
6091,8,4,2021-05-15,0,0,0,0,2021-05-15,1621036800.0
6092,8,4,2021-05-16,0,0,0,0,2021-05-16,1621123200.0
6093,8,4,2021-05-17,0,0,0,0,2021-05-17,1621206000.0
6094,8,4,2021-05-18,0,0,0,0,2021-05-18,1621292400.0
6095,8,4,2021-05-19,0,0,0,0,2021-05-19,1621378800.0
6096,8,4,2021-05-20,0,0,0,0,2021-05-20,1621465200.0
6097,8,4,2021-05-21,0,0,0,0,2021-05-21,1621551600.0
6098,8,4,2021-05-22,0,0,0,0,2021-05-22,1621638000.0
6099,8,4,2021-05-23,0,0,0,0,2021-05-23,1621724400.0
6100,8,4,2021-05-24,0,0,0,0,2021-05-24,1621810800.0
6101,8,4,2021-05-25,0,0,0,0,2021-05-25,1621897200.0
6102,8,4,2021-05-26,0,0,0,0,2021-05-26,1621983600.0
6103,8,4,2021-05-27,0,0,0,0,2021-05-27,1622070000.0
6104,8,4,2021-05-28,0,0,0,0,2021-05-28,1622156400.0
6105,8,4,2021-05-29,0,0,0,0,2021-05-29,1622242800.0
6106,8,4,2021-05-30,0,0,0,0,2021-05-30,1622329200.0
6107,8,4,2021-05-31,0,0,0,0,2021-05-31,1622415600.0
6108,8,4,2021-06-01,0,0,0,0,2021-06-01,1622502000.0
6109,8,4,2021-06-02,0,0,0,0,2021-06-02,1622588400.0
6110,8,4,2021-06-03,0,0,0,0,2021-06-03,1622674800.0
6111,8,4,2021-06-04,0,0,0,0,2021-06-04,1622761200.0
6112,8,4,2021-06-05,0,0,0,0,2021-06-05,1622847600.0
6113,8,4,2021-06-06,0,0,0,0,2021-06-06,1622934000.0
6114,8,4,2021-06-07,0,0,0,0,2021-06-07,1623020400.0
6115,8,4,2021-06-08,0,0,0,0,2021-06-08,1623106800.0
6116,8,4,2021-06-09,0,0,0,0,2021-06-09,1623193200.0
6117,8,4,2021-06-10,0,0,0,0,2021-06-10,1623279600.0
6118,8,4,2021-06-11,0,0,0,0,2021-06-11,1623366000.0
6119,8,4,2021-06-12,0,0,0,0,2021-06-12,1623452400.0
6120,8,4,2021-06-13,0,0,0,0,2021-06-13,1623538800.0
6121,8,4,2021-06-14,0,0,0,0,2021-06-14,1623625200.0
6122,8,4,2021-06-15,0,0,0,0,2021-06-15,1623711600.0
6123,8,4,2021-06-16,0,0,0,0,2021-06-16,1623798000.0
6124,8,4,2021-06-17,0,0,0,0,2021-06-17,1623884400.0
6125,8,4,2021-06-18,0,0,0,0,2021-06-18,1623970800.0
6126,8,4,2021-06-19,0,0,0,0,2021-06-19,1624057200.0
6127,8,4,2021-06-20,0,0,0,0,2021-06-20,1624143600.0
6128,8,4,2021-06-21,0,0,0,0,2021-06-21,1624230000.0
6129,8,4,2021-06-22,0,0,0,0,2021-06-22,1624316400.0
6130,8,4,2021-06-23,0,0,0,0,2021-06-23,1624402800.0
6131,8,4,2021-06-24,0,0,0,0,2021-06-24,1624489200.0
6132,8,4,2021-06-25,0,0,0,0,2021-06-25,1624575600.0
6133,8,4,2021-06-26,0,0,0,0,2021-06-26,1624662000.0
6134,8,4,2021-06-27,0,0,0,0,2021-06-27,1624748400.0
6135,8,4,2021-06-28,0,0,0,0,2021-06-28,1624834800.0
6136,8,4,2021-06-29,0,0,0,0,2021-06-29,1624921200.0
6137,8,4,2021-06-30,0,0,0,0,2021-06-30,1625007600.0
6138,8,4,2021-07-01,0,0,0,0,2021-07-01,1625094000.0
6139,8,4,2021-07-02,0,0,0,0,2021-07-02,1625180400.0
6140,8,4,2021-07-03,0,0,0,0,2021-07-03,1625266800.0
6141,8,4,2021-07-04,0,0,0,0,2021-07-04,1625353200.0
6142,8,4,2021-07-05,0,0,0,0,2021-07-05,1625439600.0
6143,8,4,2021-07-06,0,0,0,0,2021-07-06,1625526000.0
6144,11,1,2020-12-27,13,0,13,0,2020-12-27,1609023600.0
6145,11,1,2020-12-28,12,0,25,0,2020-12-28,1609110000.0
6146,11,1,2020-12-29,56,0,81,0,2020-12-29,1609196400.0
6147,11,1,2020-12-30,91,0,172,0,2020-12-30,1609282800.0
6148,11,1,2020-12-31,39,0,211,0,2020-12-31,1609369200.0
6149,11,1,2021-01-01,32,0,243,0,2021-01-01,1609455600.0
6150,11,1,2021-01-02,64,0,307,0,2021-01-02,1609542000.0
6151,11,1,2021-01-03,78,0,385,0,2021-01-03,1609628400.0
6152,11,1,2021-01-04,554,0,939,0,2021-01-04,1609714800.0
6153,11,1,2021-01-05,2075,0,3014,0,2021-01-05,1609801200.0
6154,11,1,2021-01-06,3022,0,6036,0,2021-01-06,1609887600.0
6155,11,1,2021-01-07,5393,0,11429,0,2021-01-07,1609974000.0
6156,11,1,2021-01-08,7136,0,18565,0,2021-01-08,1610060400.0
6157,11,1,2021-01-09,1895,0,20460,0,2021-01-09,1610146800.0
6158,11,1,2021-01-10,1756,0,22216,0,2021-01-10,1610233200.0
6159,11,1,2021-01-11,8021,0,30237,0,2021-01-11,1610319600.0
6160,11,1,2021-01-12,10381,0,40618,0,2021-01-12,1610406000.0
6161,11,1,2021-01-13,10027,0,50645,0,2021-01-13,1610492400.0
6162,11,1,2021-01-14,10158,0,60803,0,2021-01-14,1610578800.0
6163,11,1,2021-01-15,8928,0,69731,0,2021-01-15,1610665200.0
6164,11,1,2021-01-16,2417,9,72148,9,2021-01-16,1610751600.0
6165,11,1,2021-01-17,1092,6,73240,15,2021-01-17,1610838000.0
6166,11,1,2021-01-18,12268,22,85508,37,2021-01-18,1610924400.0
6167,11,1,2021-01-19,15867,22,101375,59,2021-01-19,1611010800.0
6168,11,1,2021-01-20,18388,26,119763,85,2021-01-20,1611097200.0
6169,11,1,2021-01-21,22312,25,142075,110,2021-01-21,1611183600.0
6170,11,1,2021-01-22,17111,54,159186,164,2021-01-22,1611270000.0
6171,11,1,2021-01-23,4957,7,164143,171,2021-01-23,1611356400.0
6172,11,1,2021-01-24,1284,0,165427,171,2021-01-24,1611442800.0
6173,11,1,2021-01-25,8874,153,174301,324,2021-01-25,1611529200.0
6174,11,1,2021-01-26,12346,333,186647,657,2021-01-26,1611615600.0
6175,11,1,2021-01-27,16231,641,202878,1298,2021-01-27,1611702000.0
6176,11,1,2021-01-28,20310,1112,223188,2410,2021-01-28,1611788400.0
6177,11,1,2021-01-29,15357,1298,238545,3708,2021-01-29,1611874800.0
6178,11,1,2021-01-30,4468,82,243013,3790,2021-01-30,1611961200.0
6179,11,1,2021-01-31,586,19,243599,3809,2021-01-31,1612047600.0
6180,11,1,2021-02-01,7374,1937,250973,5746,2021-02-01,1612134000.0
6181,11,1,2021-02-02,8354,2793,259327,8539,2021-02-02,1612220400.0
6182,11,1,2021-02-03,8088,3778,267415,12317,2021-02-03,1612306800.0
6183,11,1,2021-02-04,8711,4567,276126,16884,2021-02-04,1612393200.0
6184,11,1,2021-02-05,8942,4406,285068,21290,2021-02-05,1612479600.0
6185,11,1,2021-02-06,3243,744,288311,22034,2021-02-06,1612566000.0
6186,11,1,2021-02-07,432,535,288743,22569,2021-02-07,1612652400.0
6187,11,1,2021-02-08,3492,5857,292235,28426,2021-02-08,1612738800.0
6188,11,1,2021-02-09,4005,9561,296240,37987,2021-02-09,1612825200.0
6189,11,1,2021-02-10,4355,11018,300595,49005,2021-02-10,1612911600.0
6190,11,1,2021-02-11,5755,16163,306350,65168,2021-02-11,1612998000.0
6191,11,1,2021-02-12,5698,10265,312048,75433,2021-02-12,1613084400.0
6192,11,1,2021-02-13,1004,2554,313052,77987,2021-02-13,1613170800.0
6193,11,1,2021-02-14,131,554,313183,78541,2021-02-14,1613257200.0
6194,11,1,2021-02-15,2262,11861,315445,90402,2021-02-15,1613343600.0
6195,11,1,2021-02-16,3029,18264,318474,108666,2021-02-16,1613430000.0
6196,11,1,2021-02-17,3566,15412,322040,124078,2021-02-17,1613516400.0
6197,11,1,2021-02-18,6113,20457,328153,144535,2021-02-18,1613602800.0
6198,11,1,2021-02-19,6751,15137,334904,159672,2021-02-19,1613689200.0
6199,11,1,2021-02-20,1402,4804,336306,164476,2021-02-20,1613775600.0
6200,11,1,2021-02-21,352,817,336658,165293,2021-02-21,1613862000.0
6201,11,1,2021-02-22,2491,9811,339149,175104,2021-02-22,1613948400.0
6202,11,1,2021-02-23,3187,10377,342336,185481,2021-02-23,1614034800.0
6203,11,1,2021-02-24,3094,9748,345430,195229,2021-02-24,1614121200.0
6204,11,1,2021-02-25,3293,13817,348723,209046,2021-02-25,1614207600.0
6205,11,1,2021-02-26,4574,9875,353297,218921,2021-02-26,1614294000.0
6206,11,1,2021-02-27,1032,3197,354329,222118,2021-02-27,1614380400.0
6207,11,1,2021-02-28,90,626,354419,222744,2021-02-28,1614466800.0
6208,11,1,2021-03-01,3706,7671,358125,230415,2021-03-01,1614553200.0
6209,11,1,2021-03-02,5938,9259,364063,239674,2021-03-02,1614639600.0
6210,11,1,2021-03-03,8346,9522,372409,249196,2021-03-03,1614726000.0
6211,11,1,2021-03-04,11578,10192,383987,259388,2021-03-04,1614812400.0
6212,11,1,2021-03-05,12232,9962,396219,269350,2021-03-05,1614898800.0
6213,11,1,2021-03-06,27265,2678,423484,272028,2021-03-06,1614985200.0
6214,11,1,2021-03-07,26834,2184,450318,274212,2021-03-07,1615071600.0
6215,11,1,2021-03-08,9142,4266,459460,278478,2021-03-08,1615158000.0
6216,11,1,2021-03-09,13997,3860,473457,282338,2021-03-09,1615244400.0
6217,11,1,2021-03-10,14171,4151,487628,286489,2021-03-10,1615330800.0
6218,11,1,2021-03-11,16821,5039,504449,291528,2021-03-11,1615417200.0
6219,11,1,2021-03-12,17453,4943,521902,296471,2021-03-12,1615503600.0
6220,11,1,2021-03-13,20008,933,541910,297404,2021-03-13,1615590000.0
6221,11,1,2021-03-14,10474,383,552384,297787,2021-03-14,1615676400.0
6222,11,1,2021-03-15,14521,2807,566905,300594,2021-03-15,1615762800.0
6223,11,1,2021-03-16,20310,3152,587215,303746,2021-03-16,1615849200.0
6224,11,1,2021-03-17,20754,2878,607969,306624,2021-03-17,1615935600.0
6225,11,1,2021-03-18,23856,3034,631825,309658,2021-03-18,1616022000.0
6226,11,1,2021-03-19,24893,2886,656718,312544,2021-03-19,1616108400.0
6227,11,1,2021-03-20,14115,874,670833,313418,2021-03-20,1616194800.0
6228,11,1,2021-03-21,3838,1056,674671,314474,2021-03-21,1616281200.0
6229,11,1,2021-03-22,19481,3002,694152,317476,2021-03-22,1616367600.0
6230,11,1,2021-03-23,23488,3827,717640,321303,2021-03-23,1616454000.0
6231,11,1,2021-03-24,23282,3446,740922,324749,2021-03-24,1616540400.0
6232,11,1,2021-03-25,30019,2999,770941,327748,2021-03-25,1616626800.0
6233,11,1,2021-03-26,30601,3656,801542,331404,2021-03-26,1616713200.0
6234,11,1,2021-03-27,22373,1009,823915,332413,2021-03-27,1616799600.0
6235,11,1,2021-03-28,8239,137,832154,332550,2021-03-28,1616886000.0
6236,11,1,2021-03-29,20997,5615,853151,338165,2021-03-29,1616972400.0
6237,11,1,2021-03-30,27302,7652,880453,345817,2021-03-30,1617058800.0
6238,11,1,2021-03-31,27129,10346,907582,356163,2021-03-31,1617145200.0
6239,11,1,2021-04-01,30625,17358,938207,373521,2021-04-01,1617231600.0
6240,11,1,2021-04-02,25859,19907,964066,393428,2021-04-02,1617318000.0
6241,11,1,2021-04-03,11291,19356,975357,412784,2021-04-03,1617404400.0
6242,11,1,2021-04-04,4824,6963,980181,419747,2021-04-04,1617490800.0
6243,11,1,2021-04-05,4510,1811,984691,421558,2021-04-05,1617577200.0
6244,11,1,2021-04-06,19738,16362,1004429,437920,2021-04-06,1617663600.0
6245,11,1,2021-04-07,24894,17446,1029323,455366,2021-04-07,1617750000.0
6246,11,1,2021-04-08,30302,17992,1059625,473358,2021-04-08,1617836400.0
6247,11,1,2021-04-09,28356,18306,1087981,491664,2021-04-09,1617922800.0
6248,11,1,2021-04-10,14640,17998,1102621,509662,2021-04-10,1618009200.0
6249,11,1,2021-04-11,4618,6778,1107239,516440,2021-04-11,1618095600.0
6250,11,1,2021-04-12,22163,14949,1129402,531389,2021-04-12,1618185600.0
6251,11,1,2021-04-13,25018,22549,1154420,553938,2021-04-13,1618272000.0
6252,11,1,2021-04-14,24208,18748,1178628,572686,2021-04-14,1618358400.0
6253,11,1,2021-04-15,25223,21901,1203851,594587,2021-04-15,1618444800.0
6254,11,1,2021-04-16,25579,22509,1229430,617096,2021-04-16,1618531200.0
6255,11,1,2021-04-17,15222,12639,1244652,629735,2021-04-17,1618617600.0
6256,11,1,2021-04-18,3263,3288,1247915,633023,2021-04-18,1618704000.0
6257,11,1,2021-04-19,18264,18340,1266179,651363,2021-04-19,1618790400.0
6258,11,1,2021-04-20,21096,21977,1287275,673340,2021-04-20,1618876800.0
6259,11,1,2021-04-21,23968,22239,1311243,695579,2021-04-21,1618963200.0
6260,11,1,2021-04-22,24754,27905,1335997,723484,2021-04-22,1619049600.0
6261,11,1,2021-04-23,26010,26049,1362007,749533,2021-04-23,1619136000.0
6262,11,1,2021-04-24,19719,19446,1381726,768979,2021-04-24,1619222400.0
6263,11,1,2021-04-25,11843,6495,1393569,775474,2021-04-25,1619308800.0
6264,11,1,2021-04-26,26172,19925,1419741,795399,2021-04-26,1619395200.0
6265,11,1,2021-04-27,35619,22782,1455360,818181,2021-04-27,1619481600.0
6266,11,1,2021-04-28,38520,22021,1493880,840202,2021-04-28,1619568000.0
6267,11,1,2021-04-29,45977,23787,1539857,863989,2021-04-29,1619654400.0
6268,11,1,2021-04-30,48107,22168,1587964,886157,2021-04-30,1619740800.0
6269,11,1,2021-05-01,19853,3334,1607817,889491,2021-05-01,1619827200.0
6270,11,1,2021-05-02,12148,3247,1619965,892738,2021-05-02,1619913600.0
6271,11,1,2021-05-03,48541,27428,1668506,920166,2021-05-03,1620000000.0
6272,11,1,2021-05-04,54280,21716,1722786,941882,2021-05-04,1620086400.0
6273,11,1,2021-05-05,54596,20027,1777382,961909,2021-05-05,1620172800.0
6274,11,1,2021-05-06,60439,21793,1837821,983702,2021-05-06,1620259200.0
6275,11,1,2021-05-07,56278,22842,1894099,1006544,2021-05-07,1620345600.0
6276,11,1,2021-05-08,46904,8537,1941003,1015081,2021-05-08,1620432000.0
6277,11,1,2021-05-09,31158,6128,1972161,1021209,2021-05-09,1620518400.0
6278,11,1,2021-05-10,61314,20655,2033475,1041864,2021-05-10,1620604800.0
6279,11,1,2021-05-11,70806,25565,2104281,1067429,2021-05-11,1620691200.0
6280,11,1,2021-05-12,72587,20091,2176868,1087520,2021-05-12,1620777600.0
6281,11,1,2021-05-13,59400,3956,2236268,1091476,2021-05-13,1620864000.0
6282,11,1,2021-05-14,71928,10559,2308196,1102035,2021-05-14,1620950400.0
6283,11,1,2021-05-15,56895,6726,2365091,1108761,2021-05-15,1621036800.0
6284,11,1,2021-05-16,31260,1757,2396351,1110518,2021-05-16,1621123200.0
6285,11,1,2021-05-17,75785,5926,2472136,1116444,2021-05-17,1621206000.0
6286,11,1,2021-05-18,90074,6337,2562210,1122781,2021-05-18,1621292400.0
6287,11,1,2021-05-19,86146,12480,2648356,1135261,2021-05-19,1621378800.0
6288,11,1,2021-05-20,93047,11400,2741403,1146661,2021-05-20,1621465200.0
6289,11,1,2021-05-21,86224,7146,2827627,1153807,2021-05-21,1621551600.0
6290,11,1,2021-05-22,66027,2830,2893654,1156637,2021-05-22,1621638000.0
6291,11,1,2021-05-23,35759,1345,2929413,1157982,2021-05-23,1621724400.0
6292,11,1,2021-05-24,57155,2115,2986568,1160097,2021-05-24,1621810800.0
6293,11,1,2021-05-25,83022,14047,3069590,1174144,2021-05-25,1621897200.0
6294,11,1,2021-05-26,81239,14588,3150829,1188732,2021-05-26,1621983600.0
6295,11,1,2021-05-27,88247,18459,3239076,1207191,2021-05-27,1622070000.0
6296,11,1,2021-05-28,79529,19615,3318605,1226806,2021-05-28,1622156400.0
6297,11,1,2021-05-29,61798,10266,3380403,1237072,2021-05-29,1622242800.0
6298,11,1,2021-05-30,34745,2844,3415148,1239916,2021-05-30,1622329200.0
6299,11,1,2021-05-31,69339,21094,3484487,1261010,2021-05-31,1622415600.0
6300,11,1,2021-06-01,75137,27039,3559624,1288049,2021-06-01,1622502000.0
6301,11,1,2021-06-02,73798,24207,3633422,1312256,2021-06-02,1622588400.0
6302,11,1,2021-06-03,78564,24790,3711986,1337046,2021-06-03,1622674800.0
6303,11,1,2021-06-04,72964,28338,3784950,1365384,2021-06-04,1622761200.0
6304,11,1,2021-06-05,56122,21279,3841072,1386663,2021-06-05,1622847600.0
6305,11,1,2021-06-06,36446,8632,3877518,1395295,2021-06-06,1622934000.0
6306,11,1,2021-06-07,61830,34054,3939348,1429349,2021-06-07,1623020400.0
6307,11,1,2021-06-08,61726,40350,4001074,1469699,2021-06-08,1623106800.0
6308,11,1,2021-06-09,62216,41937,4063290,1511636,2021-06-09,1623193200.0
6309,11,1,2021-06-10,61652,55259,4124942,1566895,2021-06-10,1623279600.0
6310,11,1,2021-06-11,55658,44515,4180600,1611410,2021-06-11,1623366000.0
6311,11,1,2021-06-12,58115,28781,4238715,1640191,2021-06-12,1623452400.0
6312,11,1,2021-06-13,28067,15072,4266782,1655263,2021-06-13,1623538800.0
6313,11,1,2021-06-14,37818,57573,4304600,1712836,2021-06-14,1623625200.0
6314,11,1,2021-06-15,43068,59354,4347668,1772190,2021-06-15,1623711600.0
6315,11,1,2021-06-16,45854,57034,4393522,1829224,2021-06-16,1623798000.0
6316,11,1,2021-06-17,46572,56986,4440094,1886210,2021-06-17,1623884400.0
6317,11,1,2021-06-18,42160,68672,4482254,1954882,2021-06-18,1623970800.0
6318,11,1,2021-06-19,38588,53087,4520842,2007969,2021-06-19,1624057200.0
6319,11,1,2021-06-20,14807,31067,4535649,2039036,2021-06-20,1624143600.0
6320,11,1,2021-06-21,30747,64576,4566396,2103612,2021-06-21,1624230000.0
6321,11,1,2021-06-22,33626,75686,4600022,2179298,2021-06-22,1624316400.0
6322,11,1,2021-06-23,35028,74209,4635050,2253507,2021-06-23,1624402800.0
6323,11,1,2021-06-24,37008,66902,4672058,2320409,2021-06-24,1624489200.0
6324,11,1,2021-06-25,33678,80928,4705736,2401337,2021-06-25,1624575600.0
6325,11,1,2021-06-26,32397,65530,4738133,2466867,2021-06-26,1624662000.0
6326,11,1,2021-06-27,12165,34886,4750298,2501753,2021-06-27,1624748400.0
6327,11,1,2021-06-28,27189,76291,4777487,2578044,2021-06-28,1624834800.0
6328,11,1,2021-06-29,30419,84677,4807906,2662721,2021-06-29,1624921200.0
6329,11,1,2021-06-30,33553,80511,4841459,2743232,2021-06-30,1625007600.0
6330,11,1,2021-07-01,34995,77437,4876454,2820669,2021-07-01,1625094000.0
6331,11,1,2021-07-02,34216,79107,4910670,2899776,2021-07-02,1625180400.0
6332,11,1,2021-07-03,29438,69433,4940108,2969209,2021-07-03,1625266800.0
6333,11,1,2021-07-04,13319,34102,4953427,3003311,2021-07-04,1625353200.0
6334,11,1,2021-07-05,30268,69781,4983695,3073092,2021-07-05,1625439600.0
6335,11,1,2021-07-06,32684,79950,5016379,3153042,2021-07-06,1625526000.0
6336,11,2,2020-12-27,0,0,0,0,2020-12-27,1609023600.0
6337,11,2,2020-12-28,0,0,0,0,2020-12-28,1609110000.0
6338,11,2,2020-12-29,0,0,0,0,2020-12-29,1609196400.0
6339,11,2,2020-12-30,0,0,0,0,2020-12-30,1609282800.0
6340,11,2,2020-12-31,0,0,0,0,2020-12-31,1609369200.0
6341,11,2,2021-01-01,0,0,0,0,2021-01-01,1609455600.0
6342,11,2,2021-01-02,0,0,0,0,2021-01-02,1609542000.0
6343,11,2,2021-01-03,0,0,0,0,2021-01-03,1609628400.0
6344,11,2,2021-01-04,0,0,0,0,2021-01-04,1609714800.0
6345,11,2,2021-01-05,0,0,0,0,2021-01-05,1609801200.0
6346,11,2,2021-01-06,0,0,0,0,2021-01-06,1609887600.0
6347,11,2,2021-01-07,0,0,0,0,2021-01-07,1609974000.0
6348,11,2,2021-01-08,0,0,0,0,2021-01-08,1610060400.0
6349,11,2,2021-01-09,0,0,0,0,2021-01-09,1610146800.0
6350,11,2,2021-01-10,0,0,0,0,2021-01-10,1610233200.0
6351,11,2,2021-01-11,0,0,0,0,2021-01-11,1610319600.0
6352,11,2,2021-01-12,0,0,0,0,2021-01-12,1610406000.0
6353,11,2,2021-01-13,0,0,0,0,2021-01-13,1610492400.0
6354,11,2,2021-01-14,2,0,2,0,2021-01-14,1610578800.0
6355,11,2,2021-01-15,1,0,3,0,2021-01-15,1610665200.0
6356,11,2,2021-01-16,0,0,3,0,2021-01-16,1610751600.0
6357,11,2,2021-01-17,0,0,3,0,2021-01-17,1610838000.0
6358,11,2,2021-01-18,0,0,3,0,2021-01-18,1610924400.0
6359,11,2,2021-01-19,0,0,3,0,2021-01-19,1611010800.0
6360,11,2,2021-01-20,1,0,4,0,2021-01-20,1611097200.0
6361,11,2,2021-01-21,8,0,12,0,2021-01-21,1611183600.0
6362,11,2,2021-01-22,4,0,16,0,2021-01-22,1611270000.0
6363,11,2,2021-01-23,5,0,21,0,2021-01-23,1611356400.0
6364,11,2,2021-01-24,0,0,21,0,2021-01-24,1611442800.0
6365,11,2,2021-01-25,1,0,22,0,2021-01-25,1611529200.0
6366,11,2,2021-01-26,1,0,23,0,2021-01-26,1611615600.0
6367,11,2,2021-01-27,1,0,24,0,2021-01-27,1611702000.0
6368,11,2,2021-01-28,2,0,26,0,2021-01-28,1611788400.0
6369,11,2,2021-01-29,47,0,73,0,2021-01-29,1611874800.0
6370,11,2,2021-01-30,0,0,73,0,2021-01-30,1611961200.0
6371,11,2,2021-01-31,0,0,73,0,2021-01-31,1612047600.0
6372,11,2,2021-02-01,16,0,89,0,2021-02-01,1612134000.0
6373,11,2,2021-02-02,5,0,94,0,2021-02-02,1612220400.0
6374,11,2,2021-02-03,40,0,134,0,2021-02-03,1612306800.0
6375,11,2,2021-02-04,74,0,208,0,2021-02-04,1612393200.0
6376,11,2,2021-02-05,11,0,219,0,2021-02-05,1612479600.0
6377,11,2,2021-02-06,3,0,222,0,2021-02-06,1612566000.0
6378,11,2,2021-02-07,0,0,222,0,2021-02-07,1612652400.0
6379,11,2,2021-02-08,2390,0,2612,0,2021-02-08,1612738800.0
6380,11,2,2021-02-09,3069,2,5681,2,2021-02-09,1612825200.0
6381,11,2,2021-02-10,3569,2,9250,4,2021-02-10,1612911600.0
6382,11,2,2021-02-11,3831,5,13081,9,2021-02-11,1612998000.0
6383,11,2,2021-02-12,3675,3,16756,12,2021-02-12,1613084400.0
6384,11,2,2021-02-13,1240,1,17996,13,2021-02-13,1613170800.0
6385,11,2,2021-02-14,81,0,18077,13,2021-02-14,1613257200.0
6386,11,2,2021-02-15,195,2,18272,15,2021-02-15,1613343600.0
6387,11,2,2021-02-16,102,2,18374,17,2021-02-16,1613430000.0
6388,11,2,2021-02-17,151,0,18525,17,2021-02-17,1613516400.0
6389,11,2,2021-02-18,184,7,18709,24,2021-02-18,1613602800.0
6390,11,2,2021-02-19,232,2,18941,26,2021-02-19,1613689200.0
6391,11,2,2021-02-20,0,2,18941,28,2021-02-20,1613775600.0
6392,11,2,2021-02-21,0,0,18941,28,2021-02-21,1613862000.0
6393,11,2,2021-02-22,190,3,19131,31,2021-02-22,1613948400.0
6394,11,2,2021-02-23,142,0,19273,31,2021-02-23,1614034800.0
6395,11,2,2021-02-24,204,2,19477,33,2021-02-24,1614121200.0
6396,11,2,2021-02-25,304,0,19781,33,2021-02-25,1614207600.0
6397,11,2,2021-02-26,200,2,19981,35,2021-02-26,1614294000.0
6398,11,2,2021-02-27,39,0,20020,35,2021-02-27,1614380400.0
6399,11,2,2021-02-28,0,0,20020,35,2021-02-28,1614466800.0
6400,11,2,2021-03-01,1579,4,21599,39,2021-03-01,1614553200.0
6401,11,2,2021-03-02,2201,2,23800,41,2021-03-02,1614639600.0
6402,11,2,2021-03-03,2016,1,25816,42,2021-03-03,1614726000.0
6403,11,2,2021-03-04,2089,12,27905,54,2021-03-04,1614812400.0
6404,11,2,2021-03-05,2156,15,30061,69,2021-03-05,1614898800.0
6405,11,2,2021-03-06,1080,42,31141,111,2021-03-06,1614985200.0
6406,11,2,2021-03-07,228,3,31369,114,2021-03-07,1615071600.0
6407,11,2,2021-03-08,457,2596,31826,2710,2021-03-08,1615158000.0
6408,11,2,2021-03-09,424,3120,32250,5830,2021-03-09,1615244400.0
6409,11,2,2021-03-10,507,3381,32757,9211,2021-03-10,1615330800.0
6410,11,2,2021-03-11,550,3595,33307,12806,2021-03-11,1615417200.0
6411,11,2,2021-03-12,485,3146,33792,15952,2021-03-12,1615503600.0
6412,11,2,2021-03-13,207,909,33999,16861,2021-03-13,1615590000.0
6413,11,2,2021-03-14,27,90,34026,16951,2021-03-14,1615676400.0
6414,11,2,2021-03-15,2649,431,36675,17382,2021-03-15,1615762800.0
6415,11,2,2021-03-16,3281,107,39956,17489,2021-03-16,1615849200.0
6416,11,2,2021-03-17,3581,143,43537,17632,2021-03-17,1615935600.0
6417,11,2,2021-03-18,4887,201,48424,17833,2021-03-18,1616022000.0
6418,11,2,2021-03-19,3458,160,51882,17993,2021-03-19,1616108400.0
6419,11,2,2021-03-20,1340,1,53222,17994,2021-03-20,1616194800.0
6420,11,2,2021-03-21,146,9,53368,18003,2021-03-21,1616281200.0
6421,11,2,2021-03-22,3648,124,57016,18127,2021-03-22,1616367600.0
6422,11,2,2021-03-23,4292,176,61308,18303,2021-03-23,1616454000.0
6423,11,2,2021-03-24,4511,213,65819,18516,2021-03-24,1616540400.0
6424,11,2,2021-03-25,5173,280,70992,18796,2021-03-25,1616626800.0
6425,11,2,2021-03-26,4110,176,75102,18972,2021-03-26,1616713200.0
6426,11,2,2021-03-27,1088,13,76190,18985,2021-03-27,1616799600.0
6427,11,2,2021-03-28,199,18,76389,19003,2021-03-28,1616886000.0
6428,11,2,2021-03-29,3112,1349,79501,20352,2021-03-29,1616972400.0
6429,11,2,2021-03-30,3416,2086,82917,22438,2021-03-30,1617058800.0
6430,11,2,2021-03-31,3284,1861,86201,24299,2021-03-31,1617145200.0
6431,11,2,2021-04-01,2416,2181,88617,26480,2021-04-01,1617231600.0
6432,11,2,2021-04-02,1792,2112,90409,28592,2021-04-02,1617318000.0
6433,11,2,2021-04-03,1576,970,91985,29562,2021-04-03,1617404400.0
6434,11,2,2021-04-04,359,70,92344,29632,2021-04-04,1617490800.0
6435,11,2,2021-04-05,815,3,93159,29635,2021-04-05,1617577200.0
6436,11,2,2021-04-06,5584,617,98743,30252,2021-04-06,1617663600.0
6437,11,2,2021-04-07,7942,603,106685,30855,2021-04-07,1617750000.0
6438,11,2,2021-04-08,7461,435,114146,31290,2021-04-08,1617836400.0
6439,11,2,2021-04-09,7250,415,121396,31705,2021-04-09,1617922800.0
6440,11,2,2021-04-10,4601,250,125997,31955,2021-04-10,1618009200.0
6441,11,2,2021-04-11,843,27,126840,31982,2021-04-11,1618095600.0
6442,11,2,2021-04-12,749,2748,127589,34730,2021-04-12,1618185600.0
6443,11,2,2021-04-13,924,3050,128513,37780,2021-04-13,1618272000.0
6444,11,2,2021-04-14,1375,3604,129888,41384,2021-04-14,1618358400.0
6445,11,2,2021-04-15,1365,4266,131253,45650,2021-04-15,1618444800.0
6446,11,2,2021-04-16,1180,3160,132433,48810,2021-04-16,1618531200.0
6447,11,2,2021-04-17,544,1171,132977,49981,2021-04-17,1618617600.0
6448,11,2,2021-04-18,156,116,133133,50097,2021-04-18,1618704000.0
6449,11,2,2021-04-19,3131,3511,136264,53608,2021-04-19,1618790400.0
6450,11,2,2021-04-20,3441,4153,139705,57761,2021-04-20,1618876800.0
6451,11,2,2021-04-21,2846,4088,142551,61849,2021-04-21,1618963200.0
6452,11,2,2021-04-22,3600,4534,146151,66383,2021-04-22,1619049600.0
6453,11,2,2021-04-23,4093,3639,150244,70022,2021-04-23,1619136000.0
6454,11,2,2021-04-24,13199,1084,163443,71106,2021-04-24,1619222400.0
6455,11,2,2021-04-25,6848,192,170291,71298,2021-04-25,1619308800.0
6456,11,2,2021-04-26,4182,2572,174473,73870,2021-04-26,1619395200.0
6457,11,2,2021-04-27,4383,3034,178856,76904,2021-04-27,1619481600.0
6458,11,2,2021-04-28,4667,3120,183523,80024,2021-04-28,1619568000.0
6459,11,2,2021-04-29,4924,2211,188447,82235,2021-04-29,1619654400.0
6460,11,2,2021-04-30,4885,1969,193332,84204,2021-04-30,1619740800.0
6461,11,2,2021-05-01,2628,595,195960,84799,2021-05-01,1619827200.0
6462,11,2,2021-05-02,1691,497,197651,85296,2021-05-02,1619913600.0
6463,11,2,2021-05-03,3516,2986,201167,88282,2021-05-03,1620000000.0
6464,11,2,2021-05-04,1806,5330,202973,93612,2021-05-04,1620086400.0
6465,11,2,2021-05-05,2521,7221,205494,100833,2021-05-05,1620172800.0
6466,11,2,2021-05-06,2083,7105,207577,107938,2021-05-06,1620259200.0
6467,11,2,2021-05-07,2649,6399,210226,114337,2021-05-07,1620345600.0
6468,11,2,2021-05-08,3155,2034,213381,116371,2021-05-08,1620432000.0
6469,11,2,2021-05-09,1374,769,214755,117140,2021-05-09,1620518400.0
6470,11,2,2021-05-10,6678,1618,221433,118758,2021-05-10,1620604800.0
6471,11,2,2021-05-11,6440,1172,227873,119930,2021-05-11,1620691200.0
6472,11,2,2021-05-12,7992,1153,235865,121083,2021-05-12,1620777600.0
6473,11,2,2021-05-13,8131,207,243996,121290,2021-05-13,1620864000.0
6474,11,2,2021-05-14,10399,781,254395,122071,2021-05-14,1620950400.0
6475,11,2,2021-05-15,8571,289,262966,122360,2021-05-15,1621036800.0
6476,11,2,2021-05-16,5270,52,268236,122412,2021-05-16,1621123200.0
6477,11,2,2021-05-17,5687,507,273923,122919,2021-05-17,1621206000.0
6478,11,2,2021-05-18,7317,428,281240,123347,2021-05-18,1621292400.0
6479,11,2,2021-05-19,10435,585,291675,123932,2021-05-19,1621378800.0
6480,11,2,2021-05-20,11824,495,303499,124427,2021-05-20,1621465200.0
6481,11,2,2021-05-21,12945,721,316444,125148,2021-05-21,1621551600.0
6482,11,2,2021-05-22,12864,197,329308,125345,2021-05-22,1621638000.0
6483,11,2,2021-05-23,6154,44,335462,125389,2021-05-23,1621724400.0
6484,11,2,2021-05-24,2600,109,338062,125498,2021-05-24,1621810800.0
6485,11,2,2021-05-25,1590,890,339652,126388,2021-05-25,1621897200.0
6486,11,2,2021-05-26,1755,1117,341407,127505,2021-05-26,1621983600.0
6487,11,2,2021-05-27,1886,808,343293,128313,2021-05-27,1622070000.0
6488,11,2,2021-05-28,3907,1336,347200,129649,2021-05-28,1622156400.0
6489,11,2,2021-05-29,4491,920,351691,130569,2021-05-29,1622242800.0
6490,11,2,2021-05-30,946,264,352637,130833,2021-05-30,1622329200.0
6491,11,2,2021-05-31,6807,4389,359444,135222,2021-05-31,1622415600.0
6492,11,2,2021-06-01,9393,4006,368837,139228,2021-06-01,1622502000.0
6493,11,2,2021-06-02,7259,2967,376096,142195,2021-06-02,1622588400.0
6494,11,2,2021-06-03,7744,5633,383840,147828,2021-06-03,1622674800.0
6495,11,2,2021-06-04,8973,5332,392813,153160,2021-06-04,1622761200.0
6496,11,2,2021-06-05,6040,13008,398853,166168,2021-06-05,1622847600.0
6497,11,2,2021-06-06,1245,3329,400098,169497,2021-06-06,1622934000.0
6498,11,2,2021-06-07,5728,5410,405826,174907,2021-06-07,1623020400.0
6499,11,2,2021-06-08,8800,4784,414626,179691,2021-06-08,1623106800.0
6500,11,2,2021-06-09,6585,4658,421211,184349,2021-06-09,1623193200.0
6501,11,2,2021-06-10,7455,4624,428666,188973,2021-06-10,1623279600.0
6502,11,2,2021-06-11,7804,5148,436470,194121,2021-06-11,1623366000.0
6503,11,2,2021-06-12,4402,3998,440872,198119,2021-06-12,1623452400.0
6504,11,2,2021-06-13,1229,2538,442101,200657,2021-06-13,1623538800.0
6505,11,2,2021-06-14,4309,4268,446410,204925,2021-06-14,1623625200.0
6506,11,2,2021-06-15,6447,3127,452857,208052,2021-06-15,1623711600.0
6507,11,2,2021-06-16,5054,3388,457911,211440,2021-06-16,1623798000.0
6508,11,2,2021-06-17,5811,2687,463722,214127,2021-06-17,1623884400.0
6509,11,2,2021-06-18,6108,3860,469830,217987,2021-06-18,1623970800.0
6510,11,2,2021-06-19,3994,3151,473824,221138,2021-06-19,1624057200.0
6511,11,2,2021-06-20,1300,1109,475124,222247,2021-06-20,1624143600.0
6512,11,2,2021-06-21,2801,7633,477925,229880,2021-06-21,1624230000.0
6513,11,2,2021-06-22,4265,8330,482190,238210,2021-06-22,1624316400.0
6514,11,2,2021-06-23,3294,8829,485484,247039,2021-06-23,1624402800.0
6515,11,2,2021-06-24,3988,10693,489472,257732,2021-06-24,1624489200.0
6516,11,2,2021-06-25,3684,9627,493156,267359,2021-06-25,1624575600.0
6517,11,2,2021-06-26,2254,7849,495410,275208,2021-06-26,1624662000.0
6518,11,2,2021-06-27,982,1683,496392,276891,2021-06-27,1624748400.0
6519,11,2,2021-06-28,2146,8156,498538,285047,2021-06-28,1624834800.0
6520,11,2,2021-06-29,2589,8801,501127,293848,2021-06-29,1624921200.0
6521,11,2,2021-06-30,2188,10825,503315,304673,2021-06-30,1625007600.0
6522,11,2,2021-07-01,2950,11578,506265,316251,2021-07-01,1625094000.0
6523,11,2,2021-07-02,2905,11642,509170,327893,2021-07-02,1625180400.0
6524,11,2,2021-07-03,1867,11868,511037,339761,2021-07-03,1625266800.0
6525,11,2,2021-07-04,772,4635,511809,344396,2021-07-04,1625353200.0
6526,11,2,2021-07-05,1514,4884,513323,349280,2021-07-05,1625439600.0
6527,11,2,2021-07-06,2254,5618,515577,354898,2021-07-06,1625526000.0
6528,11,3,2020-12-27,0,0,0,0,2020-12-27,1609023600.0
6529,11,3,2020-12-28,0,0,0,0,2020-12-28,1609110000.0
6530,11,3,2020-12-29,0,0,0,0,2020-12-29,1609196400.0
6531,11,3,2020-12-30,0,0,0,0,2020-12-30,1609282800.0
6532,11,3,2020-12-31,0,0,0,0,2020-12-31,1609369200.0
6533,11,3,2021-01-01,0,0,0,0,2021-01-01,1609455600.0
6534,11,3,2021-01-02,0,0,0,0,2021-01-02,1609542000.0
6535,11,3,2021-01-03,0,0,0,0,2021-01-03,1609628400.0
6536,11,3,2021-01-04,0,0,0,0,2021-01-04,1609714800.0
6537,11,3,2021-01-05,0,0,0,0,2021-01-05,1609801200.0
6538,11,3,2021-01-06,0,0,0,0,2021-01-06,1609887600.0
6539,11,3,2021-01-07,0,0,0,0,2021-01-07,1609974000.0
6540,11,3,2021-01-08,0,0,0,0,2021-01-08,1610060400.0
6541,11,3,2021-01-09,0,0,0,0,2021-01-09,1610146800.0
6542,11,3,2021-01-10,0,0,0,0,2021-01-10,1610233200.0
6543,11,3,2021-01-11,0,0,0,0,2021-01-11,1610319600.0
6544,11,3,2021-01-12,0,0,0,0,2021-01-12,1610406000.0
6545,11,3,2021-01-13,0,0,0,0,2021-01-13,1610492400.0
6546,11,3,2021-01-14,0,0,0,0,2021-01-14,1610578800.0
6547,11,3,2021-01-15,0,0,0,0,2021-01-15,1610665200.0
6548,11,3,2021-01-16,0,0,0,0,2021-01-16,1610751600.0
6549,11,3,2021-01-17,0,0,0,0,2021-01-17,1610838000.0
6550,11,3,2021-01-18,0,0,0,0,2021-01-18,1610924400.0
6551,11,3,2021-01-19,0,0,0,0,2021-01-19,1611010800.0
6552,11,3,2021-01-20,0,0,0,0,2021-01-20,1611097200.0
6553,11,3,2021-01-21,0,0,0,0,2021-01-21,1611183600.0
6554,11,3,2021-01-22,0,0,0,0,2021-01-22,1611270000.0
6555,11,3,2021-01-23,0,0,0,0,2021-01-23,1611356400.0
6556,11,3,2021-01-24,0,0,0,0,2021-01-24,1611442800.0
6557,11,3,2021-01-25,0,0,0,0,2021-01-25,1611529200.0
6558,11,3,2021-01-26,0,0,0,0,2021-01-26,1611615600.0
6559,11,3,2021-01-27,0,0,0,0,2021-01-27,1611702000.0
6560,11,3,2021-01-28,0,0,0,0,2021-01-28,1611788400.0
6561,11,3,2021-01-29,0,0,0,0,2021-01-29,1611874800.0
6562,11,3,2021-01-30,0,0,0,0,2021-01-30,1611961200.0
6563,11,3,2021-01-31,0,0,0,0,2021-01-31,1612047600.0
6564,11,3,2021-02-01,0,0,0,0,2021-02-01,1612134000.0
6565,11,3,2021-02-02,0,0,0,0,2021-02-02,1612220400.0
6566,11,3,2021-02-03,0,0,0,0,2021-02-03,1612306800.0
6567,11,3,2021-02-04,0,0,0,0,2021-02-04,1612393200.0
6568,11,3,2021-02-05,0,0,0,0,2021-02-05,1612479600.0
6569,11,3,2021-02-06,25,0,25,0,2021-02-06,1612566000.0
6570,11,3,2021-02-07,156,0,181,0,2021-02-07,1612652400.0
6571,11,3,2021-02-08,348,0,529,0,2021-02-08,1612738800.0
6572,11,3,2021-02-09,1366,0,1895,0,2021-02-09,1612825200.0
6573,11,3,2021-02-10,2044,0,3939,0,2021-02-10,1612911600.0
6574,11,3,2021-02-11,2800,0,6739,0,2021-02-11,1612998000.0
6575,11,3,2021-02-12,2504,0,9243,0,2021-02-12,1613084400.0
6576,11,3,2021-02-13,352,0,9595,0,2021-02-13,1613170800.0
6577,11,3,2021-02-14,103,0,9698,0,2021-02-14,1613257200.0
6578,11,3,2021-02-15,2001,0,11699,0,2021-02-15,1613343600.0
6579,11,3,2021-02-16,2551,0,14250,0,2021-02-16,1613430000.0
6580,11,3,2021-02-17,1975,0,16225,0,2021-02-17,1613516400.0
6581,11,3,2021-02-18,2352,0,18577,0,2021-02-18,1613602800.0
6582,11,3,2021-02-19,2063,0,20640,0,2021-02-19,1613689200.0
6583,11,3,2021-02-20,289,0,20929,0,2021-02-20,1613775600.0
6584,11,3,2021-02-21,46,0,20975,0,2021-02-21,1613862000.0
6585,11,3,2021-02-22,1548,0,22523,0,2021-02-22,1613948400.0
6586,11,3,2021-02-23,1623,0,24146,0,2021-02-23,1614034800.0
6587,11,3,2021-02-24,2123,0,26269,0,2021-02-24,1614121200.0
6588,11,3,2021-02-25,5027,0,31296,0,2021-02-25,1614207600.0
6589,11,3,2021-02-26,6424,0,37720,0,2021-02-26,1614294000.0
6590,11,3,2021-02-27,3997,0,41717,0,2021-02-27,1614380400.0
6591,11,3,2021-02-28,653,0,42370,0,2021-02-28,1614466800.0
6592,11,3,2021-03-01,3574,3,45944,3,2021-03-01,1614553200.0
6593,11,3,2021-03-02,6255,3,52199,6,2021-03-02,1614639600.0
6594,11,3,2021-03-03,8333,5,60532,11,2021-03-03,1614726000.0
6595,11,3,2021-03-04,14622,4,75154,15,2021-03-04,1614812400.0
6596,11,3,2021-03-05,22137,25,97291,40,2021-03-05,1614898800.0
6597,11,3,2021-03-06,18110,11,115401,51,2021-03-06,1614985200.0
6598,11,3,2021-03-07,7249,1,122650,52,2021-03-07,1615071600.0
6599,11,3,2021-03-08,8186,7,130836,59,2021-03-08,1615158000.0
6600,11,3,2021-03-09,12469,7,143305,66,2021-03-09,1615244400.0
6601,11,3,2021-03-10,12998,2,156303,68,2021-03-10,1615330800.0
6602,11,3,2021-03-11,19719,10,176022,78,2021-03-11,1615417200.0
6603,11,3,2021-03-12,26902,14,202924,92,2021-03-12,1615503600.0
6604,11,3,2021-03-13,19684,3,222608,95,2021-03-13,1615590000.0
6605,11,3,2021-03-14,3774,1,226382,96,2021-03-14,1615676400.0
6606,11,3,2021-03-15,12074,11,238456,107,2021-03-15,1615762800.0
6607,11,3,2021-03-16,182,1,238638,108,2021-03-16,1615849200.0
6608,11,3,2021-03-17,122,1,238760,109,2021-03-17,1615935600.0
6609,11,3,2021-03-18,299,0,239059,109,2021-03-18,1616022000.0
6610,11,3,2021-03-19,11354,7,250413,116,2021-03-19,1616108400.0
6611,11,3,2021-03-20,10424,6,260837,122,2021-03-20,1616194800.0
6612,11,3,2021-03-21,1653,3,262490,125,2021-03-21,1616281200.0
6613,11,3,2021-03-22,9045,9,271535,134,2021-03-22,1616367600.0
6614,11,3,2021-03-23,15580,16,287115,150,2021-03-23,1616454000.0
6615,11,3,2021-03-24,14918,15,302033,165,2021-03-24,1616540400.0
6616,11,3,2021-03-25,22818,16,324851,181,2021-03-25,1616626800.0
6617,11,3,2021-03-26,23120,21,347971,202,2021-03-26,1616713200.0
6618,11,3,2021-03-27,11057,7,359028,209,2021-03-27,1616799600.0
6619,11,3,2021-03-28,1735,3,360763,212,2021-03-28,1616886000.0
6620,11,3,2021-03-29,9005,13,369768,225,2021-03-29,1616972400.0
6621,11,3,2021-03-30,14205,21,383973,246,2021-03-30,1617058800.0
6622,11,3,2021-03-31,9539,11,393512,257,2021-03-31,1617145200.0
6623,11,3,2021-04-01,12438,11,405950,268,2021-04-01,1617231600.0
6624,11,3,2021-04-02,11865,32,417815,300,2021-04-02,1617318000.0
6625,11,3,2021-04-03,5540,29,423355,329,2021-04-03,1617404400.0
6626,11,3,2021-04-04,943,3,424298,332,2021-04-04,1617490800.0
6627,11,3,2021-04-05,649,0,424947,332,2021-04-05,1617577200.0
6628,11,3,2021-04-06,4699,17,429646,349,2021-04-06,1617663600.0
6629,11,3,2021-04-07,4772,8,434418,357,2021-04-07,1617750000.0
6630,11,3,2021-04-08,9003,38,443421,395,2021-04-08,1617836400.0
6631,11,3,2021-04-09,18286,62,461707,457,2021-04-09,1617922800.0
6632,11,3,2021-04-10,9760,59,471467,516,2021-04-10,1618009200.0
6633,11,3,2021-04-11,1096,6,472563,522,2021-04-11,1618095600.0
6634,11,3,2021-04-12,7436,65,479999,587,2021-04-12,1618185600.0
6635,11,3,2021-04-13,11430,88,491429,675,2021-04-13,1618272000.0
6636,11,3,2021-04-14,9495,91,500924,766,2021-04-14,1618358400.0
6637,11,3,2021-04-15,12631,84,513555,850,2021-04-15,1618444800.0
6638,11,3,2021-04-16,14368,91,527923,941,2021-04-16,1618531200.0
6639,11,3,2021-04-17,7050,53,534973,994,2021-04-17,1618617600.0
6640,11,3,2021-04-18,1905,15,536878,1009,2021-04-18,1618704000.0
6641,11,3,2021-04-19,3749,41,540627,1050,2021-04-19,1618790400.0
6642,11,3,2021-04-20,6096,83,546723,1133,2021-04-20,1618876800.0
6643,11,3,2021-04-21,5455,110,552178,1243,2021-04-21,1618963200.0
6644,11,3,2021-04-22,6173,134,558351,1377,2021-04-22,1619049600.0
6645,11,3,2021-04-23,7623,136,565974,1513,2021-04-23,1619136000.0
6646,11,3,2021-04-24,4608,120,570582,1633,2021-04-24,1619222400.0
6647,11,3,2021-04-25,1771,70,572353,1703,2021-04-25,1619308800.0
6648,11,3,2021-04-26,2873,108,575226,1811,2021-04-26,1619395200.0
6649,11,3,2021-04-27,4390,173,579616,1984,2021-04-27,1619481600.0
6650,11,3,2021-04-28,3823,240,583439,2224,2021-04-28,1619568000.0
6651,11,3,2021-04-29,5087,642,588526,2866,2021-04-29,1619654400.0
6652,11,3,2021-04-30,6491,844,595017,3710,2021-04-30,1619740800.0
6653,11,3,2021-05-01,1514,289,596531,3999,2021-05-01,1619827200.0
6654,11,3,2021-05-02,777,182,597308,4181,2021-05-02,1619913600.0
6655,11,3,2021-05-03,1824,824,599132,5005,2021-05-03,1620000000.0
6656,11,3,2021-05-04,2883,2063,602015,7068,2021-05-04,1620086400.0
6657,11,3,2021-05-05,2499,1731,604514,8799,2021-05-05,1620172800.0
6658,11,3,2021-05-06,3647,3044,608161,11843,2021-05-06,1620259200.0
6659,11,3,2021-05-07,4871,4089,613032,15932,2021-05-07,1620345600.0
6660,11,3,2021-05-08,835,2454,613867,18386,2021-05-08,1620432000.0
6661,11,3,2021-05-09,376,567,614243,18953,2021-05-09,1620518400.0
6662,11,3,2021-05-10,1941,2342,616184,21295,2021-05-10,1620604800.0
6663,11,3,2021-05-11,2968,3669,619152,24964,2021-05-11,1620691200.0
6664,11,3,2021-05-12,1920,3826,621072,28790,2021-05-12,1620777600.0
6665,11,3,2021-05-13,291,462,621363,29252,2021-05-13,1620864000.0
6666,11,3,2021-05-14,1588,3520,622951,32772,2021-05-14,1620950400.0
6667,11,3,2021-05-15,864,2881,623815,35653,2021-05-15,1621036800.0
6668,11,3,2021-05-16,150,558,623965,36211,2021-05-16,1621123200.0
6669,11,3,2021-05-17,960,3177,624925,39388,2021-05-17,1621206000.0
6670,11,3,2021-05-18,1349,4128,626274,43516,2021-05-18,1621292400.0
6671,11,3,2021-05-19,1106,6036,627380,49552,2021-05-19,1621378800.0
6672,11,3,2021-05-20,1412,6763,628792,56315,2021-05-20,1621465200.0
6673,11,3,2021-05-21,1319,8178,630111,64493,2021-05-21,1621551600.0
6674,11,3,2021-05-22,602,4486,630713,68979,2021-05-22,1621638000.0
6675,11,3,2021-05-23,67,757,630780,69736,2021-05-23,1621724400.0
6676,11,3,2021-05-24,179,832,630959,70568,2021-05-24,1621810800.0
6677,11,3,2021-05-25,779,8643,631738,79211,2021-05-25,1621897200.0
6678,11,3,2021-05-26,727,7808,632465,87019,2021-05-26,1621983600.0
6679,11,3,2021-05-27,865,11177,633330,98196,2021-05-27,1622070000.0
6680,11,3,2021-05-28,904,13468,634234,111664,2021-05-28,1622156400.0
6681,11,3,2021-05-29,455,8463,634689,120127,2021-05-29,1622242800.0
6682,11,3,2021-05-30,75,1807,634764,121934,2021-05-30,1622329200.0
6683,11,3,2021-05-31,370,5934,635134,127868,2021-05-31,1622415600.0
6684,11,3,2021-06-01,413,9452,635547,137320,2021-06-01,1622502000.0
6685,11,3,2021-06-02,413,8154,635960,145474,2021-06-02,1622588400.0
6686,11,3,2021-06-03,535,12171,636495,157645,2021-06-03,1622674800.0
6687,11,3,2021-06-04,560,13989,637055,171634,2021-06-04,1622761200.0
6688,11,3,2021-06-05,255,7635,637310,179269,2021-06-05,1622847600.0
6689,11,3,2021-06-06,61,1371,637371,180640,2021-06-06,1622934000.0
6690,11,3,2021-06-07,263,5494,637634,186134,2021-06-07,1623020400.0
6691,11,3,2021-06-08,284,7006,637918,193140,2021-06-08,1623106800.0
6692,11,3,2021-06-09,282,6597,638200,199737,2021-06-09,1623193200.0
6693,11,3,2021-06-10,291,10645,638491,210382,2021-06-10,1623279600.0
6694,11,3,2021-06-11,350,12508,638841,222890,2021-06-11,1623366000.0
6695,11,3,2021-06-12,174,6143,639015,229033,2021-06-12,1623452400.0
6696,11,3,2021-06-13,20,931,639035,229964,2021-06-13,1623538800.0
6697,11,3,2021-06-14,175,6559,639210,236523,2021-06-14,1623625200.0
6698,11,3,2021-06-15,217,12266,639427,248789,2021-06-15,1623711600.0
6699,11,3,2021-06-16,205,9407,639632,258196,2021-06-16,1623798000.0
6700,11,3,2021-06-17,259,13034,639891,271230,2021-06-17,1623884400.0
6701,11,3,2021-06-18,272,14572,640163,285802,2021-06-18,1623970800.0
6702,11,3,2021-06-19,135,5862,640298,291664,2021-06-19,1624057200.0
6703,11,3,2021-06-20,28,896,640326,292560,2021-06-20,1624143600.0
6704,11,3,2021-06-21,135,5789,640461,298349,2021-06-21,1624230000.0
6705,11,3,2021-06-22,189,9486,640650,307835,2021-06-22,1624316400.0
6706,11,3,2021-06-23,168,6897,640818,314732,2021-06-23,1624402800.0
6707,11,3,2021-06-24,212,9578,641030,324310,2021-06-24,1624489200.0
6708,11,3,2021-06-25,221,11153,641251,335463,2021-06-25,1624575600.0
6709,11,3,2021-06-26,98,5061,641349,340524,2021-06-26,1624662000.0
6710,11,3,2021-06-27,22,855,641371,341379,2021-06-27,1624748400.0
6711,11,3,2021-06-28,137,4801,641508,346180,2021-06-28,1624834800.0
6712,11,3,2021-06-29,126,7261,641634,353441,2021-06-29,1624921200.0
6713,11,3,2021-06-30,139,5998,641773,359439,2021-06-30,1625007600.0
6714,11,3,2021-07-01,213,7329,641986,366768,2021-07-01,1625094000.0
6715,11,3,2021-07-02,200,9508,642186,376276,2021-07-02,1625180400.0
6716,11,3,2021-07-03,104,3856,642290,380132,2021-07-03,1625266800.0
6717,11,3,2021-07-04,7,669,642297,380801,2021-07-04,1625353200.0
6718,11,3,2021-07-05,120,4039,642417,384840,2021-07-05,1625439600.0
6719,11,3,2021-07-06,135,6380,642552,391220,2021-07-06,1625526000.0
6720,11,4,2020-12-27,0,0,0,0,2020-12-27,1609023600.0
6721,11,4,2020-12-28,0,0,0,0,2020-12-28,1609110000.0
6722,11,4,2020-12-29,0,0,0,0,2020-12-29,1609196400.0
6723,11,4,2020-12-30,0,0,0,0,2020-12-30,1609282800.0
6724,11,4,2020-12-31,0,0,0,0,2020-12-31,1609369200.0
6725,11,4,2021-01-01,0,0,0,0,2021-01-01,1609455600.0
6726,11,4,2021-01-02,0,0,0,0,2021-01-02,1609542000.0
6727,11,4,2021-01-03,0,0,0,0,2021-01-03,1609628400.0
6728,11,4,2021-01-04,0,0,0,0,2021-01-04,1609714800.0
6729,11,4,2021-01-05,0,0,0,0,2021-01-05,1609801200.0
6730,11,4,2021-01-06,0,0,0,0,2021-01-06,1609887600.0
6731,11,4,2021-01-07,0,0,0,0,2021-01-07,1609974000.0
6732,11,4,2021-01-08,0,0,0,0,2021-01-08,1610060400.0
6733,11,4,2021-01-09,0,0,0,0,2021-01-09,1610146800.0
6734,11,4,2021-01-10,0,0,0,0,2021-01-10,1610233200.0
6735,11,4,2021-01-11,0,0,0,0,2021-01-11,1610319600.0
6736,11,4,2021-01-12,0,0,0,0,2021-01-12,1610406000.0
6737,11,4,2021-01-13,0,0,0,0,2021-01-13,1610492400.0
6738,11,4,2021-01-14,0,0,0,0,2021-01-14,1610578800.0
6739,11,4,2021-01-15,0,0,0,0,2021-01-15,1610665200.0
6740,11,4,2021-01-16,0,0,0,0,2021-01-16,1610751600.0
6741,11,4,2021-01-17,0,0,0,0,2021-01-17,1610838000.0
6742,11,4,2021-01-18,0,0,0,0,2021-01-18,1610924400.0
6743,11,4,2021-01-19,0,0,0,0,2021-01-19,1611010800.0
6744,11,4,2021-01-20,0,0,0,0,2021-01-20,1611097200.0
6745,11,4,2021-01-21,0,0,0,0,2021-01-21,1611183600.0
6746,11,4,2021-01-22,0,0,0,0,2021-01-22,1611270000.0
6747,11,4,2021-01-23,0,0,0,0,2021-01-23,1611356400.0
6748,11,4,2021-01-24,0,0,0,0,2021-01-24,1611442800.0
6749,11,4,2021-01-25,0,0,0,0,2021-01-25,1611529200.0
6750,11,4,2021-01-26,0,0,0,0,2021-01-26,1611615600.0
6751,11,4,2021-01-27,0,0,0,0,2021-01-27,1611702000.0
6752,11,4,2021-01-28,0,0,0,0,2021-01-28,1611788400.0
6753,11,4,2021-01-29,0,0,0,0,2021-01-29,1611874800.0
6754,11,4,2021-01-30,0,0,0,0,2021-01-30,1611961200.0
6755,11,4,2021-01-31,0,0,0,0,2021-01-31,1612047600.0
6756,11,4,2021-02-01,0,0,0,0,2021-02-01,1612134000.0
6757,11,4,2021-02-02,0,0,0,0,2021-02-02,1612220400.0
6758,11,4,2021-02-03,0,0,0,0,2021-02-03,1612306800.0
6759,11,4,2021-02-04,0,0,0,0,2021-02-04,1612393200.0
6760,11,4,2021-02-05,0,0,0,0,2021-02-05,1612479600.0
6761,11,4,2021-02-06,0,0,0,0,2021-02-06,1612566000.0
6762,11,4,2021-02-07,0,0,0,0,2021-02-07,1612652400.0
6763,11,4,2021-02-08,0,0,0,0,2021-02-08,1612738800.0
6764,11,4,2021-02-09,0,0,0,0,2021-02-09,1612825200.0
6765,11,4,2021-02-10,0,0,0,0,2021-02-10,1612911600.0
6766,11,4,2021-02-11,0,0,0,0,2021-02-11,1612998000.0
6767,11,4,2021-02-12,0,0,0,0,2021-02-12,1613084400.0
6768,11,4,2021-02-13,0,0,0,0,2021-02-13,1613170800.0
6769,11,4,2021-02-14,0,0,0,0,2021-02-14,1613257200.0
6770,11,4,2021-02-15,0,0,0,0,2021-02-15,1613343600.0
6771,11,4,2021-02-16,0,0,0,0,2021-02-16,1613430000.0
6772,11,4,2021-02-17,0,0,0,0,2021-02-17,1613516400.0
6773,11,4,2021-02-18,0,0,0,0,2021-02-18,1613602800.0
6774,11,4,2021-02-19,0,0,0,0,2021-02-19,1613689200.0
6775,11,4,2021-02-20,0,0,0,0,2021-02-20,1613775600.0
6776,11,4,2021-02-21,0,0,0,0,2021-02-21,1613862000.0
6777,11,4,2021-02-22,0,0,0,0,2021-02-22,1613948400.0
6778,11,4,2021-02-23,0,0,0,0,2021-02-23,1614034800.0
6779,11,4,2021-02-24,0,0,0,0,2021-02-24,1614121200.0
6780,11,4,2021-02-25,0,0,0,0,2021-02-25,1614207600.0
6781,11,4,2021-02-26,0,0,0,0,2021-02-26,1614294000.0
6782,11,4,2021-02-27,0,0,0,0,2021-02-27,1614380400.0
6783,11,4,2021-02-28,0,0,0,0,2021-02-28,1614466800.0
6784,11,4,2021-03-01,0,0,0,0,2021-03-01,1614553200.0
6785,11,4,2021-03-02,0,0,0,0,2021-03-02,1614639600.0
6786,11,4,2021-03-03,0,0,0,0,2021-03-03,1614726000.0
6787,11,4,2021-03-04,0,0,0,0,2021-03-04,1614812400.0
6788,11,4,2021-03-05,0,0,0,0,2021-03-05,1614898800.0
6789,11,4,2021-03-06,0,0,0,0,2021-03-06,1614985200.0
6790,11,4,2021-03-07,0,0,0,0,2021-03-07,1615071600.0
6791,11,4,2021-03-08,0,0,0,0,2021-03-08,1615158000.0
6792,11,4,2021-03-09,0,0,0,0,2021-03-09,1615244400.0
6793,11,4,2021-03-10,0,0,0,0,2021-03-10,1615330800.0
6794,11,4,2021-03-11,0,0,0,0,2021-03-11,1615417200.0
6795,11,4,2021-03-12,0,0,0,0,2021-03-12,1615503600.0
6796,11,4,2021-03-13,0,0,0,0,2021-03-13,1615590000.0
6797,11,4,2021-03-14,0,0,0,0,2021-03-14,1615676400.0
6798,11,4,2021-03-15,0,0,0,0,2021-03-15,1615762800.0
6799,11,4,2021-03-16,0,0,0,0,2021-03-16,1615849200.0
6800,11,4,2021-03-17,0,0,0,0,2021-03-17,1615935600.0
6801,11,4,2021-03-18,0,0,0,0,2021-03-18,1616022000.0
6802,11,4,2021-03-19,0,0,0,0,2021-03-19,1616108400.0
6803,11,4,2021-03-20,0,0,0,0,2021-03-20,1616194800.0
6804,11,4,2021-03-21,0,0,0,0,2021-03-21,1616281200.0
6805,11,4,2021-03-22,0,0,0,0,2021-03-22,1616367600.0
6806,11,4,2021-03-23,0,0,0,0,2021-03-23,1616454000.0
6807,11,4,2021-03-24,0,0,0,0,2021-03-24,1616540400.0
6808,11,4,2021-03-25,0,0,0,0,2021-03-25,1616626800.0
6809,11,4,2021-03-26,0,0,0,0,2021-03-26,1616713200.0
6810,11,4,2021-03-27,0,0,0,0,2021-03-27,1616799600.0
6811,11,4,2021-03-28,0,0,0,0,2021-03-28,1616886000.0
6812,11,4,2021-03-29,0,0,0,0,2021-03-29,1616972400.0
6813,11,4,2021-03-30,0,0,0,0,2021-03-30,1617058800.0
6814,11,4,2021-03-31,0,0,0,0,2021-03-31,1617145200.0
6815,11,4,2021-04-01,0,0,0,0,2021-04-01,1617231600.0
6816,11,4,2021-04-02,0,0,0,0,2021-04-02,1617318000.0
6817,11,4,2021-04-03,0,0,0,0,2021-04-03,1617404400.0
6818,11,4,2021-04-04,0,0,0,0,2021-04-04,1617490800.0
6819,11,4,2021-04-05,0,0,0,0,2021-04-05,1617577200.0
6820,11,4,2021-04-06,0,0,0,0,2021-04-06,1617663600.0
6821,11,4,2021-04-07,0,0,0,0,2021-04-07,1617750000.0
6822,11,4,2021-04-08,0,0,0,0,2021-04-08,1617836400.0
6823,11,4,2021-04-09,0,0,0,0,2021-04-09,1617922800.0
6824,11,4,2021-04-10,0,0,0,0,2021-04-10,1618009200.0
6825,11,4,2021-04-11,0,0,0,0,2021-04-11,1618095600.0
6826,11,4,2021-04-12,0,0,0,0,2021-04-12,1618185600.0
6827,11,4,2021-04-13,0,0,0,0,2021-04-13,1618272000.0
6828,11,4,2021-04-14,0,0,0,0,2021-04-14,1618358400.0
6829,11,4,2021-04-15,0,0,0,0,2021-04-15,1618444800.0
6830,11,4,2021-04-16,0,0,0,0,2021-04-16,1618531200.0
6831,11,4,2021-04-17,0,0,0,0,2021-04-17,1618617600.0
6832,11,4,2021-04-18,0,0,0,0,2021-04-18,1618704000.0
6833,11,4,2021-04-19,0,0,0,0,2021-04-19,1618790400.0
6834,11,4,2021-04-20,0,0,0,0,2021-04-20,1618876800.0
6835,11,4,2021-04-21,0,0,0,0,2021-04-21,1618963200.0
6836,11,4,2021-04-22,0,0,0,0,2021-04-22,1619049600.0
6837,11,4,2021-04-23,262,0,262,0,2021-04-23,1619136000.0
6838,11,4,2021-04-24,462,0,724,0,2021-04-24,1619222400.0
6839,11,4,2021-04-25,68,0,792,0,2021-04-25,1619308800.0
6840,11,4,2021-04-26,690,0,1482,0,2021-04-26,1619395200.0
6841,11,4,2021-04-27,1399,0,2881,0,2021-04-27,1619481600.0
6842,11,4,2021-04-28,1450,0,4331,0,2021-04-28,1619568000.0
6843,11,4,2021-04-29,1844,2,6175,2,2021-04-29,1619654400.0
6844,11,4,2021-04-30,1882,0,8057,2,2021-04-30,1619740800.0
6845,11,4,2021-05-01,137,3,8194,5,2021-05-01,1619827200.0
6846,11,4,2021-05-02,48,0,8242,5,2021-05-02,1619913600.0
6847,11,4,2021-05-03,593,0,8835,5,2021-05-03,1620000000.0
6848,11,4,2021-05-04,793,0,9628,5,2021-05-04,1620086400.0
6849,11,4,2021-05-05,801,2,10429,7,2021-05-05,1620172800.0
6850,11,4,2021-05-06,1190,0,11619,7,2021-05-06,1620259200.0
6851,11,4,2021-05-07,1843,1,13462,8,2021-05-07,1620345600.0
6852,11,4,2021-05-08,313,0,13775,8,2021-05-08,1620432000.0
6853,11,4,2021-05-09,294,0,14069,8,2021-05-09,1620518400.0
6854,11,4,2021-05-10,892,1,14961,9,2021-05-10,1620604800.0
6855,11,4,2021-05-11,1646,2,16607,11,2021-05-11,1620691200.0
6856,11,4,2021-05-12,1228,2,17835,13,2021-05-12,1620777600.0
6857,11,4,2021-05-13,422,1,18257,14,2021-05-13,1620864000.0
6858,11,4,2021-05-14,749,4,19006,18,2021-05-14,1620950400.0
6859,11,4,2021-05-15,484,5,19490,23,2021-05-15,1621036800.0
6860,11,4,2021-05-16,50,0,19540,23,2021-05-16,1621123200.0
6861,11,4,2021-05-17,535,0,20075,23,2021-05-17,1621206000.0
6862,11,4,2021-05-18,1054,2,21129,25,2021-05-18,1621292400.0
6863,11,4,2021-05-19,758,3,21887,28,2021-05-19,1621378800.0
6864,11,4,2021-05-20,1104,1,22991,29,2021-05-20,1621465200.0
6865,11,4,2021-05-21,1241,3,24232,32,2021-05-21,1621551600.0
6866,11,4,2021-05-22,633,0,24865,32,2021-05-22,1621638000.0
6867,11,4,2021-05-23,92,0,24957,32,2021-05-23,1621724400.0
6868,11,4,2021-05-24,201,3,25158,35,2021-05-24,1621810800.0
6869,11,4,2021-05-25,808,0,25966,35,2021-05-25,1621897200.0
6870,11,4,2021-05-26,981,1,26947,36,2021-05-26,1621983600.0
6871,11,4,2021-05-27,1618,1,28565,37,2021-05-27,1622070000.0
6872,11,4,2021-05-28,2810,28,31375,65,2021-05-28,1622156400.0
6873,11,4,2021-05-29,1558,2,32933,67,2021-05-29,1622242800.0
6874,11,4,2021-05-30,268,1,33201,68,2021-05-30,1622329200.0
6875,11,4,2021-05-31,1567,3,34768,71,2021-05-31,1622415600.0
6876,11,4,2021-06-01,2289,14,37057,85,2021-06-01,1622502000.0
6877,11,4,2021-06-02,1888,14,38945,99,2021-06-02,1622588400.0
6878,11,4,2021-06-03,2176,4,41121,103,2021-06-03,1622674800.0
6879,11,4,2021-06-04,2270,6,43391,109,2021-06-04,1622761200.0
6880,11,4,2021-06-05,1246,3,44637,112,2021-06-05,1622847600.0
6881,11,4,2021-06-06,225,0,44862,112,2021-06-06,1622934000.0
6882,11,4,2021-06-07,1204,0,46066,112,2021-06-07,1623020400.0
6883,11,4,2021-06-08,1646,4,47712,116,2021-06-08,1623106800.0
6884,11,4,2021-06-09,1534,8,49246,124,2021-06-09,1623193200.0
6885,11,4,2021-06-10,1816,4,51062,128,2021-06-10,1623279600.0
6886,11,4,2021-06-11,1802,6,52864,134,2021-06-11,1623366000.0
6887,11,4,2021-06-12,1065,6,53929,140,2021-06-12,1623452400.0
6888,11,4,2021-06-13,234,0,54163,140,2021-06-13,1623538800.0
6889,11,4,2021-06-14,899,5,55062,145,2021-06-14,1623625200.0
6890,11,4,2021-06-15,1362,5,56424,150,2021-06-15,1623711600.0
6891,11,4,2021-06-16,1220,2,57644,152,2021-06-16,1623798000.0
6892,11,4,2021-06-17,1370,2,59014,154,2021-06-17,1623884400.0
6893,11,4,2021-06-18,1431,5,60445,159,2021-06-18,1623970800.0
6894,11,4,2021-06-19,748,6,61193,165,2021-06-19,1624057200.0
6895,11,4,2021-06-20,163,2,61356,167,2021-06-20,1624143600.0
6896,11,4,2021-06-21,672,3,62028,170,2021-06-21,1624230000.0
6897,11,4,2021-06-22,877,4,62905,174,2021-06-22,1624316400.0
6898,11,4,2021-06-23,936,4,63841,178,2021-06-23,1624402800.0
6899,11,4,2021-06-24,1067,4,64908,182,2021-06-24,1624489200.0
6900,11,4,2021-06-25,1134,7,66042,189,2021-06-25,1624575600.0
6901,11,4,2021-06-26,571,0,66613,189,2021-06-26,1624662000.0
6902,11,4,2021-06-27,147,0,66760,189,2021-06-27,1624748400.0
6903,11,4,2021-06-28,721,3,67481,192,2021-06-28,1624834800.0
6904,11,4,2021-06-29,872,2,68353,194,2021-06-29,1624921200.0
6905,11,4,2021-06-30,727,12,69080,206,2021-06-30,1625007600.0
6906,11,4,2021-07-01,887,2,69967,208,2021-07-01,1625094000.0
6907,11,4,2021-07-02,935,8,70902,216,2021-07-02,1625180400.0
6908,11,4,2021-07-03,651,5,71553,221,2021-07-03,1625266800.0
6909,11,4,2021-07-04,110,0,71663,221,2021-07-04,1625353200.0
6910,11,4,2021-07-05,547,2,72210,223,2021-07-05,1625439600.0
6911,11,4,2021-07-06,784,4,72994,227,2021-07-06,1625526000.0
6912,24,1,2020-12-27,0,0,0,0,2020-12-27,1609023600.0
6913,24,1,2020-12-28,17,0,17,0,2020-12-28,1609110000.0
6914,24,1,2020-12-29,10,0,27,0,2020-12-29,1609196400.0
6915,24,1,2020-12-30,1,0,28,0,2020-12-30,1609282800.0
6916,24,1,2020-12-31,0,0,28,0,2020-12-31,1609369200.0
6917,24,1,2021-01-01,1,0,29,0,2021-01-01,1609455600.0
6918,24,1,2021-01-02,0,0,29,0,2021-01-02,1609542000.0
6919,24,1,2021-01-03,0,0,29,0,2021-01-03,1609628400.0
6920,24,1,2021-01-04,24,0,53,0,2021-01-04,1609714800.0
6921,24,1,2021-01-05,163,0,216,0,2021-01-05,1609801200.0
6922,24,1,2021-01-06,328,0,544,0,2021-01-06,1609887600.0
6923,24,1,2021-01-07,492,0,1036,0,2021-01-07,1609974000.0
6924,24,1,2021-01-08,952,0,1988,0,2021-01-08,1610060400.0
6925,24,1,2021-01-09,504,0,2492,0,2021-01-09,1610146800.0
6926,24,1,2021-01-10,395,0,2887,0,2021-01-10,1610233200.0
6927,24,1,2021-01-11,1279,0,4166,0,2021-01-11,1610319600.0
6928,24,1,2021-01-12,2575,0,6741,0,2021-01-12,1610406000.0
6929,24,1,2021-01-13,2190,0,8931,0,2021-01-13,1610492400.0
6930,24,1,2021-01-14,2504,0,11435,0,2021-01-14,1610578800.0
6931,24,1,2021-01-15,2115,0,13550,0,2021-01-15,1610665200.0
6932,24,1,2021-01-16,857,2,14407,2,2021-01-16,1610751600.0
6933,24,1,2021-01-17,322,3,14729,5,2021-01-17,1610838000.0
6934,24,1,2021-01-18,3214,13,17943,18,2021-01-18,1610924400.0
6935,24,1,2021-01-19,6325,10,24268,28,2021-01-19,1611010800.0
6936,24,1,2021-01-20,7165,5,31433,33,2021-01-20,1611097200.0
6937,24,1,2021-01-21,7418,1,38851,34,2021-01-21,1611183600.0
6938,24,1,2021-01-22,5118,1,43969,35,2021-01-22,1611270000.0
6939,24,1,2021-01-23,1276,1,45245,36,2021-01-23,1611356400.0
6940,24,1,2021-01-24,225,1,45470,37,2021-01-24,1611442800.0
6941,24,1,2021-01-25,3114,20,48584,57,2021-01-25,1611529200.0
6942,24,1,2021-01-26,4847,81,53431,138,2021-01-26,1611615600.0
6943,24,1,2021-01-27,5042,176,58473,314,2021-01-27,1611702000.0
6944,24,1,2021-01-28,5632,495,64105,809,2021-01-28,1611788400.0
6945,24,1,2021-01-29,3420,725,67525,1534,2021-01-29,1611874800.0
6946,24,1,2021-01-30,1207,397,68732,1931,2021-01-30,1611961200.0
6947,24,1,2021-01-31,251,368,68983,2299,2021-01-31,1612047600.0
6948,24,1,2021-02-01,2169,925,71152,3224,2021-02-01,1612134000.0
6949,24,1,2021-02-02,3032,1887,74184,5111,2021-02-02,1612220400.0
6950,24,1,2021-02-03,3111,1766,77295,6877,2021-02-03,1612306800.0
6951,24,1,2021-02-04,3234,1611,80529,8488,2021-02-04,1612393200.0
6952,24,1,2021-02-05,2394,1364,82923,9852,2021-02-05,1612479600.0
6953,24,1,2021-02-06,698,262,83621,10114,2021-02-06,1612566000.0
6954,24,1,2021-02-07,114,31,83735,10145,2021-02-07,1612652400.0
6955,24,1,2021-02-08,1773,1560,85508,11705,2021-02-08,1612738800.0
6956,24,1,2021-02-09,3054,3287,88562,14992,2021-02-09,1612825200.0
6957,24,1,2021-02-10,3640,3735,92202,18727,2021-02-10,1612911600.0
6958,24,1,2021-02-11,4063,4744,96265,23471,2021-02-11,1612998000.0
6959,24,1,2021-02-12,2920,3255,99185,26726,2021-02-12,1613084400.0
6960,24,1,2021-02-13,613,766,99798,27492,2021-02-13,1613170800.0
6961,24,1,2021-02-14,168,250,99966,27742,2021-02-14,1613257200.0
6962,24,1,2021-02-15,1276,2838,101242,30580,2021-02-15,1613343600.0
6963,24,1,2021-02-16,2092,4473,103334,35053,2021-02-16,1613430000.0
6964,24,1,2021-02-17,2152,5068,105486,40121,2021-02-17,1613516400.0
6965,24,1,2021-02-18,2799,5131,108285,45252,2021-02-18,1613602800.0
6966,24,1,2021-02-19,2415,3538,110700,48790,2021-02-19,1613689200.0
6967,24,1,2021-02-20,938,981,111638,49771,2021-02-20,1613775600.0
6968,24,1,2021-02-21,249,238,111887,50009,2021-02-21,1613862000.0
6969,24,1,2021-02-22,1130,3053,113017,53062,2021-02-22,1613948400.0
6970,24,1,2021-02-23,1801,3130,114818,56192,2021-02-23,1614034800.0
6971,24,1,2021-02-24,1441,3456,116259,59648,2021-02-24,1614121200.0
6972,24,1,2021-02-25,1784,3138,118043,62786,2021-02-25,1614207600.0
6973,24,1,2021-02-26,1659,2594,119702,65380,2021-02-26,1614294000.0
6974,24,1,2021-02-27,502,979,120204,66359,2021-02-27,1614380400.0
6975,24,1,2021-02-28,47,219,120251,66578,2021-02-28,1614466800.0
6976,24,1,2021-03-01,1385,2003,121636,68581,2021-03-01,1614553200.0
6977,24,1,2021-03-02,2132,2863,123768,71444,2021-03-02,1614639600.0
6978,24,1,2021-03-03,2096,3386,125864,74830,2021-03-03,1614726000.0
6979,24,1,2021-03-04,2584,3635,128448,78465,2021-03-04,1614812400.0
6980,24,1,2021-03-05,2837,3085,131285,81550,2021-03-05,1614898800.0
6981,24,1,2021-03-06,1997,689,133282,82239,2021-03-06,1614985200.0
6982,24,1,2021-03-07,909,268,134191,82507,2021-03-07,1615071600.0
6983,24,1,2021-03-08,1175,2463,135366,84970,2021-03-08,1615158000.0
6984,24,1,2021-03-09,2824,2695,138190,87665,2021-03-09,1615244400.0
6985,24,1,2021-03-10,3644,3304,141834,90969,2021-03-10,1615330800.0
6986,24,1,2021-03-11,3689,3237,145523,94206,2021-03-11,1615417200.0
6987,24,1,2021-03-12,4047,2389,149570,96595,2021-03-12,1615503600.0
6988,24,1,2021-03-13,1173,514,150743,97109,2021-03-13,1615590000.0
6989,24,1,2021-03-14,581,162,151324,97271,2021-03-14,1615676400.0
6990,24,1,2021-03-15,2281,1777,153605,99048,2021-03-15,1615762800.0
6991,24,1,2021-03-16,3776,2088,157381,101136,2021-03-16,1615849200.0
6992,24,1,2021-03-17,3984,1848,161365,102984,2021-03-17,1615935600.0
6993,24,1,2021-03-18,4004,1887,165369,104871,2021-03-18,1616022000.0
6994,24,1,2021-03-19,4201,1406,169570,106277,2021-03-19,1616108400.0
6995,24,1,2021-03-20,1069,725,170639,107002,2021-03-20,1616194800.0
6996,24,1,2021-03-21,102,243,170741,107245,2021-03-21,1616281200.0
6997,24,1,2021-03-22,3160,1384,173901,108629,2021-03-22,1616367600.0
6998,24,1,2021-03-23,4442,1970,178343,110599,2021-03-23,1616454000.0
6999,24,1,2021-03-24,4805,1636,183148,112235,2021-03-24,1616540400.0
7000,24,1,2021-03-25,5250,1510,188398,113745,2021-03-25,1616626800.0
7001,24,1,2021-03-26,5458,1327,193856,115072,2021-03-26,1616713200.0
7002,24,1,2021-03-27,2453,472,196309,115544,2021-03-27,1616799600.0
7003,24,1,2021-03-28,156,97,196465,115641,2021-03-28,1616886000.0
7004,24,1,2021-03-29,4288,1615,200753,117256,2021-03-29,1616972400.0
7005,24,1,2021-03-30,5300,2453,206053,119709,2021-03-30,1617058800.0
7006,24,1,2021-03-31,6942,2004,212995,121713,2021-03-31,1617145200.0
7007,24,1,2021-04-01,7199,2866,220194,124579,2021-04-01,1617231600.0
7008,24,1,2021-04-02,6199,2816,226393,127395,2021-04-02,1617318000.0
7009,24,1,2021-04-03,1437,1606,227830,129001,2021-04-03,1617404400.0
7010,24,1,2021-04-04,159,328,227989,129329,2021-04-04,1617490800.0
7011,24,1,2021-04-05,150,45,228139,129374,2021-04-05,1617577200.0
7012,24,1,2021-04-06,6025,3069,234164,132443,2021-04-06,1617663600.0
7013,24,1,2021-04-07,8676,4075,242840,136518,2021-04-07,1617750000.0
7014,24,1,2021-04-08,9027,4129,251867,140647,2021-04-08,1617836400.0
7015,24,1,2021-04-09,8584,3139,260451,143786,2021-04-09,1617922800.0
7016,24,1,2021-04-10,3861,1137,264312,144923,2021-04-10,1618009200.0
7017,24,1,2021-04-11,823,591,265135,145514,2021-04-11,1618095600.0
7018,24,1,2021-04-12,7869,2675,273004,148189,2021-04-12,1618185600.0
7019,24,1,2021-04-13,9138,3802,282142,151991,2021-04-13,1618272000.0
7020,24,1,2021-04-14,9577,4196,291719,156187,2021-04-14,1618358400.0
7021,24,1,2021-04-15,9480,3850,301199,160037,2021-04-15,1618444800.0
7022,24,1,2021-04-16,8815,3372,310014,163409,2021-04-16,1618531200.0
7023,24,1,2021-04-17,4879,928,314893,164337,2021-04-17,1618617600.0
7024,24,1,2021-04-18,567,39,315460,164376,2021-04-18,1618704000.0
7025,24,1,2021-04-19,7868,3329,323328,167705,2021-04-19,1618790400.0
7026,24,1,2021-04-20,9502,4814,332830,172519,2021-04-20,1618876800.0
7027,24,1,2021-04-21,9774,5000,342604,177519,2021-04-21,1618963200.0
7028,24,1,2021-04-22,10523,5953,353127,183472,2021-04-22,1619049600.0
7029,24,1,2021-04-23,9120,5351,362247,188823,2021-04-23,1619136000.0
7030,24,1,2021-04-24,7047,2271,369294,191094,2021-04-24,1619222400.0
7031,24,1,2021-04-25,2743,206,372037,191300,2021-04-25,1619308800.0
7032,24,1,2021-04-26,8827,4477,380864,195777,2021-04-26,1619395200.0
7033,24,1,2021-04-27,10346,5332,391210,201109,2021-04-27,1619481600.0
7034,24,1,2021-04-28,10537,6868,401747,207977,2021-04-28,1619568000.0
7035,24,1,2021-04-29,12756,5880,414503,213857,2021-04-29,1619654400.0
7036,24,1,2021-04-30,12739,4358,427242,218215,2021-04-30,1619740800.0
7037,24,1,2021-05-01,1969,294,429211,218509,2021-05-01,1619827200.0
7038,24,1,2021-05-02,1788,199,430999,218708,2021-05-02,1619913600.0
7039,24,1,2021-05-03,9876,4816,440875,223524,2021-05-03,1620000000.0
7040,24,1,2021-05-04,10065,8352,450940,231876,2021-05-04,1620086400.0
7041,24,1,2021-05-05,11827,7507,462767,239383,2021-05-05,1620172800.0
7042,24,1,2021-05-06,14007,6420,476774,245803,2021-05-06,1620259200.0
7043,24,1,2021-05-07,10127,8115,486901,253918,2021-05-07,1620345600.0
7044,24,1,2021-05-08,2827,1089,489728,255007,2021-05-08,1620432000.0
7045,24,1,2021-05-09,2155,1367,491883,256374,2021-05-09,1620518400.0
7046,24,1,2021-05-10,8793,9868,500676,266242,2021-05-10,1620604800.0
7047,24,1,2021-05-11,11970,10553,512646,276795,2021-05-11,1620691200.0
7048,24,1,2021-05-12,14977,9840,527623,286635,2021-05-12,1620777600.0
7049,24,1,2021-05-13,6129,2734,533752,289369,2021-05-13,1620864000.0
7050,24,1,2021-05-14,10907,6795,544659,296164,2021-05-14,1620950400.0
7051,24,1,2021-05-15,7190,3531,551849,299695,2021-05-15,1621036800.0
7052,24,1,2021-05-16,3120,638,554969,300333,2021-05-16,1621123200.0
7053,24,1,2021-05-17,11119,5740,566088,306073,2021-05-17,1621206000.0
7054,24,1,2021-05-18,14883,5488,580971,311561,2021-05-18,1621292400.0
7055,24,1,2021-05-19,16245,4826,597216,316387,2021-05-19,1621378800.0
7056,24,1,2021-05-20,17677,4484,614893,320871,2021-05-20,1621465200.0
7057,24,1,2021-05-21,14219,4710,629112,325581,2021-05-21,1621551600.0
7058,24,1,2021-05-22,6141,2298,635253,327879,2021-05-22,1621638000.0
7059,24,1,2021-05-23,2461,668,637714,328547,2021-05-23,1621724400.0
7060,24,1,2021-05-24,8228,1061,645942,329608,2021-05-24,1621810800.0
7061,24,1,2021-05-25,15804,5318,661746,334926,2021-05-25,1621897200.0
7062,24,1,2021-05-26,17927,5149,679673,340075,2021-05-26,1621983600.0
7063,24,1,2021-05-27,18601,5340,698274,345415,2021-05-27,1622070000.0
7064,24,1,2021-05-28,16922,5382,715196,350797,2021-05-28,1622156400.0
7065,24,1,2021-05-29,7578,1487,722774,352284,2021-05-29,1622242800.0
7066,24,1,2021-05-30,708,841,723482,353125,2021-05-30,1622329200.0
7067,24,1,2021-05-31,12798,6326,736280,359451,2021-05-31,1622415600.0
7068,24,1,2021-06-01,16190,6926,752470,366377,2021-06-01,1622502000.0
7069,24,1,2021-06-02,15501,7082,767971,373459,2021-06-02,1622588400.0
7070,24,1,2021-06-03,17663,6564,785634,380023,2021-06-03,1622674800.0
7071,24,1,2021-06-04,16115,7000,801749,387023,2021-06-04,1622761200.0
7072,24,1,2021-06-05,7893,4830,809642,391853,2021-06-05,1622847600.0
7073,24,1,2021-06-06,1875,2417,811517,394270,2021-06-06,1622934000.0
7074,24,1,2021-06-07,13321,8938,824838,403208,2021-06-07,1623020400.0
7075,24,1,2021-06-08,13532,10263,838370,413471,2021-06-08,1623106800.0
7076,24,1,2021-06-09,14713,9157,853083,422628,2021-06-09,1623193200.0
7077,24,1,2021-06-10,15598,7912,868681,430540,2021-06-10,1623279600.0
7078,24,1,2021-06-11,14179,9053,882860,439593,2021-06-11,1623366000.0
7079,24,1,2021-06-12,8124,3244,890984,442837,2021-06-12,1623452400.0
7080,24,1,2021-06-13,815,805,891799,443642,2021-06-13,1623538800.0
7081,24,1,2021-06-14,9026,12185,900825,455827,2021-06-14,1623625200.0
7082,24,1,2021-06-15,10566,11625,911391,467452,2021-06-15,1623711600.0
7083,24,1,2021-06-16,11789,11634,923180,479086,2021-06-16,1623798000.0
7084,24,1,2021-06-17,10965,10600,934145,489686,2021-06-17,1623884400.0
7085,24,1,2021-06-18,12052,12417,946197,502103,2021-06-18,1623970800.0
7086,24,1,2021-06-19,6387,3779,952584,505882,2021-06-19,1624057200.0
7087,24,1,2021-06-20,489,498,953073,506380,2021-06-20,1624143600.0
7088,24,1,2021-06-21,7897,12483,960970,518863,2021-06-21,1624230000.0
7089,24,1,2021-06-22,8499,13159,969469,532022,2021-06-22,1624316400.0
7090,24,1,2021-06-23,8498,12896,977967,544918,2021-06-23,1624402800.0
7091,24,1,2021-06-24,7438,7664,985405,552582,2021-06-24,1624489200.0
7092,24,1,2021-06-25,8435,12070,993840,564652,2021-06-25,1624575600.0
7093,24,1,2021-06-26,3888,5860,997728,570512,2021-06-26,1624662000.0
7094,24,1,2021-06-27,709,1848,998437,572360,2021-06-27,1624748400.0
7095,24,1,2021-06-28,5878,14803,1004315,587163,2021-06-28,1624834800.0
7096,24,1,2021-06-29,6689,16995,1011004,604158,2021-06-29,1624921200.0
7097,24,1,2021-06-30,7176,16509,1018180,620667,2021-06-30,1625007600.0
7098,24,1,2021-07-01,6810,13013,1024990,633680,2021-07-01,1625094000.0
7099,24,1,2021-07-02,6806,14593,1031796,648273,2021-07-02,1625180400.0
7100,24,1,2021-07-03,3431,7351,1035227,655624,2021-07-03,1625266800.0
7101,24,1,2021-07-04,426,1782,1035653,657406,2021-07-04,1625353200.0
7102,24,1,2021-07-05,6185,15024,1041838,672430,2021-07-05,1625439600.0
7103,24,1,2021-07-06,6967,17321,1048805,689751,2021-07-06,1625526000.0
7104,24,2,2020-12-27,0,0,0,0,2020-12-27,1609023600.0
7105,24,2,2020-12-28,0,0,0,0,2020-12-28,1609110000.0
7106,24,2,2020-12-29,0,0,0,0,2020-12-29,1609196400.0
7107,24,2,2020-12-30,0,0,0,0,2020-12-30,1609282800.0
7108,24,2,2020-12-31,0,0,0,0,2020-12-31,1609369200.0
7109,24,2,2021-01-01,0,0,0,0,2021-01-01,1609455600.0
7110,24,2,2021-01-02,0,0,0,0,2021-01-02,1609542000.0
7111,24,2,2021-01-03,0,0,0,0,2021-01-03,1609628400.0
7112,24,2,2021-01-04,0,0,0,0,2021-01-04,1609714800.0
7113,24,2,2021-01-05,0,0,0,0,2021-01-05,1609801200.0
7114,24,2,2021-01-06,0,0,0,0,2021-01-06,1609887600.0
7115,24,2,2021-01-07,0,0,0,0,2021-01-07,1609974000.0
7116,24,2,2021-01-08,0,0,0,0,2021-01-08,1610060400.0
7117,24,2,2021-01-09,0,0,0,0,2021-01-09,1610146800.0
7118,24,2,2021-01-10,0,0,0,0,2021-01-10,1610233200.0
7119,24,2,2021-01-11,0,0,0,0,2021-01-11,1610319600.0
7120,24,2,2021-01-12,0,0,0,0,2021-01-12,1610406000.0
7121,24,2,2021-01-13,0,0,0,0,2021-01-13,1610492400.0
7122,24,2,2021-01-14,0,0,0,0,2021-01-14,1610578800.0
7123,24,2,2021-01-15,0,0,0,0,2021-01-15,1610665200.0
7124,24,2,2021-01-16,0,0,0,0,2021-01-16,1610751600.0
7125,24,2,2021-01-17,0,0,0,0,2021-01-17,1610838000.0
7126,24,2,2021-01-18,0,0,0,0,2021-01-18,1610924400.0
7127,24,2,2021-01-19,0,0,0,0,2021-01-19,1611010800.0
7128,24,2,2021-01-20,0,0,0,0,2021-01-20,1611097200.0
7129,24,2,2021-01-21,0,0,0,0,2021-01-21,1611183600.0
7130,24,2,2021-01-22,2,0,2,0,2021-01-22,1611270000.0
7131,24,2,2021-01-23,0,0,2,0,2021-01-23,1611356400.0
7132,24,2,2021-01-24,0,0,2,0,2021-01-24,1611442800.0
7133,24,2,2021-01-25,0,0,2,0,2021-01-25,1611529200.0
7134,24,2,2021-01-26,1,0,3,0,2021-01-26,1611615600.0
7135,24,2,2021-01-27,3,0,6,0,2021-01-27,1611702000.0
7136,24,2,2021-01-28,2,0,8,0,2021-01-28,1611788400.0
7137,24,2,2021-01-29,3,0,11,0,2021-01-29,1611874800.0
7138,24,2,2021-01-30,1,0,12,0,2021-01-30,1611961200.0
7139,24,2,2021-01-31,0,0,12,0,2021-01-31,1612047600.0
7140,24,2,2021-02-01,1,0,13,0,2021-02-01,1612134000.0
7141,24,2,2021-02-02,0,0,13,0,2021-02-02,1612220400.0
7142,24,2,2021-02-03,0,0,13,0,2021-02-03,1612306800.0
7143,24,2,2021-02-04,0,0,13,0,2021-02-04,1612393200.0
7144,24,2,2021-02-05,0,0,13,0,2021-02-05,1612479600.0
7145,24,2,2021-02-06,0,0,13,0,2021-02-06,1612566000.0
7146,24,2,2021-02-07,0,0,13,0,2021-02-07,1612652400.0
7147,24,2,2021-02-08,120,0,133,0,2021-02-08,1612738800.0
7148,24,2,2021-02-09,30,0,163,0,2021-02-09,1612825200.0
7149,24,2,2021-02-10,168,0,331,0,2021-02-10,1612911600.0
7150,24,2,2021-02-11,197,1,528,1,2021-02-11,1612998000.0
7151,24,2,2021-02-12,215,1,743,2,2021-02-12,1613084400.0
7152,24,2,2021-02-13,127,0,870,2,2021-02-13,1613170800.0
7153,24,2,2021-02-14,101,0,971,2,2021-02-14,1613257200.0
7154,24,2,2021-02-15,167,0,1138,2,2021-02-15,1613343600.0
7155,24,2,2021-02-16,260,0,1398,2,2021-02-16,1613430000.0
7156,24,2,2021-02-17,137,3,1535,5,2021-02-17,1613516400.0
7157,24,2,2021-02-18,276,1,1811,6,2021-02-18,1613602800.0
7158,24,2,2021-02-19,304,5,2115,11,2021-02-19,1613689200.0
7159,24,2,2021-02-20,187,0,2302,11,2021-02-20,1613775600.0
7160,24,2,2021-02-21,105,0,2407,11,2021-02-21,1613862000.0
7161,24,2,2021-02-22,266,1,2673,12,2021-02-22,1613948400.0
7162,24,2,2021-02-23,268,3,2941,15,2021-02-23,1614034800.0
7163,24,2,2021-02-24,244,1,3185,16,2021-02-24,1614121200.0
7164,24,2,2021-02-25,308,1,3493,17,2021-02-25,1614207600.0
7165,24,2,2021-02-26,544,2,4037,19,2021-02-26,1614294000.0
7166,24,2,2021-02-27,153,0,4190,19,2021-02-27,1614380400.0
7167,24,2,2021-02-28,0,0,4190,19,2021-02-28,1614466800.0
7168,24,2,2021-03-01,171,0,4361,19,2021-03-01,1614553200.0
7169,24,2,2021-03-02,176,0,4537,19,2021-03-02,1614639600.0
7170,24,2,2021-03-03,177,0,4714,19,2021-03-03,1614726000.0
7171,24,2,2021-03-04,233,0,4947,19,2021-03-04,1614812400.0
7172,24,2,2021-03-05,310,1,5257,20,2021-03-05,1614898800.0
7173,24,2,2021-03-06,72,0,5329,20,2021-03-06,1614985200.0
7174,24,2,2021-03-07,0,0,5329,20,2021-03-07,1615071600.0
7175,24,2,2021-03-08,153,128,5482,148,2021-03-08,1615158000.0
7176,24,2,2021-03-09,163,64,5645,212,2021-03-09,1615244400.0
7177,24,2,2021-03-10,294,164,5939,376,2021-03-10,1615330800.0
7178,24,2,2021-03-11,316,184,6255,560,2021-03-11,1615417200.0
7179,24,2,2021-03-12,278,193,6533,753,2021-03-12,1615503600.0
7180,24,2,2021-03-13,797,165,7330,918,2021-03-13,1615590000.0
7181,24,2,2021-03-14,635,101,7965,1019,2021-03-14,1615676400.0
7182,24,2,2021-03-15,593,168,8558,1187,2021-03-15,1615762800.0
7183,24,2,2021-03-16,781,234,9339,1421,2021-03-16,1615849200.0
7184,24,2,2021-03-17,457,113,9796,1534,2021-03-17,1615935600.0
7185,24,2,2021-03-18,1032,155,10828,1689,2021-03-18,1616022000.0
7186,24,2,2021-03-19,642,192,11470,1881,2021-03-19,1616108400.0
7187,24,2,2021-03-20,288,114,11758,1995,2021-03-20,1616194800.0
7188,24,2,2021-03-21,253,101,12011,2096,2021-03-21,1616281200.0
7189,24,2,2021-03-22,617,249,12628,2345,2021-03-22,1616367600.0
7190,24,2,2021-03-23,952,242,13580,2587,2021-03-23,1616454000.0
7191,24,2,2021-03-24,738,268,14318,2855,2021-03-24,1616540400.0
7192,24,2,2021-03-25,1252,328,15570,3183,2021-03-25,1616626800.0
7193,24,2,2021-03-26,1257,502,16827,3685,2021-03-26,1616713200.0
7194,24,2,2021-03-27,748,159,17575,3844,2021-03-27,1616799600.0
7195,24,2,2021-03-28,170,0,17745,3844,2021-03-28,1616886000.0
7196,24,2,2021-03-29,723,175,18468,4019,2021-03-29,1616972400.0
7197,24,2,2021-03-30,1666,189,20134,4208,2021-03-30,1617058800.0
7198,24,2,2021-03-31,846,191,20980,4399,2021-03-31,1617145200.0
7199,24,2,2021-04-01,1532,252,22512,4651,2021-04-01,1617231600.0
7200,24,2,2021-04-02,1278,306,23790,4957,2021-04-02,1617318000.0
7201,24,2,2021-04-03,218,69,24008,5026,2021-04-03,1617404400.0
7202,24,2,2021-04-04,71,10,24079,5036,2021-04-04,1617490800.0
7203,24,2,2021-04-05,187,0,24266,5036,2021-04-05,1617577200.0
7204,24,2,2021-04-06,1075,215,25341,5251,2021-04-06,1617663600.0
7205,24,2,2021-04-07,1075,282,26416,5533,2021-04-07,1617750000.0
7206,24,2,2021-04-08,1750,354,28166,5887,2021-04-08,1617836400.0
7207,24,2,2021-04-09,1479,267,29645,6154,2021-04-09,1617922800.0
7208,24,2,2021-04-10,1373,797,31018,6951,2021-04-10,1618009200.0
7209,24,2,2021-04-11,1921,597,32939,7548,2021-04-11,1618095600.0
7210,24,2,2021-04-12,854,598,33793,8146,2021-04-12,1618185600.0
7211,24,2,2021-04-13,1428,765,35221,8911,2021-04-13,1618272000.0
7212,24,2,2021-04-14,745,478,35966,9389,2021-04-14,1618358400.0
7213,24,2,2021-04-15,1356,1014,37322,10403,2021-04-15,1618444800.0
7214,24,2,2021-04-16,1400,663,38722,11066,2021-04-16,1618531200.0
7215,24,2,2021-04-17,625,262,39347,11328,2021-04-17,1618617600.0
7216,24,2,2021-04-18,329,226,39676,11554,2021-04-18,1618704000.0
7217,24,2,2021-04-19,441,566,40117,12120,2021-04-19,1618790400.0
7218,24,2,2021-04-20,888,872,41005,12992,2021-04-20,1618876800.0
7219,24,2,2021-04-21,465,659,41470,13651,2021-04-21,1618963200.0
7220,24,2,2021-04-22,866,1200,42336,14851,2021-04-22,1619049600.0
7221,24,2,2021-04-23,810,1291,43146,16142,2021-04-23,1619136000.0
7222,24,2,2021-04-24,442,710,43588,16852,2021-04-24,1619222400.0
7223,24,2,2021-04-25,216,167,43804,17019,2021-04-25,1619308800.0
7224,24,2,2021-04-26,358,632,44162,17651,2021-04-26,1619395200.0
7225,24,2,2021-04-27,884,1615,45046,19266,2021-04-27,1619481600.0
7226,24,2,2021-04-28,520,810,45566,20076,2021-04-28,1619568000.0
7227,24,2,2021-04-29,767,1453,46333,21529,2021-04-29,1619654400.0
7228,24,2,2021-04-30,590,1269,46923,22798,2021-04-30,1619740800.0
7229,24,2,2021-05-01,317,154,47240,22952,2021-05-01,1619827200.0
7230,24,2,2021-05-02,224,7,47464,22959,2021-05-02,1619913600.0
7231,24,2,2021-05-03,478,617,47942,23576,2021-05-03,1620000000.0
7232,24,2,2021-05-04,1078,1119,49020,24695,2021-05-04,1620086400.0
7233,24,2,2021-05-05,569,1020,49589,25715,2021-05-05,1620172800.0
7234,24,2,2021-05-06,660,1665,50249,27380,2021-05-06,1620259200.0
7235,24,2,2021-05-07,609,1466,50858,28846,2021-05-07,1620345600.0
7236,24,2,2021-05-08,24,754,50882,29600,2021-05-08,1620432000.0
7237,24,2,2021-05-09,71,2204,50953,31804,2021-05-09,1620518400.0
7238,24,2,2021-05-10,1450,1111,52403,32915,2021-05-10,1620604800.0
7239,24,2,2021-05-11,1759,1314,54162,34229,2021-05-11,1620691200.0
7240,24,2,2021-05-12,1767,1347,55929,35576,2021-05-12,1620777600.0
7241,24,2,2021-05-13,540,0,56469,35576,2021-05-13,1620864000.0
7242,24,2,2021-05-14,2398,594,58867,36170,2021-05-14,1620950400.0
7243,24,2,2021-05-15,2637,339,61504,36509,2021-05-15,1621036800.0
7244,24,2,2021-05-16,18,309,61522,36818,2021-05-16,1621123200.0
7245,24,2,2021-05-17,1662,521,63184,37339,2021-05-17,1621206000.0
7246,24,2,2021-05-18,2094,647,65278,37986,2021-05-18,1621292400.0
7247,24,2,2021-05-19,1958,384,67236,38370,2021-05-19,1621378800.0
7248,24,2,2021-05-20,2339,540,69575,38910,2021-05-20,1621465200.0
7249,24,2,2021-05-21,2822,641,72397,39551,2021-05-21,1621551600.0
7250,24,2,2021-05-22,1006,8,73403,39559,2021-05-22,1621638000.0
7251,24,2,2021-05-23,366,7,73769,39566,2021-05-23,1621724400.0
7252,24,2,2021-05-24,1,0,73770,39566,2021-05-24,1621810800.0
7253,24,2,2021-05-25,1297,852,75067,40418,2021-05-25,1621897200.0
7254,24,2,2021-05-26,818,523,75885,40941,2021-05-26,1621983600.0
7255,24,2,2021-05-27,1283,778,77168,41719,2021-05-27,1622070000.0
7256,24,2,2021-05-28,1836,613,79004,42332,2021-05-28,1622156400.0
7257,24,2,2021-05-29,4056,438,83060,42770,2021-05-29,1622242800.0
7258,24,2,2021-05-30,1264,48,84324,42818,2021-05-30,1622329200.0
7259,24,2,2021-05-31,1156,267,85480,43085,2021-05-31,1622415600.0
7260,24,2,2021-06-01,2246,621,87726,43706,2021-06-01,1622502000.0
7261,24,2,2021-06-02,1602,249,89328,43955,2021-06-02,1622588400.0
7262,24,2,2021-06-03,2169,517,91497,44472,2021-06-03,1622674800.0
7263,24,2,2021-06-04,2623,610,94120,45082,2021-06-04,1622761200.0
7264,24,2,2021-06-05,1339,370,95459,45452,2021-06-05,1622847600.0
7265,24,2,2021-06-06,81,208,95540,45660,2021-06-06,1622934000.0
7266,24,2,2021-06-07,685,589,96225,46249,2021-06-07,1623020400.0
7267,24,2,2021-06-08,1646,1167,97871,47416,2021-06-08,1623106800.0
7268,24,2,2021-06-09,1051,460,98922,47876,2021-06-09,1623193200.0
7269,24,2,2021-06-10,1520,462,100442,48338,2021-06-10,1623279600.0
7270,24,2,2021-06-11,2017,488,102459,48826,2021-06-11,1623366000.0
7271,24,2,2021-06-12,1517,988,103976,49814,2021-06-12,1623452400.0
7272,24,2,2021-06-13,54,217,104030,50031,2021-06-13,1623538800.0
7273,24,2,2021-06-14,1092,723,105122,50754,2021-06-14,1623625200.0
7274,24,2,2021-06-15,1952,978,107074,51732,2021-06-15,1623711600.0
7275,24,2,2021-06-16,1273,535,108347,52267,2021-06-16,1623798000.0
7276,24,2,2021-06-17,1650,762,109997,53029,2021-06-17,1623884400.0
7277,24,2,2021-06-18,1916,946,111913,53975,2021-06-18,1623970800.0
7278,24,2,2021-06-19,1250,192,113163,54167,2021-06-19,1624057200.0
7279,24,2,2021-06-20,43,103,113206,54270,2021-06-20,1624143600.0
7280,24,2,2021-06-21,628,1508,113834,55778,2021-06-21,1624230000.0
7281,24,2,2021-06-22,1203,1920,115037,57698,2021-06-22,1624316400.0
7282,24,2,2021-06-23,796,1526,115833,59224,2021-06-23,1624402800.0
7283,24,2,2021-06-24,1121,688,116954,59912,2021-06-24,1624489200.0
7284,24,2,2021-06-25,1682,2570,118636,62482,2021-06-25,1624575600.0
7285,24,2,2021-06-26,1154,2270,119790,64752,2021-06-26,1624662000.0
7286,24,2,2021-06-27,43,12,119833,64764,2021-06-27,1624748400.0
7287,24,2,2021-06-28,396,1799,120229,66563,2021-06-28,1624834800.0
7288,24,2,2021-06-29,864,2941,121093,69504,2021-06-29,1624921200.0
7289,24,2,2021-06-30,661,2180,121754,71684,2021-06-30,1625007600.0
7290,24,2,2021-07-01,537,2267,122291,73951,2021-07-01,1625094000.0
7291,24,2,2021-07-02,933,2838,123224,76789,2021-07-02,1625180400.0
7292,24,2,2021-07-03,519,1461,123743,78250,2021-07-03,1625266800.0
7293,24,2,2021-07-04,39,684,123782,78934,2021-07-04,1625353200.0
7294,24,2,2021-07-05,247,798,124029,79732,2021-07-05,1625439600.0
7295,24,2,2021-07-06,604,2067,124633,81799,2021-07-06,1625526000.0
7296,24,3,2020-12-27,0,0,0,0,2020-12-27,1609023600.0
7297,24,3,2020-12-28,0,0,0,0,2020-12-28,1609110000.0
7298,24,3,2020-12-29,0,0,0,0,2020-12-29,1609196400.0
7299,24,3,2020-12-30,0,0,0,0,2020-12-30,1609282800.0
7300,24,3,2020-12-31,0,0,0,0,2020-12-31,1609369200.0
7301,24,3,2021-01-01,0,0,0,0,2021-01-01,1609455600.0
7302,24,3,2021-01-02,0,0,0,0,2021-01-02,1609542000.0
7303,24,3,2021-01-03,0,0,0,0,2021-01-03,1609628400.0
7304,24,3,2021-01-04,0,0,0,0,2021-01-04,1609714800.0
7305,24,3,2021-01-05,0,0,0,0,2021-01-05,1609801200.0
7306,24,3,2021-01-06,0,0,0,0,2021-01-06,1609887600.0
7307,24,3,2021-01-07,0,0,0,0,2021-01-07,1609974000.0
7308,24,3,2021-01-08,0,0,0,0,2021-01-08,1610060400.0
7309,24,3,2021-01-09,0,0,0,0,2021-01-09,1610146800.0
7310,24,3,2021-01-10,0,0,0,0,2021-01-10,1610233200.0
7311,24,3,2021-01-11,0,0,0,0,2021-01-11,1610319600.0
7312,24,3,2021-01-12,0,0,0,0,2021-01-12,1610406000.0
7313,24,3,2021-01-13,0,0,0,0,2021-01-13,1610492400.0
7314,24,3,2021-01-14,0,0,0,0,2021-01-14,1610578800.0
7315,24,3,2021-01-15,0,0,0,0,2021-01-15,1610665200.0
7316,24,3,2021-01-16,0,0,0,0,2021-01-16,1610751600.0
7317,24,3,2021-01-17,0,0,0,0,2021-01-17,1610838000.0
7318,24,3,2021-01-18,0,0,0,0,2021-01-18,1610924400.0
7319,24,3,2021-01-19,0,0,0,0,2021-01-19,1611010800.0
7320,24,3,2021-01-20,0,0,0,0,2021-01-20,1611097200.0
7321,24,3,2021-01-21,0,0,0,0,2021-01-21,1611183600.0
7322,24,3,2021-01-22,0,0,0,0,2021-01-22,1611270000.0
7323,24,3,2021-01-23,0,0,0,0,2021-01-23,1611356400.0
7324,24,3,2021-01-24,0,0,0,0,2021-01-24,1611442800.0
7325,24,3,2021-01-25,0,0,0,0,2021-01-25,1611529200.0
7326,24,3,2021-01-26,0,0,0,0,2021-01-26,1611615600.0
7327,24,3,2021-01-27,0,0,0,0,2021-01-27,1611702000.0
7328,24,3,2021-01-28,0,0,0,0,2021-01-28,1611788400.0
7329,24,3,2021-01-29,0,0,0,0,2021-01-29,1611874800.0
7330,24,3,2021-01-30,0,0,0,0,2021-01-30,1611961200.0
7331,24,3,2021-01-31,0,0,0,0,2021-01-31,1612047600.0
7332,24,3,2021-02-01,0,0,0,0,2021-02-01,1612134000.0
7333,24,3,2021-02-02,0,0,0,0,2021-02-02,1612220400.0
7334,24,3,2021-02-03,0,0,0,0,2021-02-03,1612306800.0
7335,24,3,2021-02-04,0,0,0,0,2021-02-04,1612393200.0
7336,24,3,2021-02-05,0,0,0,0,2021-02-05,1612479600.0
7337,24,3,2021-02-06,9,0,9,0,2021-02-06,1612566000.0
7338,24,3,2021-02-07,20,0,29,0,2021-02-07,1612652400.0
7339,24,3,2021-02-08,75,0,104,0,2021-02-08,1612738800.0
7340,24,3,2021-02-09,329,0,433,0,2021-02-09,1612825200.0
7341,24,3,2021-02-10,277,0,710,0,2021-02-10,1612911600.0
7342,24,3,2021-02-11,396,0,1106,0,2021-02-11,1612998000.0
7343,24,3,2021-02-12,348,0,1454,0,2021-02-12,1613084400.0
7344,24,3,2021-02-13,100,0,1554,0,2021-02-13,1613170800.0
7345,24,3,2021-02-14,157,0,1711,0,2021-02-14,1613257200.0
7346,24,3,2021-02-15,520,0,2231,0,2021-02-15,1613343600.0
7347,24,3,2021-02-16,497,0,2728,0,2021-02-16,1613430000.0
7348,24,3,2021-02-17,402,0,3130,0,2021-02-17,1613516400.0
7349,24,3,2021-02-18,446,0,3576,0,2021-02-18,1613602800.0
7350,24,3,2021-02-19,538,0,4114,0,2021-02-19,1613689200.0
7351,24,3,2021-02-20,163,0,4277,0,2021-02-20,1613775600.0
7352,24,3,2021-02-21,79,0,4356,0,2021-02-21,1613862000.0
7353,24,3,2021-02-22,256,0,4612,0,2021-02-22,1613948400.0
7354,24,3,2021-02-23,271,0,4883,0,2021-02-23,1614034800.0
7355,24,3,2021-02-24,408,0,5291,0,2021-02-24,1614121200.0
7356,24,3,2021-02-25,1531,0,6822,0,2021-02-25,1614207600.0
7357,24,3,2021-02-26,2264,0,9086,0,2021-02-26,1614294000.0
7358,24,3,2021-02-27,1222,0,10308,0,2021-02-27,1614380400.0
7359,24,3,2021-02-28,50,0,10358,0,2021-02-28,1614466800.0
7360,24,3,2021-03-01,620,0,10978,0,2021-03-01,1614553200.0
7361,24,3,2021-03-02,1123,2,12101,2,2021-03-02,1614639600.0
7362,24,3,2021-03-03,1278,3,13379,5,2021-03-03,1614726000.0
7363,24,3,2021-03-04,2520,0,15899,5,2021-03-04,1614812400.0
7364,24,3,2021-03-05,3892,3,19791,8,2021-03-05,1614898800.0
7365,24,3,2021-03-06,5307,2,25098,10,2021-03-06,1614985200.0
7366,24,3,2021-03-07,1520,0,26618,10,2021-03-07,1615071600.0
7367,24,3,2021-03-08,1361,1,27979,11,2021-03-08,1615158000.0
7368,24,3,2021-03-09,2791,4,30770,15,2021-03-09,1615244400.0
7369,24,3,2021-03-10,2475,1,33245,16,2021-03-10,1615330800.0
7370,24,3,2021-03-11,3800,3,37045,19,2021-03-11,1615417200.0
7371,24,3,2021-03-12,6463,0,43508,19,2021-03-12,1615503600.0
7372,24,3,2021-03-13,5152,2,48660,21,2021-03-13,1615590000.0
7373,24,3,2021-03-14,333,0,48993,21,2021-03-14,1615676400.0
7374,24,3,2021-03-15,1685,0,50678,21,2021-03-15,1615762800.0
7375,24,3,2021-03-16,40,0,50718,21,2021-03-16,1615849200.0
7376,24,3,2021-03-17,21,0,50739,21,2021-03-17,1615935600.0
7377,24,3,2021-03-18,28,0,50767,21,2021-03-18,1616022000.0
7378,24,3,2021-03-19,2940,2,53707,23,2021-03-19,1616108400.0
7379,24,3,2021-03-20,3079,3,56786,26,2021-03-20,1616194800.0
7380,24,3,2021-03-21,202,0,56988,26,2021-03-21,1616281200.0
7381,24,3,2021-03-22,1084,0,58072,26,2021-03-22,1616367600.0
7382,24,3,2021-03-23,2645,4,60717,30,2021-03-23,1616454000.0
7383,24,3,2021-03-24,3273,1,63990,31,2021-03-24,1616540400.0
7384,24,3,2021-03-25,5632,3,69622,34,2021-03-25,1616626800.0
7385,24,3,2021-03-26,6558,5,76180,39,2021-03-26,1616713200.0
7386,24,3,2021-03-27,2581,2,78761,41,2021-03-27,1616799600.0
7387,24,3,2021-03-28,194,0,78955,41,2021-03-28,1616886000.0
7388,24,3,2021-03-29,1751,1,80706,42,2021-03-29,1616972400.0
7389,24,3,2021-03-30,3208,4,83914,46,2021-03-30,1617058800.0
7390,24,3,2021-03-31,2106,1,86020,47,2021-03-31,1617145200.0
7391,24,3,2021-04-01,3316,4,89336,51,2021-04-01,1617231600.0
7392,24,3,2021-04-02,3165,1,92501,52,2021-04-02,1617318000.0
7393,24,3,2021-04-03,1760,1,94261,53,2021-04-03,1617404400.0
7394,24,3,2021-04-04,164,0,94425,53,2021-04-04,1617490800.0
7395,24,3,2021-04-05,63,3,94488,56,2021-04-05,1617577200.0
7396,24,3,2021-04-06,1228,0,95716,56,2021-04-06,1617663600.0
7397,24,3,2021-04-07,1320,0,97036,56,2021-04-07,1617750000.0
7398,24,3,2021-04-08,3412,4,100448,60,2021-04-08,1617836400.0
7399,24,3,2021-04-09,7702,11,108150,71,2021-04-09,1617922800.0
7400,24,3,2021-04-10,4158,12,112308,83,2021-04-10,1618009200.0
7401,24,3,2021-04-11,166,0,112474,83,2021-04-11,1618095600.0
7402,24,3,2021-04-12,2125,4,114599,87,2021-04-12,1618185600.0
7403,24,3,2021-04-13,4429,6,119028,93,2021-04-13,1618272000.0
7404,24,3,2021-04-14,3155,7,122183,100,2021-04-14,1618358400.0
7405,24,3,2021-04-15,4524,6,126707,106,2021-04-15,1618444800.0
7406,24,3,2021-04-16,5478,6,132185,112,2021-04-16,1618531200.0
7407,24,3,2021-04-17,2692,12,134877,124,2021-04-17,1618617600.0
7408,24,3,2021-04-18,205,0,135082,124,2021-04-18,1618704000.0
7409,24,3,2021-04-19,1130,5,136212,129,2021-04-19,1618790400.0
7410,24,3,2021-04-20,2337,4,138549,133,2021-04-20,1618876800.0
7411,24,3,2021-04-21,2090,19,140639,152,2021-04-21,1618963200.0
7412,24,3,2021-04-22,2476,25,143115,177,2021-04-22,1619049600.0
7413,24,3,2021-04-23,3750,30,146865,207,2021-04-23,1619136000.0
7414,24,3,2021-04-24,2673,21,149538,228,2021-04-24,1619222400.0
7415,24,3,2021-04-25,88,2,149626,230,2021-04-25,1619308800.0
7416,24,3,2021-04-26,926,1,150552,231,2021-04-26,1619395200.0
7417,24,3,2021-04-27,2201,54,152753,285,2021-04-27,1619481600.0
7418,24,3,2021-04-28,1581,70,154334,355,2021-04-28,1619568000.0
7419,24,3,2021-04-29,2373,142,156707,497,2021-04-29,1619654400.0
7420,24,3,2021-04-30,3336,333,160043,830,2021-04-30,1619740800.0
7421,24,3,2021-05-01,553,56,160596,886,2021-05-01,1619827200.0
7422,24,3,2021-05-02,110,12,160706,898,2021-05-02,1619913600.0
7423,24,3,2021-05-03,776,142,161482,1040,2021-05-03,1620000000.0
7424,24,3,2021-05-04,1465,188,162947,1228,2021-05-04,1620086400.0
7425,24,3,2021-05-05,1223,305,164170,1533,2021-05-05,1620172800.0
7426,24,3,2021-05-06,2342,531,166512,2064,2021-05-06,1620259200.0
7427,24,3,2021-05-07,2928,1009,169440,3073,2021-05-07,1620345600.0
7428,24,3,2021-05-08,650,254,170090,3327,2021-05-08,1620432000.0
7429,24,3,2021-05-09,98,57,170188,3384,2021-05-09,1620518400.0
7430,24,3,2021-05-10,925,383,171113,3767,2021-05-10,1620604800.0
7431,24,3,2021-05-11,1957,1124,173070,4891,2021-05-11,1620691200.0
7432,24,3,2021-05-12,1078,857,174148,5748,2021-05-12,1620777600.0
7433,24,3,2021-05-13,147,69,174295,5817,2021-05-13,1620864000.0
7434,24,3,2021-05-14,806,854,175101,6671,2021-05-14,1620950400.0
7435,24,3,2021-05-15,497,653,175598,7324,2021-05-15,1621036800.0
7436,24,3,2021-05-16,29,73,175627,7397,2021-05-16,1621123200.0
7437,24,3,2021-05-17,339,546,175966,7943,2021-05-17,1621206000.0
7438,24,3,2021-05-18,1091,882,177057,8825,2021-05-18,1621292400.0
7439,24,3,2021-05-19,625,1281,177682,10106,2021-05-19,1621378800.0
7440,24,3,2021-05-20,848,1995,178530,12101,2021-05-20,1621465200.0
7441,24,3,2021-05-21,856,2357,179386,14458,2021-05-21,1621551600.0
7442,24,3,2021-05-22,303,1393,179689,15851,2021-05-22,1621638000.0
7443,24,3,2021-05-23,138,108,179827,15959,2021-05-23,1621724400.0
7444,24,3,2021-05-24,71,122,179898,16081,2021-05-24,1621810800.0
7445,24,3,2021-05-25,298,1393,180196,17474,2021-05-25,1621897200.0
7446,24,3,2021-05-26,274,1424,180470,18898,2021-05-26,1621983600.0
7447,24,3,2021-05-27,361,2302,180831,21200,2021-05-27,1622070000.0
7448,24,3,2021-05-28,388,3941,181219,25141,2021-05-28,1622156400.0
7449,24,3,2021-05-29,178,2831,181397,27972,2021-05-29,1622242800.0
7450,24,3,2021-05-30,45,497,181442,28469,2021-05-30,1622329200.0
7451,24,3,2021-05-31,107,1116,181549,29585,2021-05-31,1622415600.0
7452,24,3,2021-06-01,203,2437,181752,32022,2021-06-01,1622502000.0
7453,24,3,2021-06-02,129,1988,181881,34010,2021-06-02,1622588400.0
7454,24,3,2021-06-03,182,2801,182063,36811,2021-06-03,1622674800.0
7455,24,3,2021-06-04,157,4134,182220,40945,2021-06-04,1622761200.0
7456,24,3,2021-06-05,106,2671,182326,43616,2021-06-05,1622847600.0
7457,24,3,2021-06-06,17,245,182343,43861,2021-06-06,1622934000.0
7458,24,3,2021-06-07,53,1275,182396,45136,2021-06-07,1623020400.0
7459,24,3,2021-06-08,76,1834,182472,46970,2021-06-08,1623106800.0
7460,24,3,2021-06-09,111,1602,182583,48572,2021-06-09,1623193200.0
7461,24,3,2021-06-10,120,2166,182703,50738,2021-06-10,1623279600.0
7462,24,3,2021-06-11,105,3861,182808,54599,2021-06-11,1623366000.0
7463,24,3,2021-06-12,47,2131,182855,56730,2021-06-12,1623452400.0
7464,24,3,2021-06-13,2,202,182857,56932,2021-06-13,1623538800.0
7465,24,3,2021-06-14,31,1430,182888,58362,2021-06-14,1623625200.0
7466,24,3,2021-06-15,39,3278,182927,61640,2021-06-15,1623711600.0
7467,24,3,2021-06-16,49,2934,182976,64574,2021-06-16,1623798000.0
7468,24,3,2021-06-17,78,4568,183054,69142,2021-06-17,1623884400.0
7469,24,3,2021-06-18,74,4919,183128,74061,2021-06-18,1623970800.0
7470,24,3,2021-06-19,44,1895,183172,75956,2021-06-19,1624057200.0
7471,24,3,2021-06-20,8,211,183180,76167,2021-06-20,1624143600.0
7472,24,3,2021-06-21,74,1538,183254,77705,2021-06-21,1624230000.0
7473,24,3,2021-06-22,89,3038,183343,80743,2021-06-22,1624316400.0
7474,24,3,2021-06-23,37,2226,183380,82969,2021-06-23,1624402800.0
7475,24,3,2021-06-24,70,3352,183450,86321,2021-06-24,1624489200.0
7476,24,3,2021-06-25,48,3841,183498,90162,2021-06-25,1624575600.0
7477,24,3,2021-06-26,23,2106,183521,92268,2021-06-26,1624662000.0
7478,24,3,2021-06-27,11,209,183532,92477,2021-06-27,1624748400.0
7479,24,3,2021-06-28,9,1108,183541,93585,2021-06-28,1624834800.0
7480,24,3,2021-06-29,55,3025,183596,96610,2021-06-29,1624921200.0
7481,24,3,2021-06-30,37,2415,183633,99025,2021-06-30,1625007600.0
7482,24,3,2021-07-01,44,3113,183677,102138,2021-07-01,1625094000.0
7483,24,3,2021-07-02,53,4644,183730,106782,2021-07-02,1625180400.0
7484,24,3,2021-07-03,30,1709,183760,108491,2021-07-03,1625266800.0
7485,24,3,2021-07-04,9,232,183769,108723,2021-07-04,1625353200.0
7486,24,3,2021-07-05,12,1773,183781,110496,2021-07-05,1625439600.0
7487,24,3,2021-07-06,18,2883,183799,113379,2021-07-06,1625526000.0
7488,24,4,2020-12-27,0,0,0,0,2020-12-27,1609023600.0
7489,24,4,2020-12-28,0,0,0,0,2020-12-28,1609110000.0
7490,24,4,2020-12-29,0,0,0,0,2020-12-29,1609196400.0
7491,24,4,2020-12-30,0,0,0,0,2020-12-30,1609282800.0
7492,24,4,2020-12-31,0,0,0,0,2020-12-31,1609369200.0
7493,24,4,2021-01-01,0,0,0,0,2021-01-01,1609455600.0
7494,24,4,2021-01-02,0,0,0,0,2021-01-02,1609542000.0
7495,24,4,2021-01-03,0,0,0,0,2021-01-03,1609628400.0
7496,24,4,2021-01-04,0,0,0,0,2021-01-04,1609714800.0
7497,24,4,2021-01-05,0,0,0,0,2021-01-05,1609801200.0
7498,24,4,2021-01-06,0,0,0,0,2021-01-06,1609887600.0
7499,24,4,2021-01-07,0,0,0,0,2021-01-07,1609974000.0
7500,24,4,2021-01-08,0,0,0,0,2021-01-08,1610060400.0
7501,24,4,2021-01-09,0,0,0,0,2021-01-09,1610146800.0
7502,24,4,2021-01-10,0,0,0,0,2021-01-10,1610233200.0
7503,24,4,2021-01-11,0,0,0,0,2021-01-11,1610319600.0
7504,24,4,2021-01-12,0,0,0,0,2021-01-12,1610406000.0
7505,24,4,2021-01-13,0,0,0,0,2021-01-13,1610492400.0
7506,24,4,2021-01-14,0,0,0,0,2021-01-14,1610578800.0
7507,24,4,2021-01-15,0,0,0,0,2021-01-15,1610665200.0
7508,24,4,2021-01-16,0,0,0,0,2021-01-16,1610751600.0
7509,24,4,2021-01-17,0,0,0,0,2021-01-17,1610838000.0
7510,24,4,2021-01-18,0,0,0,0,2021-01-18,1610924400.0
7511,24,4,2021-01-19,0,0,0,0,2021-01-19,1611010800.0
7512,24,4,2021-01-20,0,0,0,0,2021-01-20,1611097200.0
7513,24,4,2021-01-21,0,0,0,0,2021-01-21,1611183600.0
7514,24,4,2021-01-22,0,0,0,0,2021-01-22,1611270000.0
7515,24,4,2021-01-23,0,0,0,0,2021-01-23,1611356400.0
7516,24,4,2021-01-24,0,0,0,0,2021-01-24,1611442800.0
7517,24,4,2021-01-25,0,0,0,0,2021-01-25,1611529200.0
7518,24,4,2021-01-26,0,0,0,0,2021-01-26,1611615600.0
7519,24,4,2021-01-27,0,0,0,0,2021-01-27,1611702000.0
7520,24,4,2021-01-28,0,0,0,0,2021-01-28,1611788400.0
7521,24,4,2021-01-29,0,0,0,0,2021-01-29,1611874800.0
7522,24,4,2021-01-30,0,0,0,0,2021-01-30,1611961200.0
7523,24,4,2021-01-31,0,0,0,0,2021-01-31,1612047600.0
7524,24,4,2021-02-01,0,0,0,0,2021-02-01,1612134000.0
7525,24,4,2021-02-02,0,0,0,0,2021-02-02,1612220400.0
7526,24,4,2021-02-03,0,0,0,0,2021-02-03,1612306800.0
7527,24,4,2021-02-04,0,0,0,0,2021-02-04,1612393200.0
7528,24,4,2021-02-05,0,0,0,0,2021-02-05,1612479600.0
7529,24,4,2021-02-06,0,0,0,0,2021-02-06,1612566000.0
7530,24,4,2021-02-07,0,0,0,0,2021-02-07,1612652400.0
7531,24,4,2021-02-08,0,0,0,0,2021-02-08,1612738800.0
7532,24,4,2021-02-09,0,0,0,0,2021-02-09,1612825200.0
7533,24,4,2021-02-10,0,0,0,0,2021-02-10,1612911600.0
7534,24,4,2021-02-11,0,0,0,0,2021-02-11,1612998000.0
7535,24,4,2021-02-12,0,0,0,0,2021-02-12,1613084400.0
7536,24,4,2021-02-13,0,0,0,0,2021-02-13,1613170800.0
7537,24,4,2021-02-14,0,0,0,0,2021-02-14,1613257200.0
7538,24,4,2021-02-15,0,0,0,0,2021-02-15,1613343600.0
7539,24,4,2021-02-16,0,0,0,0,2021-02-16,1613430000.0
7540,24,4,2021-02-17,0,0,0,0,2021-02-17,1613516400.0
7541,24,4,2021-02-18,0,0,0,0,2021-02-18,1613602800.0
7542,24,4,2021-02-19,0,0,0,0,2021-02-19,1613689200.0
7543,24,4,2021-02-20,0,0,0,0,2021-02-20,1613775600.0
7544,24,4,2021-02-21,0,0,0,0,2021-02-21,1613862000.0
7545,24,4,2021-02-22,0,0,0,0,2021-02-22,1613948400.0
7546,24,4,2021-02-23,0,0,0,0,2021-02-23,1614034800.0
7547,24,4,2021-02-24,0,0,0,0,2021-02-24,1614121200.0
7548,24,4,2021-02-25,0,0,0,0,2021-02-25,1614207600.0
7549,24,4,2021-02-26,0,0,0,0,2021-02-26,1614294000.0
7550,24,4,2021-02-27,0,0,0,0,2021-02-27,1614380400.0
7551,24,4,2021-02-28,0,0,0,0,2021-02-28,1614466800.0
7552,24,4,2021-03-01,0,0,0,0,2021-03-01,1614553200.0
7553,24,4,2021-03-02,0,0,0,0,2021-03-02,1614639600.0
7554,24,4,2021-03-03,0,0,0,0,2021-03-03,1614726000.0
7555,24,4,2021-03-04,0,0,0,0,2021-03-04,1614812400.0
7556,24,4,2021-03-05,0,0,0,0,2021-03-05,1614898800.0
7557,24,4,2021-03-06,0,0,0,0,2021-03-06,1614985200.0
7558,24,4,2021-03-07,0,0,0,0,2021-03-07,1615071600.0
7559,24,4,2021-03-08,0,0,0,0,2021-03-08,1615158000.0
7560,24,4,2021-03-09,0,0,0,0,2021-03-09,1615244400.0
7561,24,4,2021-03-10,0,0,0,0,2021-03-10,1615330800.0
7562,24,4,2021-03-11,0,0,0,0,2021-03-11,1615417200.0
7563,24,4,2021-03-12,0,0,0,0,2021-03-12,1615503600.0
7564,24,4,2021-03-13,0,0,0,0,2021-03-13,1615590000.0
7565,24,4,2021-03-14,0,0,0,0,2021-03-14,1615676400.0
7566,24,4,2021-03-15,0,0,0,0,2021-03-15,1615762800.0
7567,24,4,2021-03-16,0,0,0,0,2021-03-16,1615849200.0
7568,24,4,2021-03-17,0,0,0,0,2021-03-17,1615935600.0
7569,24,4,2021-03-18,0,0,0,0,2021-03-18,1616022000.0
7570,24,4,2021-03-19,0,0,0,0,2021-03-19,1616108400.0
7571,24,4,2021-03-20,0,0,0,0,2021-03-20,1616194800.0
7572,24,4,2021-03-21,0,0,0,0,2021-03-21,1616281200.0
7573,24,4,2021-03-22,0,0,0,0,2021-03-22,1616367600.0
7574,24,4,2021-03-23,0,0,0,0,2021-03-23,1616454000.0
7575,24,4,2021-03-24,0,0,0,0,2021-03-24,1616540400.0
7576,24,4,2021-03-25,0,0,0,0,2021-03-25,1616626800.0
7577,24,4,2021-03-26,0,0,0,0,2021-03-26,1616713200.0
7578,24,4,2021-03-27,0,0,0,0,2021-03-27,1616799600.0
7579,24,4,2021-03-28,0,0,0,0,2021-03-28,1616886000.0
7580,24,4,2021-03-29,0,0,0,0,2021-03-29,1616972400.0
7581,24,4,2021-03-30,0,0,0,0,2021-03-30,1617058800.0
7582,24,4,2021-03-31,0,0,0,0,2021-03-31,1617145200.0
7583,24,4,2021-04-01,0,0,0,0,2021-04-01,1617231600.0
7584,24,4,2021-04-02,0,0,0,0,2021-04-02,1617318000.0
7585,24,4,2021-04-03,0,0,0,0,2021-04-03,1617404400.0
7586,24,4,2021-04-04,0,0,0,0,2021-04-04,1617490800.0
7587,24,4,2021-04-05,0,0,0,0,2021-04-05,1617577200.0
7588,24,4,2021-04-06,0,0,0,0,2021-04-06,1617663600.0
7589,24,4,2021-04-07,0,0,0,0,2021-04-07,1617750000.0
7590,24,4,2021-04-08,0,0,0,0,2021-04-08,1617836400.0
7591,24,4,2021-04-09,0,0,0,0,2021-04-09,1617922800.0
7592,24,4,2021-04-10,0,0,0,0,2021-04-10,1618009200.0
7593,24,4,2021-04-11,0,0,0,0,2021-04-11,1618095600.0
7594,24,4,2021-04-12,0,0,0,0,2021-04-12,1618185600.0
7595,24,4,2021-04-13,0,0,0,0,2021-04-13,1618272000.0
7596,24,4,2021-04-14,0,0,0,0,2021-04-14,1618358400.0
7597,24,4,2021-04-15,0,0,0,0,2021-04-15,1618444800.0
7598,24,4,2021-04-16,0,0,0,0,2021-04-16,1618531200.0
7599,24,4,2021-04-17,0,0,0,0,2021-04-17,1618617600.0
7600,24,4,2021-04-18,0,0,0,0,2021-04-18,1618704000.0
7601,24,4,2021-04-19,0,0,0,0,2021-04-19,1618790400.0
7602,24,4,2021-04-20,0,0,0,0,2021-04-20,1618876800.0
7603,24,4,2021-04-21,0,0,0,0,2021-04-21,1618963200.0
7604,24,4,2021-04-22,0,0,0,0,2021-04-22,1619049600.0
7605,24,4,2021-04-23,21,0,21,0,2021-04-23,1619136000.0
7606,24,4,2021-04-24,76,0,97,0,2021-04-24,1619222400.0
7607,24,4,2021-04-25,1,0,98,0,2021-04-25,1619308800.0
7608,24,4,2021-04-26,95,0,193,0,2021-04-26,1619395200.0
7609,24,4,2021-04-27,444,0,637,0,2021-04-27,1619481600.0
7610,24,4,2021-04-28,387,0,1024,0,2021-04-28,1619568000.0
7611,24,4,2021-04-29,687,0,1711,0,2021-04-29,1619654400.0
7612,24,4,2021-04-30,811,0,2522,0,2021-04-30,1619740800.0
7613,24,4,2021-05-01,72,0,2594,0,2021-05-01,1619827200.0
7614,24,4,2021-05-02,20,0,2614,0,2021-05-02,1619913600.0
7615,24,4,2021-05-03,165,0,2779,0,2021-05-03,1620000000.0
7616,24,4,2021-05-04,211,0,2990,0,2021-05-04,1620086400.0
7617,24,4,2021-05-05,266,0,3256,0,2021-05-05,1620172800.0
7618,24,4,2021-05-06,481,0,3737,0,2021-05-06,1620259200.0
7619,24,4,2021-05-07,900,0,4637,0,2021-05-07,1620345600.0
7620,24,4,2021-05-08,204,0,4841,0,2021-05-08,1620432000.0
7621,24,4,2021-05-09,25,1,4866,1,2021-05-09,1620518400.0
7622,24,4,2021-05-10,370,0,5236,1,2021-05-10,1620604800.0
7623,24,4,2021-05-11,683,1,5919,2,2021-05-11,1620691200.0
7624,24,4,2021-05-12,416,0,6335,2,2021-05-12,1620777600.0
7625,24,4,2021-05-13,114,0,6449,2,2021-05-13,1620864000.0
7626,24,4,2021-05-14,401,0,6850,2,2021-05-14,1620950400.0
7627,24,4,2021-05-15,142,0,6992,2,2021-05-15,1621036800.0
7628,24,4,2021-05-16,0,0,6992,2,2021-05-16,1621123200.0
7629,24,4,2021-05-17,198,0,7190,2,2021-05-17,1621206000.0
7630,24,4,2021-05-18,413,0,7603,2,2021-05-18,1621292400.0
7631,24,4,2021-05-19,218,0,7821,2,2021-05-19,1621378800.0
7632,24,4,2021-05-20,479,0,8300,2,2021-05-20,1621465200.0
7633,24,4,2021-05-21,539,0,8839,2,2021-05-21,1621551600.0
7634,24,4,2021-05-22,177,0,9016,2,2021-05-22,1621638000.0
7635,24,4,2021-05-23,27,0,9043,2,2021-05-23,1621724400.0
7636,24,4,2021-05-24,49,0,9092,2,2021-05-24,1621810800.0
7637,24,4,2021-05-25,404,1,9496,3,2021-05-25,1621897200.0
7638,24,4,2021-05-26,313,0,9809,3,2021-05-26,1621983600.0
7639,24,4,2021-05-27,647,0,10456,3,2021-05-27,1622070000.0
7640,24,4,2021-05-28,1326,5,11782,8,2021-05-28,1622156400.0
7641,24,4,2021-05-29,609,0,12391,8,2021-05-29,1622242800.0
7642,24,4,2021-05-30,16,0,12407,8,2021-05-30,1622329200.0
7643,24,4,2021-05-31,521,0,12928,8,2021-05-31,1622415600.0
7644,24,4,2021-06-01,1063,1,13991,9,2021-06-01,1622502000.0
7645,24,4,2021-06-02,545,0,14536,9,2021-06-02,1622588400.0
7646,24,4,2021-06-03,879,0,15415,9,2021-06-03,1622674800.0
7647,24,4,2021-06-04,1042,0,16457,9,2021-06-04,1622761200.0
7648,24,4,2021-06-05,537,0,16994,9,2021-06-05,1622847600.0
7649,24,4,2021-06-06,20,0,17014,9,2021-06-06,1622934000.0
7650,24,4,2021-06-07,357,1,17371,10,2021-06-07,1623020400.0
7651,24,4,2021-06-08,824,1,18195,11,2021-06-08,1623106800.0
7652,24,4,2021-06-09,579,1,18774,12,2021-06-09,1623193200.0
7653,24,4,2021-06-10,650,2,19424,14,2021-06-10,1623279600.0
7654,24,4,2021-06-11,863,0,20287,14,2021-06-11,1623366000.0
7655,24,4,2021-06-12,390,1,20677,15,2021-06-12,1623452400.0
7656,24,4,2021-06-13,22,6,20699,21,2021-06-13,1623538800.0
7657,24,4,2021-06-14,303,1,21002,22,2021-06-14,1623625200.0
7658,24,4,2021-06-15,420,4,21422,26,2021-06-15,1623711600.0
7659,24,4,2021-06-16,330,0,21752,26,2021-06-16,1623798000.0
7660,24,4,2021-06-17,429,9,22181,35,2021-06-17,1623884400.0
7661,24,4,2021-06-18,501,0,22682,35,2021-06-18,1623970800.0
7662,24,4,2021-06-19,244,0,22926,35,2021-06-19,1624057200.0
7663,24,4,2021-06-20,14,0,22940,35,2021-06-20,1624143600.0
7664,24,4,2021-06-21,254,0,23194,35,2021-06-21,1624230000.0
7665,24,4,2021-06-22,415,1,23609,36,2021-06-22,1624316400.0
7666,24,4,2021-06-23,369,0,23978,36,2021-06-23,1624402800.0
7667,24,4,2021-06-24,380,0,24358,36,2021-06-24,1624489200.0
7668,24,4,2021-06-25,477,0,24835,36,2021-06-25,1624575600.0
7669,24,4,2021-06-26,229,1,25064,37,2021-06-26,1624662000.0
7670,24,4,2021-06-27,31,1,25095,38,2021-06-27,1624748400.0
7671,24,4,2021-06-28,197,1,25292,39,2021-06-28,1624834800.0
7672,24,4,2021-06-29,307,0,25599,39,2021-06-29,1624921200.0
7673,24,4,2021-06-30,263,1,25862,40,2021-06-30,1625007600.0
7674,24,4,2021-07-01,293,2,26155,42,2021-07-01,1625094000.0
7675,24,4,2021-07-02,422,1,26577,43,2021-07-02,1625180400.0
7676,24,4,2021-07-03,188,0,26765,43,2021-07-03,1625266800.0
7677,24,4,2021-07-04,25,0,26790,43,2021-07-04,1625353200.0
7678,24,4,2021-07-05,189,1,26979,44,2021-07-05,1625439600.0
7679,24,4,2021-07-06,337,0,27316,44,2021-07-06,1625526000.0
7680,27,1,2020-12-27,4,0,4,0,2020-12-27,1609023600.0
7681,27,1,2020-12-28,0,0,4,0,2020-12-28,1609110000.0
7682,27,1,2020-12-29,19,0,23,0,2020-12-29,1609196400.0
7683,27,1,2020-12-30,20,0,43,0,2020-12-30,1609282800.0
7684,27,1,2020-12-31,2,0,45,0,2020-12-31,1609369200.0
7685,27,1,2021-01-01,0,0,45,0,2021-01-01,1609455600.0
7686,27,1,2021-01-02,1,0,46,0,2021-01-02,1609542000.0
7687,27,1,2021-01-03,1,0,47,0,2021-01-03,1609628400.0
7688,27,1,2021-01-04,28,0,75,0,2021-01-04,1609714800.0
7689,27,1,2021-01-05,263,0,338,0,2021-01-05,1609801200.0
7690,27,1,2021-01-06,718,0,1056,0,2021-01-06,1609887600.0
7691,27,1,2021-01-07,1582,0,2638,0,2021-01-07,1609974000.0
7692,27,1,2021-01-08,1896,0,4534,0,2021-01-08,1610060400.0
7693,27,1,2021-01-09,688,0,5222,0,2021-01-09,1610146800.0
7694,27,1,2021-01-10,3,0,5225,0,2021-01-10,1610233200.0
7695,27,1,2021-01-11,2420,0,7645,0,2021-01-11,1610319600.0
7696,27,1,2021-01-12,3823,0,11468,0,2021-01-12,1610406000.0
7697,27,1,2021-01-13,3849,0,15317,0,2021-01-13,1610492400.0
7698,27,1,2021-01-14,4736,0,20053,0,2021-01-14,1610578800.0
7699,27,1,2021-01-15,3592,0,23645,0,2021-01-15,1610665200.0
7700,27,1,2021-01-16,781,5,24426,5,2021-01-16,1610751600.0
7701,27,1,2021-01-17,116,1,24542,6,2021-01-17,1610838000.0
7702,27,1,2021-01-18,5392,10,29934,16,2021-01-18,1610924400.0
7703,27,1,2021-01-19,7259,8,37193,24,2021-01-19,1611010800.0
7704,27,1,2021-01-20,6599,48,43792,72,2021-01-20,1611097200.0
7705,27,1,2021-01-21,8044,8,51836,80,2021-01-21,1611183600.0
7706,27,1,2021-01-22,6401,6,58237,86,2021-01-22,1611270000.0
7707,27,1,2021-01-23,2418,6,60655,92,2021-01-23,1611356400.0
7708,27,1,2021-01-24,347,0,61002,92,2021-01-24,1611442800.0
7709,27,1,2021-01-25,4037,24,65039,116,2021-01-25,1611529200.0
7710,27,1,2021-01-26,5952,223,70991,339,2021-01-26,1611615600.0
7711,27,1,2021-01-27,5737,339,76728,678,2021-01-27,1611702000.0
7712,27,1,2021-01-28,5047,886,81775,1564,2021-01-28,1611788400.0
7713,27,1,2021-01-29,4830,1255,86605,2819,2021-01-29,1611874800.0
7714,27,1,2021-01-30,2019,347,88624,3166,2021-01-30,1611961200.0
7715,27,1,2021-01-31,252,22,88876,3188,2021-01-31,1612047600.0
7716,27,1,2021-02-01,2072,1389,90948,4577,2021-02-01,1612134000.0
7717,27,1,2021-02-02,2261,2216,93209,6793,2021-02-02,1612220400.0
7718,27,1,2021-02-03,1623,2378,94832,9171,2021-02-03,1612306800.0
7719,27,1,2021-02-04,1574,3149,96406,12320,2021-02-04,1612393200.0
7720,27,1,2021-02-05,1237,2585,97643,14905,2021-02-05,1612479600.0
7721,27,1,2021-02-06,662,667,98305,15572,2021-02-06,1612566000.0
7722,27,1,2021-02-07,3,87,98308,15659,2021-02-07,1612652400.0
7723,27,1,2021-02-08,743,2678,99051,18337,2021-02-08,1612738800.0
7724,27,1,2021-02-09,849,3610,99900,21947,2021-02-09,1612825200.0
7725,27,1,2021-02-10,767,3373,100667,25320,2021-02-10,1612911600.0
7726,27,1,2021-02-11,1487,4616,102154,29936,2021-02-11,1612998000.0
7727,27,1,2021-02-12,1125,4422,103279,34358,2021-02-12,1613084400.0
7728,27,1,2021-02-13,274,1383,103553,35741,2021-02-13,1613170800.0
7729,27,1,2021-02-14,28,289,103581,36030,2021-02-14,1613257200.0
7730,27,1,2021-02-15,745,4891,104326,40921,2021-02-15,1613343600.0
7731,27,1,2021-02-16,1017,6363,105343,47284,2021-02-16,1613430000.0
7732,27,1,2021-02-17,1418,5684,106761,52968,2021-02-17,1613516400.0
7733,27,1,2021-02-18,1507,4942,108268,57910,2021-02-18,1613602800.0
7734,27,1,2021-02-19,1341,4430,109609,62340,2021-02-19,1613689200.0
7735,27,1,2021-02-20,542,1597,110151,63937,2021-02-20,1613775600.0
7736,27,1,2021-02-21,1,280,110152,64217,2021-02-21,1613862000.0
7737,27,1,2021-02-22,549,3611,110701,67828,2021-02-22,1613948400.0
7738,27,1,2021-02-23,614,4061,111315,71889,2021-02-23,1614034800.0
7739,27,1,2021-02-24,676,3502,111991,75391,2021-02-24,1614121200.0
7740,27,1,2021-02-25,745,3735,112736,79126,2021-02-25,1614207600.0
7741,27,1,2021-02-26,827,2909,113563,82035,2021-02-26,1614294000.0
7742,27,1,2021-02-27,306,1480,113869,83515,2021-02-27,1614380400.0
7743,27,1,2021-02-28,4,278,113873,83793,2021-02-28,1614466800.0
7744,27,1,2021-03-01,2490,1882,116363,85675,2021-03-01,1614553200.0
7745,27,1,2021-03-02,3257,2135,119620,87810,2021-03-02,1614639600.0
7746,27,1,2021-03-03,3568,1578,123188,89388,2021-03-03,1614726000.0
7747,27,1,2021-03-04,4343,1642,127531,91030,2021-03-04,1614812400.0
7748,27,1,2021-03-05,4215,1378,131746,92408,2021-03-05,1614898800.0
7749,27,1,2021-03-06,1019,358,132765,92766,2021-03-06,1614985200.0
7750,27,1,2021-03-07,14,173,132779,92939,2021-03-07,1615071600.0
7751,27,1,2021-03-08,2875,872,135654,93811,2021-03-08,1615158000.0
7752,27,1,2021-03-09,4580,1376,140234,95187,2021-03-09,1615244400.0
7753,27,1,2021-03-10,5270,1053,145504,96240,2021-03-10,1615330800.0
7754,27,1,2021-03-11,5619,1615,151123,97855,2021-03-11,1615417200.0
7755,27,1,2021-03-12,5160,1234,156283,99089,2021-03-12,1615503600.0
7756,27,1,2021-03-13,1446,300,157729,99389,2021-03-13,1615590000.0
7757,27,1,2021-03-14,4,12,157733,99401,2021-03-14,1615676400.0
7758,27,1,2021-03-15,5015,890,162748,100291,2021-03-15,1615762800.0
7759,27,1,2021-03-16,6977,737,169725,101028,2021-03-16,1615849200.0
7760,27,1,2021-03-17,6572,917,176297,101945,2021-03-17,1615935600.0
7761,27,1,2021-03-18,6965,1084,183262,103029,2021-03-18,1616022000.0
7762,27,1,2021-03-19,5111,701,188373,103730,2021-03-19,1616108400.0
7763,27,1,2021-03-20,1212,242,189585,103972,2021-03-20,1616194800.0
7764,27,1,2021-03-21,2,4,189587,103976,2021-03-21,1616281200.0
7765,27,1,2021-03-22,7167,717,196754,104693,2021-03-22,1616367600.0
7766,27,1,2021-03-23,9549,834,206303,105527,2021-03-23,1616454000.0
7767,27,1,2021-03-24,8884,838,215187,106365,2021-03-24,1616540400.0
7768,27,1,2021-03-25,9272,987,224459,107352,2021-03-25,1616626800.0
7769,27,1,2021-03-26,9327,742,233786,108094,2021-03-26,1616713200.0
7770,27,1,2021-03-27,3732,215,237518,108309,2021-03-27,1616799600.0
7771,27,1,2021-03-28,102,116,237620,108425,2021-03-28,1616886000.0
7772,27,1,2021-03-29,6812,3077,244432,111502,2021-03-29,1616972400.0
7773,27,1,2021-03-30,7153,3570,251585,115072,2021-03-30,1617058800.0
7774,27,1,2021-03-31,7344,3684,258929,118756,2021-03-31,1617145200.0
7775,27,1,2021-04-01,7278,3549,266207,122305,2021-04-01,1617231600.0
7776,27,1,2021-04-02,6457,3553,272664,125858,2021-04-02,1617318000.0
7777,27,1,2021-04-03,2124,956,274788,126814,2021-04-03,1617404400.0
7778,27,1,2021-04-04,40,30,274828,126844,2021-04-04,1617490800.0
7779,27,1,2021-04-05,207,1,275035,126845,2021-04-05,1617577200.0
7780,27,1,2021-04-06,6241,5495,281276,132340,2021-04-06,1617663600.0
7781,27,1,2021-04-07,6861,5984,288137,138324,2021-04-07,1617750000.0
7782,27,1,2021-04-08,8558,5300,296695,143624,2021-04-08,1617836400.0
7783,27,1,2021-04-09,8025,5025,304720,148649,2021-04-09,1617922800.0
7784,27,1,2021-04-10,1942,1595,306662,150244,2021-04-10,1618009200.0
7785,27,1,2021-04-11,79,73,306741,150317,2021-04-11,1618095600.0
7786,27,1,2021-04-12,6868,5726,313609,156043,2021-04-12,1618185600.0
7787,27,1,2021-04-13,7326,6857,320935,162900,2021-04-13,1618272000.0
7788,27,1,2021-04-14,7256,5507,328191,168407,2021-04-14,1618358400.0
7789,27,1,2021-04-15,8504,5636,336695,174043,2021-04-15,1618444800.0
7790,27,1,2021-04-16,7521,4676,344216,178719,2021-04-16,1618531200.0
7791,27,1,2021-04-17,3643,1780,347859,180499,2021-04-17,1618617600.0
7792,27,1,2021-04-18,85,22,347944,180521,2021-04-18,1618704000.0
7793,27,1,2021-04-19,5201,7388,353145,187909,2021-04-19,1618790400.0
7794,27,1,2021-04-20,5281,9117,358426,197026,2021-04-20,1618876800.0
7795,27,1,2021-04-21,5282,7664,363708,204690,2021-04-21,1618963200.0
7796,27,1,2021-04-22,5455,8411,369163,213101,2021-04-22,1619049600.0
7797,27,1,2021-04-23,5931,8108,375094,221209,2021-04-23,1619136000.0
7798,27,1,2021-04-24,2176,3039,377270,224248,2021-04-24,1619222400.0
7799,27,1,2021-04-25,294,106,377564,224354,2021-04-25,1619308800.0
7800,27,1,2021-04-26,8563,7371,386127,231725,2021-04-26,1619395200.0
7801,27,1,2021-04-27,10666,7745,396793,239470,2021-04-27,1619481600.0
7802,27,1,2021-04-28,11179,6786,407972,246256,2021-04-28,1619568000.0
7803,27,1,2021-04-29,13677,6298,421649,252554,2021-04-29,1619654400.0
7804,27,1,2021-04-30,14348,4997,435997,257551,2021-04-30,1619740800.0
7805,27,1,2021-05-01,5111,860,441108,258411,2021-05-01,1619827200.0
7806,27,1,2021-05-02,568,8,441676,258419,2021-05-02,1619913600.0
7807,27,1,2021-05-03,13880,4666,455556,263085,2021-05-03,1620000000.0
7808,27,1,2021-05-04,12075,7142,467631,270227,2021-05-04,1620086400.0
7809,27,1,2021-05-05,14401,6308,482032,276535,2021-05-05,1620172800.0
7810,27,1,2021-05-06,15637,7037,497669,283572,2021-05-06,1620259200.0
7811,27,1,2021-05-07,13725,6303,511394,289875,2021-05-07,1620345600.0
7812,27,1,2021-05-08,5475,559,516869,290434,2021-05-08,1620432000.0
7813,27,1,2021-05-09,381,140,517250,290574,2021-05-09,1620518400.0
7814,27,1,2021-05-10,13604,7759,530854,298333,2021-05-10,1620604800.0
7815,27,1,2021-05-11,17506,9216,548360,307549,2021-05-11,1620691200.0
7816,27,1,2021-05-12,16720,8609,565080,316158,2021-05-12,1620777600.0
7817,27,1,2021-05-13,9432,907,574512,317065,2021-05-13,1620864000.0
7818,27,1,2021-05-14,18340,5392,592852,322457,2021-05-14,1620950400.0
7819,27,1,2021-05-15,8228,1367,601080,323824,2021-05-15,1621036800.0
7820,27,1,2021-05-16,1543,67,602623,323891,2021-05-16,1621123200.0
7821,27,1,2021-05-17,15980,4554,618603,328445,2021-05-17,1621206000.0
7822,27,1,2021-05-18,17283,5425,635886,333870,2021-05-18,1621292400.0
7823,27,1,2021-05-19,20244,4033,656130,337903,2021-05-19,1621378800.0
7824,27,1,2021-05-20,20339,3912,676469,341815,2021-05-20,1621465200.0
7825,27,1,2021-05-21,17311,4951,693780,346766,2021-05-21,1621551600.0
7826,27,1,2021-05-22,6714,976,700494,347742,2021-05-22,1621638000.0
7827,27,1,2021-05-23,879,111,701373,347853,2021-05-23,1621724400.0
7828,27,1,2021-05-24,1929,562,703302,348415,2021-05-24,1621810800.0
7829,27,1,2021-05-25,12272,7917,715574,356332,2021-05-25,1621897200.0
7830,27,1,2021-05-26,12211,6762,727785,363094,2021-05-26,1621983600.0
7831,27,1,2021-05-27,14891,6106,742676,369200,2021-05-27,1622070000.0
7832,27,1,2021-05-28,11419,7283,754095,376483,2021-05-28,1622156400.0
7833,27,1,2021-05-29,3801,1788,757896,378271,2021-05-29,1622242800.0
7834,27,1,2021-05-30,113,81,758009,378352,2021-05-30,1622329200.0
7835,27,1,2021-05-31,9390,7248,767399,385600,2021-05-31,1622415600.0
7836,27,1,2021-06-01,12167,6834,779566,392434,2021-06-01,1622502000.0
7837,27,1,2021-06-02,12872,5093,792438,397527,2021-06-02,1622588400.0
7838,27,1,2021-06-03,13586,4891,806024,402418,2021-06-03,1622674800.0
7839,27,1,2021-06-04,10636,6951,816660,409369,2021-06-04,1622761200.0
7840,27,1,2021-06-05,5164,2087,821824,411456,2021-06-05,1622847600.0
7841,27,1,2021-06-06,977,207,822801,411663,2021-06-06,1622934000.0
7842,27,1,2021-06-07,15757,9351,838558,421014,2021-06-07,1623020400.0
7843,27,1,2021-06-08,17212,9544,855770,430558,2021-06-08,1623106800.0
7844,27,1,2021-06-09,17186,7971,872956,438529,2021-06-09,1623193200.0
7845,27,1,2021-06-10,16621,8247,889577,446776,2021-06-10,1623279600.0
7846,27,1,2021-06-11,14843,9981,904420,456757,2021-06-11,1623366000.0
7847,27,1,2021-06-12,7518,4606,911938,461363,2021-06-12,1623452400.0
7848,27,1,2021-06-13,725,558,912663,461921,2021-06-13,1623538800.0
7849,27,1,2021-06-14,9719,13431,922382,475352,2021-06-14,1623625200.0
7850,27,1,2021-06-15,12102,11703,934484,487055,2021-06-15,1623711600.0
7851,27,1,2021-06-16,13115,10538,947599,497593,2021-06-16,1623798000.0
7852,27,1,2021-06-17,13377,10161,960976,507754,2021-06-17,1623884400.0
7853,27,1,2021-06-18,12217,12097,973193,519851,2021-06-18,1623970800.0
7854,27,1,2021-06-19,6287,5904,979480,525755,2021-06-19,1624057200.0
7855,27,1,2021-06-20,73,339,979553,526094,2021-06-20,1624143600.0
7856,27,1,2021-06-21,6979,14349,986532,540443,2021-06-21,1624230000.0
7857,27,1,2021-06-22,8214,17374,994746,557817,2021-06-22,1624316400.0
7858,27,1,2021-06-23,10146,13063,1004892,570880,2021-06-23,1624402800.0
7859,27,1,2021-06-24,8918,10759,1013810,581639,2021-06-24,1624489200.0
7860,27,1,2021-06-25,7382,17473,1021192,599112,2021-06-25,1624575600.0
7861,27,1,2021-06-26,4162,8340,1025354,607452,2021-06-26,1624662000.0
7862,27,1,2021-06-27,578,1302,1025932,608754,2021-06-27,1624748400.0
7863,27,1,2021-06-28,5633,17019,1031565,625773,2021-06-28,1624834800.0
7864,27,1,2021-06-29,6140,17127,1037705,642900,2021-06-29,1624921200.0
7865,27,1,2021-06-30,8137,17684,1045842,660584,2021-06-30,1625007600.0
7866,27,1,2021-07-01,7970,15218,1053812,675802,2021-07-01,1625094000.0
7867,27,1,2021-07-02,9158,12415,1062970,688217,2021-07-02,1625180400.0
7868,27,1,2021-07-03,3764,6321,1066734,694538,2021-07-03,1625266800.0
7869,27,1,2021-07-04,430,691,1067164,695229,2021-07-04,1625353200.0
7870,27,1,2021-07-05,8163,11898,1075327,707127,2021-07-05,1625439600.0
7871,27,1,2021-07-06,8175,14535,1083502,721662,2021-07-06,1625526000.0
7872,27,2,2020-12-27,0,0,0,0,2020-12-27,1609023600.0
7873,27,2,2020-12-28,0,0,0,0,2020-12-28,1609110000.0
7874,27,2,2020-12-29,0,0,0,0,2020-12-29,1609196400.0
7875,27,2,2020-12-30,0,0,0,0,2020-12-30,1609282800.0
7876,27,2,2020-12-31,0,0,0,0,2020-12-31,1609369200.0
7877,27,2,2021-01-01,0,0,0,0,2021-01-01,1609455600.0
7878,27,2,2021-01-02,0,0,0,0,2021-01-02,1609542000.0
7879,27,2,2021-01-03,0,0,0,0,2021-01-03,1609628400.0
7880,27,2,2021-01-04,0,0,0,0,2021-01-04,1609714800.0
7881,27,2,2021-01-05,0,0,0,0,2021-01-05,1609801200.0
7882,27,2,2021-01-06,0,0,0,0,2021-01-06,1609887600.0
7883,27,2,2021-01-07,0,0,0,0,2021-01-07,1609974000.0
7884,27,2,2021-01-08,0,0,0,0,2021-01-08,1610060400.0
7885,27,2,2021-01-09,0,0,0,0,2021-01-09,1610146800.0
7886,27,2,2021-01-10,0,0,0,0,2021-01-10,1610233200.0
7887,27,2,2021-01-11,0,0,0,0,2021-01-11,1610319600.0
7888,27,2,2021-01-12,0,0,0,0,2021-01-12,1610406000.0
7889,27,2,2021-01-13,0,0,0,0,2021-01-13,1610492400.0
7890,27,2,2021-01-14,16,0,16,0,2021-01-14,1610578800.0
7891,27,2,2021-01-15,9,0,25,0,2021-01-15,1610665200.0
7892,27,2,2021-01-16,14,0,39,0,2021-01-16,1610751600.0
7893,27,2,2021-01-17,0,0,39,0,2021-01-17,1610838000.0
7894,27,2,2021-01-18,862,0,901,0,2021-01-18,1610924400.0
7895,27,2,2021-01-19,1142,0,2043,0,2021-01-19,1611010800.0
7896,27,2,2021-01-20,1311,0,3354,0,2021-01-20,1611097200.0
7897,27,2,2021-01-21,1417,0,4771,0,2021-01-21,1611183600.0
7898,27,2,2021-01-22,1309,0,6080,0,2021-01-22,1611270000.0
7899,27,2,2021-01-23,568,0,6648,0,2021-01-23,1611356400.0
7900,27,2,2021-01-24,0,0,6648,0,2021-01-24,1611442800.0
7901,27,2,2021-01-25,1185,0,7833,0,2021-01-25,1611529200.0
7902,27,2,2021-01-26,1438,0,9271,0,2021-01-26,1611615600.0
7903,27,2,2021-01-27,1361,0,10632,0,2021-01-27,1611702000.0
7904,27,2,2021-01-28,1290,0,11922,0,2021-01-28,1611788400.0
7905,27,2,2021-01-29,1101,0,13023,0,2021-01-29,1611874800.0
7906,27,2,2021-01-30,477,0,13500,0,2021-01-30,1611961200.0
7907,27,2,2021-01-31,0,0,13500,0,2021-01-31,1612047600.0
7908,27,2,2021-02-01,1287,0,14787,0,2021-02-01,1612134000.0
7909,27,2,2021-02-02,1779,0,16566,0,2021-02-02,1612220400.0
7910,27,2,2021-02-03,1995,0,18561,0,2021-02-03,1612306800.0
7911,27,2,2021-02-04,2128,1,20689,1,2021-02-04,1612393200.0
7912,27,2,2021-02-05,2002,2,22691,3,2021-02-05,1612479600.0
7913,27,2,2021-02-06,942,2,23633,5,2021-02-06,1612566000.0
7914,27,2,2021-02-07,2,0,23635,5,2021-02-07,1612652400.0
7915,27,2,2021-02-08,2112,0,25747,5,2021-02-08,1612738800.0
7916,27,2,2021-02-09,1907,1,27654,6,2021-02-09,1612825200.0
7917,27,2,2021-02-10,1709,1,29363,7,2021-02-10,1612911600.0
7918,27,2,2021-02-11,1459,12,30822,19,2021-02-11,1612998000.0
7919,27,2,2021-02-12,1138,12,31960,31,2021-02-12,1613084400.0
7920,27,2,2021-02-13,444,68,32404,99,2021-02-13,1613170800.0
7921,27,2,2021-02-14,9,0,32413,99,2021-02-14,1613257200.0
7922,27,2,2021-02-15,172,844,32585,943,2021-02-15,1613343600.0
7923,27,2,2021-02-16,162,1050,32747,1993,2021-02-16,1613430000.0
7924,27,2,2021-02-17,14,1195,32761,3188,2021-02-17,1613516400.0
7925,27,2,2021-02-18,123,1469,32884,4657,2021-02-18,1613602800.0
7926,27,2,2021-02-19,66,1203,32950,5860,2021-02-19,1613689200.0
7927,27,2,2021-02-20,56,579,33006,6439,2021-02-20,1613775600.0
7928,27,2,2021-02-21,0,0,33006,6439,2021-02-21,1613862000.0
7929,27,2,2021-02-22,20,1232,33026,7671,2021-02-22,1613948400.0
7930,27,2,2021-02-23,8,1344,33034,9015,2021-02-23,1614034800.0
7931,27,2,2021-02-24,29,1308,33063,10323,2021-02-24,1614121200.0
7932,27,2,2021-02-25,24,1266,33087,11589,2021-02-25,1614207600.0
7933,27,2,2021-02-26,38,1235,33125,12824,2021-02-26,1614294000.0
7934,27,2,2021-02-27,3,453,33128,13277,2021-02-27,1614380400.0
7935,27,2,2021-02-28,1,1,33129,13278,2021-02-28,1614466800.0
7936,27,2,2021-03-01,74,1571,33203,14849,2021-03-01,1614553200.0
7937,27,2,2021-03-02,80,2105,33283,16954,2021-03-02,1614639600.0
7938,27,2,2021-03-03,103,1906,33386,18860,2021-03-03,1614726000.0
7939,27,2,2021-03-04,143,1772,33529,20632,2021-03-04,1614812400.0
7940,27,2,2021-03-05,113,1631,33642,22263,2021-03-05,1614898800.0
7941,27,2,2021-03-06,87,649,33729,22912,2021-03-06,1614985200.0
7942,27,2,2021-03-07,0,6,33729,22918,2021-03-07,1615071600.0
7943,27,2,2021-03-08,157,2470,33886,25388,2021-03-08,1615158000.0
7944,27,2,2021-03-09,229,1865,34115,27253,2021-03-09,1615244400.0
7945,27,2,2021-03-10,171,1586,34286,28839,2021-03-10,1615330800.0
7946,27,2,2021-03-11,156,1428,34442,30267,2021-03-11,1615417200.0
7947,27,2,2021-03-12,205,1038,34647,31305,2021-03-12,1615503600.0
7948,27,2,2021-03-13,142,300,34789,31605,2021-03-13,1615590000.0
7949,27,2,2021-03-14,0,47,34789,31652,2021-03-14,1615676400.0
7950,27,2,2021-03-15,677,347,35466,31999,2021-03-15,1615762800.0
7951,27,2,2021-03-16,1239,157,36705,32156,2021-03-16,1615849200.0
7952,27,2,2021-03-17,1942,18,38647,32174,2021-03-17,1615935600.0
7953,27,2,2021-03-18,1591,104,40238,32278,2021-03-18,1616022000.0
7954,27,2,2021-03-19,1336,125,41574,32403,2021-03-19,1616108400.0
7955,27,2,2021-03-20,1377,37,42951,32440,2021-03-20,1616194800.0
7956,27,2,2021-03-21,161,0,43112,32440,2021-03-21,1616281200.0
7957,27,2,2021-03-22,980,11,44092,32451,2021-03-22,1616367600.0
7958,27,2,2021-03-23,1222,7,45314,32458,2021-03-23,1616454000.0
7959,27,2,2021-03-24,2112,4,47426,32462,2021-03-24,1616540400.0
7960,27,2,2021-03-25,2368,19,49794,32481,2021-03-25,1616626800.0
7961,27,2,2021-03-26,1399,37,51193,32518,2021-03-26,1616713200.0
7962,27,2,2021-03-27,1016,0,52209,32518,2021-03-27,1616799600.0
7963,27,2,2021-03-28,193,0,52402,32518,2021-03-28,1616886000.0
7964,27,2,2021-03-29,821,66,53223,32584,2021-03-29,1616972400.0
7965,27,2,2021-03-30,1445,62,54668,32646,2021-03-30,1617058800.0
7966,27,2,2021-03-31,2577,67,57245,32713,2021-03-31,1617145200.0
7967,27,2,2021-04-01,3302,135,60547,32848,2021-04-01,1617231600.0
7968,27,2,2021-04-02,2538,64,63085,32912,2021-04-02,1617318000.0
7969,27,2,2021-04-03,846,61,63931,32973,2021-04-03,1617404400.0
7970,27,2,2021-04-04,3,3,63934,32976,2021-04-04,1617490800.0
7971,27,2,2021-04-05,1,0,63935,32976,2021-04-05,1617577200.0
7972,27,2,2021-04-06,1873,278,65808,33254,2021-04-06,1617663600.0
7973,27,2,2021-04-07,1912,61,67720,33315,2021-04-07,1617750000.0
7974,27,2,2021-04-08,2953,188,70673,33503,2021-04-08,1617836400.0
7975,27,2,2021-04-09,2154,255,72827,33758,2021-04-09,1617922800.0
7976,27,2,2021-04-10,585,125,73412,33883,2021-04-10,1618009200.0
7977,27,2,2021-04-11,120,0,73532,33883,2021-04-11,1618095600.0
7978,27,2,2021-04-12,278,717,73810,34600,2021-04-12,1618185600.0
7979,27,2,2021-04-13,341,1162,74151,35762,2021-04-13,1618272000.0
7980,27,2,2021-04-14,319,1805,74470,37567,2021-04-14,1618358400.0
7981,27,2,2021-04-15,360,1453,74830,39020,2021-04-15,1618444800.0
7982,27,2,2021-04-16,388,1204,75218,40224,2021-04-16,1618531200.0
7983,27,2,2021-04-17,99,962,75317,41186,2021-04-17,1618617600.0
7984,27,2,2021-04-18,2,148,75319,41334,2021-04-18,1618704000.0
7985,27,2,2021-04-19,756,1158,76075,42492,2021-04-19,1618790400.0
7986,27,2,2021-04-20,1120,1051,77195,43543,2021-04-20,1618876800.0
7987,27,2,2021-04-21,1475,1965,78670,45508,2021-04-21,1618963200.0
7988,27,2,2021-04-22,2008,2440,80678,47948,2021-04-22,1619049600.0
7989,27,2,2021-04-23,2109,1485,82787,49433,2021-04-23,1619136000.0
7990,27,2,2021-04-24,1392,672,84179,50105,2021-04-24,1619222400.0
7991,27,2,2021-04-25,59,163,84238,50268,2021-04-25,1619308800.0
7992,27,2,2021-04-26,240,886,84478,51154,2021-04-26,1619395200.0
7993,27,2,2021-04-27,784,1551,85262,52705,2021-04-27,1619481600.0
7994,27,2,2021-04-28,1413,2367,86675,55072,2021-04-28,1619568000.0
7995,27,2,2021-04-29,839,2947,87514,58019,2021-04-29,1619654400.0
7996,27,2,2021-04-30,332,2154,87846,60173,2021-04-30,1619740800.0
7997,27,2,2021-05-01,6,96,87852,60269,2021-05-01,1619827200.0
7998,27,2,2021-05-02,0,0,87852,60269,2021-05-02,1619913600.0
7999,27,2,2021-05-03,278,421,88130,60690,2021-05-03,1620000000.0
8000,27,2,2021-05-04,235,1984,88365,62674,2021-05-04,1620086400.0
8001,27,2,2021-05-05,143,2044,88508,64718,2021-05-05,1620172800.0
8002,27,2,2021-05-06,253,2674,88761,67392,2021-05-06,1620259200.0
8003,27,2,2021-05-07,308,2147,89069,69539,2021-05-07,1620345600.0
8004,27,2,2021-05-08,26,202,89095,69741,2021-05-08,1620432000.0
8005,27,2,2021-05-09,72,140,89167,69881,2021-05-09,1620518400.0
8006,27,2,2021-05-10,662,339,89829,70220,2021-05-10,1620604800.0
8007,27,2,2021-05-11,1272,560,91101,70780,2021-05-11,1620691200.0
8008,27,2,2021-05-12,1722,376,92823,71156,2021-05-12,1620777600.0
8009,27,2,2021-05-13,2735,78,95558,71234,2021-05-13,1620864000.0
8010,27,2,2021-05-14,3506,256,99064,71490,2021-05-14,1620950400.0
8011,27,2,2021-05-15,6778,57,105842,71547,2021-05-15,1621036800.0
8012,27,2,2021-05-16,330,1,106172,71548,2021-05-16,1621123200.0
8013,27,2,2021-05-17,2533,299,108705,71847,2021-05-17,1621206000.0
8014,27,2,2021-05-18,2635,845,111340,72692,2021-05-18,1621292400.0
8015,27,2,2021-05-19,1429,270,112769,72962,2021-05-19,1621378800.0
8016,27,2,2021-05-20,1965,226,114734,73188,2021-05-20,1621465200.0
8017,27,2,2021-05-21,2679,363,117413,73551,2021-05-21,1621551600.0
8018,27,2,2021-05-22,997,103,118410,73654,2021-05-22,1621638000.0
8019,27,2,2021-05-23,0,3,118410,73657,2021-05-23,1621724400.0
8020,27,2,2021-05-24,2187,18,120597,73675,2021-05-24,1621810800.0
8021,27,2,2021-05-25,2318,344,122915,74019,2021-05-25,1621897200.0
8022,27,2,2021-05-26,2683,292,125598,74311,2021-05-26,1621983600.0
8023,27,2,2021-05-27,2561,262,128159,74573,2021-05-27,1622070000.0
8024,27,2,2021-05-28,3013,426,131172,74999,2021-05-28,1622156400.0
8025,27,2,2021-05-29,2295,169,133467,75168,2021-05-29,1622242800.0
8026,27,2,2021-05-30,211,18,133678,75186,2021-05-30,1622329200.0
8027,27,2,2021-05-31,3260,790,136938,75976,2021-05-31,1622415600.0
8028,27,2,2021-06-01,3370,1371,140308,77347,2021-06-01,1622502000.0
8029,27,2,2021-06-02,2696,1912,143004,79259,2021-06-02,1622588400.0
8030,27,2,2021-06-03,3156,1086,146160,80345,2021-06-03,1622674800.0
8031,27,2,2021-06-04,4305,1386,150465,81731,2021-06-04,1622761200.0
8032,27,2,2021-06-05,2617,1107,153082,82838,2021-06-05,1622847600.0
8033,27,2,2021-06-06,679,50,153761,82888,2021-06-06,1622934000.0
8034,27,2,2021-06-07,1219,741,154980,83629,2021-06-07,1623020400.0
8035,27,2,2021-06-08,1834,1232,156814,84861,2021-06-08,1623106800.0
8036,27,2,2021-06-09,1358,743,158172,85604,2021-06-09,1623193200.0
8037,27,2,2021-06-10,1658,301,159830,85905,2021-06-10,1623279600.0
8038,27,2,2021-06-11,2415,478,162245,86383,2021-06-11,1623366000.0
8039,27,2,2021-06-12,1563,169,163808,86552,2021-06-12,1623452400.0
8040,27,2,2021-06-13,147,10,163955,86562,2021-06-13,1623538800.0
8041,27,2,2021-06-14,1049,415,165004,86977,2021-06-14,1623625200.0
8042,27,2,2021-06-15,1487,329,166491,87306,2021-06-15,1623711600.0
8043,27,2,2021-06-16,1154,426,167645,87732,2021-06-16,1623798000.0
8044,27,2,2021-06-17,1277,399,168922,88131,2021-06-17,1623884400.0
8045,27,2,2021-06-18,1952,844,170874,88975,2021-06-18,1623970800.0
8046,27,2,2021-06-19,1031,299,171905,89274,2021-06-19,1624057200.0
8047,27,2,2021-06-20,86,7,171991,89281,2021-06-20,1624143600.0
8048,27,2,2021-06-21,548,1984,172539,91265,2021-06-21,1624230000.0
8049,27,2,2021-06-22,1014,2052,173553,93317,2021-06-22,1624316400.0
8050,27,2,2021-06-23,838,2594,174391,95911,2021-06-23,1624402800.0
8051,27,2,2021-06-24,1136,1958,175527,97869,2021-06-24,1624489200.0
8052,27,2,2021-06-25,1450,3753,176977,101622,2021-06-25,1624575600.0
8053,27,2,2021-06-26,665,5108,177642,106730,2021-06-26,1624662000.0
8054,27,2,2021-06-27,51,334,177693,107064,2021-06-27,1624748400.0
8055,27,2,2021-06-28,391,2786,178084,109850,2021-06-28,1624834800.0
8056,27,2,2021-06-29,706,3370,178790,113220,2021-06-29,1624921200.0
8057,27,2,2021-06-30,614,1892,179404,115112,2021-06-30,1625007600.0
8058,27,2,2021-07-01,803,2266,180207,117378,2021-07-01,1625094000.0
8059,27,2,2021-07-02,1044,2633,181251,120011,2021-07-02,1625180400.0
8060,27,2,2021-07-03,616,801,181867,120812,2021-07-03,1625266800.0
8061,27,2,2021-07-04,63,102,181930,120914,2021-07-04,1625353200.0
8062,27,2,2021-07-05,323,2900,182253,123814,2021-07-05,1625439600.0
8063,27,2,2021-07-06,478,2571,182731,126385,2021-07-06,1625526000.0
8064,27,3,2020-12-27,0,0,0,0,2020-12-27,1609023600.0
8065,27,3,2020-12-28,0,0,0,0,2020-12-28,1609110000.0
8066,27,3,2020-12-29,0,0,0,0,2020-12-29,1609196400.0
8067,27,3,2020-12-30,0,0,0,0,2020-12-30,1609282800.0
8068,27,3,2020-12-31,0,0,0,0,2020-12-31,1609369200.0
8069,27,3,2021-01-01,0,0,0,0,2021-01-01,1609455600.0
8070,27,3,2021-01-02,0,0,0,0,2021-01-02,1609542000.0
8071,27,3,2021-01-03,0,0,0,0,2021-01-03,1609628400.0
8072,27,3,2021-01-04,0,0,0,0,2021-01-04,1609714800.0
8073,27,3,2021-01-05,0,0,0,0,2021-01-05,1609801200.0
8074,27,3,2021-01-06,0,0,0,0,2021-01-06,1609887600.0
8075,27,3,2021-01-07,0,0,0,0,2021-01-07,1609974000.0
8076,27,3,2021-01-08,0,0,0,0,2021-01-08,1610060400.0
8077,27,3,2021-01-09,0,0,0,0,2021-01-09,1610146800.0
8078,27,3,2021-01-10,0,0,0,0,2021-01-10,1610233200.0
8079,27,3,2021-01-11,0,0,0,0,2021-01-11,1610319600.0
8080,27,3,2021-01-12,0,0,0,0,2021-01-12,1610406000.0
8081,27,3,2021-01-13,0,0,0,0,2021-01-13,1610492400.0
8082,27,3,2021-01-14,0,0,0,0,2021-01-14,1610578800.0
8083,27,3,2021-01-15,0,0,0,0,2021-01-15,1610665200.0
8084,27,3,2021-01-16,0,0,0,0,2021-01-16,1610751600.0
8085,27,3,2021-01-17,0,0,0,0,2021-01-17,1610838000.0
8086,27,3,2021-01-18,0,0,0,0,2021-01-18,1610924400.0
8087,27,3,2021-01-19,0,0,0,0,2021-01-19,1611010800.0
8088,27,3,2021-01-20,0,0,0,0,2021-01-20,1611097200.0
8089,27,3,2021-01-21,0,0,0,0,2021-01-21,1611183600.0
8090,27,3,2021-01-22,0,0,0,0,2021-01-22,1611270000.0
8091,27,3,2021-01-23,0,0,0,0,2021-01-23,1611356400.0
8092,27,3,2021-01-24,0,0,0,0,2021-01-24,1611442800.0
8093,27,3,2021-01-25,0,0,0,0,2021-01-25,1611529200.0
8094,27,3,2021-01-26,0,0,0,0,2021-01-26,1611615600.0
8095,27,3,2021-01-27,0,0,0,0,2021-01-27,1611702000.0
8096,27,3,2021-01-28,0,0,0,0,2021-01-28,1611788400.0
8097,27,3,2021-01-29,0,0,0,0,2021-01-29,1611874800.0
8098,27,3,2021-01-30,0,0,0,0,2021-01-30,1611961200.0
8099,27,3,2021-01-31,0,0,0,0,2021-01-31,1612047600.0
8100,27,3,2021-02-01,0,0,0,0,2021-02-01,1612134000.0
8101,27,3,2021-02-02,0,0,0,0,2021-02-02,1612220400.0
8102,27,3,2021-02-03,0,0,0,0,2021-02-03,1612306800.0
8103,27,3,2021-02-04,0,0,0,0,2021-02-04,1612393200.0
8104,27,3,2021-02-05,0,0,0,0,2021-02-05,1612479600.0
8105,27,3,2021-02-06,4,0,4,0,2021-02-06,1612566000.0
8106,27,3,2021-02-07,0,0,4,0,2021-02-07,1612652400.0
8107,27,3,2021-02-08,57,0,61,0,2021-02-08,1612738800.0
8108,27,3,2021-02-09,260,0,321,0,2021-02-09,1612825200.0
8109,27,3,2021-02-10,578,0,899,0,2021-02-10,1612911600.0
8110,27,3,2021-02-11,368,0,1267,0,2021-02-11,1612998000.0
8111,27,3,2021-02-12,464,0,1731,0,2021-02-12,1613084400.0
8112,27,3,2021-02-13,268,0,1999,0,2021-02-13,1613170800.0
8113,27,3,2021-02-14,221,0,2220,0,2021-02-14,1613257200.0
8114,27,3,2021-02-15,322,0,2542,0,2021-02-15,1613343600.0
8115,27,3,2021-02-16,328,0,2870,0,2021-02-16,1613430000.0
8116,27,3,2021-02-17,374,0,3244,0,2021-02-17,1613516400.0
8117,27,3,2021-02-18,516,0,3760,0,2021-02-18,1613602800.0
8118,27,3,2021-02-19,329,0,4089,0,2021-02-19,1613689200.0
8119,27,3,2021-02-20,114,0,4203,0,2021-02-20,1613775600.0
8120,27,3,2021-02-21,1,0,4204,0,2021-02-21,1613862000.0
8121,27,3,2021-02-22,410,0,4614,0,2021-02-22,1613948400.0
8122,27,3,2021-02-23,581,0,5195,0,2021-02-23,1614034800.0
8123,27,3,2021-02-24,803,0,5998,0,2021-02-24,1614121200.0
8124,27,3,2021-02-25,2152,0,8150,0,2021-02-25,1614207600.0
8125,27,3,2021-02-26,2818,0,10968,0,2021-02-26,1614294000.0
8126,27,3,2021-02-27,1602,0,12570,0,2021-02-27,1614380400.0
8127,27,3,2021-02-28,102,0,12672,0,2021-02-28,1614466800.0
8128,27,3,2021-03-01,1109,0,13781,0,2021-03-01,1614553200.0
8129,27,3,2021-03-02,2080,0,15861,0,2021-03-02,1614639600.0
8130,27,3,2021-03-03,2304,1,18165,1,2021-03-03,1614726000.0
8131,27,3,2021-03-04,3228,1,21393,2,2021-03-04,1614812400.0
8132,27,3,2021-03-05,5373,0,26766,2,2021-03-05,1614898800.0
8133,27,3,2021-03-06,5125,1,31891,3,2021-03-06,1614985200.0
8134,27,3,2021-03-07,858,0,32749,3,2021-03-07,1615071600.0
8135,27,3,2021-03-08,1520,1,34269,4,2021-03-08,1615158000.0
8136,27,3,2021-03-09,3615,3,37884,7,2021-03-09,1615244400.0
8137,27,3,2021-03-10,3285,1,41169,8,2021-03-10,1615330800.0
8138,27,3,2021-03-11,4494,0,45663,8,2021-03-11,1615417200.0
8139,27,3,2021-03-12,6531,3,52194,11,2021-03-12,1615503600.0
8140,27,3,2021-03-13,5462,1,57656,12,2021-03-13,1615590000.0
8141,27,3,2021-03-14,210,0,57866,12,2021-03-14,1615676400.0
8142,27,3,2021-03-15,1628,1,59494,13,2021-03-15,1615762800.0
8143,27,3,2021-03-16,30,0,59524,13,2021-03-16,1615849200.0
8144,27,3,2021-03-17,26,1,59550,14,2021-03-17,1615935600.0
8145,27,3,2021-03-18,68,1,59618,15,2021-03-18,1616022000.0
8146,27,3,2021-03-19,3001,2,62619,17,2021-03-19,1616108400.0
8147,27,3,2021-03-20,3081,1,65700,18,2021-03-20,1616194800.0
8148,27,3,2021-03-21,75,0,65775,18,2021-03-21,1616281200.0
8149,27,3,2021-03-22,1199,0,66974,18,2021-03-22,1616367600.0
8150,27,3,2021-03-23,3957,3,70931,21,2021-03-23,1616454000.0
8151,27,3,2021-03-24,4197,3,75128,24,2021-03-24,1616540400.0
8152,27,3,2021-03-25,6745,9,81873,33,2021-03-25,1616626800.0
8153,27,3,2021-03-26,7664,15,89537,48,2021-03-26,1616713200.0
8154,27,3,2021-03-27,2942,20,92479,68,2021-03-27,1616799600.0
8155,27,3,2021-03-28,197,0,92676,68,2021-03-28,1616886000.0
8156,27,3,2021-03-29,2400,4,95076,72,2021-03-29,1616972400.0
8157,27,3,2021-03-30,4376,1,99452,73,2021-03-30,1617058800.0
8158,27,3,2021-03-31,2923,7,102375,80,2021-03-31,1617145200.0
8159,27,3,2021-04-01,3975,3,106350,83,2021-04-01,1617231600.0
8160,27,3,2021-04-02,3959,18,110309,101,2021-04-02,1617318000.0
8161,27,3,2021-04-03,1511,3,111820,104,2021-04-03,1617404400.0
8162,27,3,2021-04-04,27,0,111847,104,2021-04-04,1617490800.0
8163,27,3,2021-04-05,137,0,111984,104,2021-04-05,1617577200.0
8164,27,3,2021-04-06,1450,22,113434,126,2021-04-06,1617663600.0
8165,27,3,2021-04-07,1426,3,114860,129,2021-04-07,1617750000.0
8166,27,3,2021-04-08,4224,5,119084,134,2021-04-08,1617836400.0
8167,27,3,2021-04-09,7674,21,126758,155,2021-04-09,1617922800.0
8168,27,3,2021-04-10,3546,31,130304,186,2021-04-10,1618009200.0
8169,27,3,2021-04-11,223,1,130527,187,2021-04-11,1618095600.0
8170,27,3,2021-04-12,1924,8,132451,195,2021-04-12,1618185600.0
8171,27,3,2021-04-13,4077,14,136528,209,2021-04-13,1618272000.0
8172,27,3,2021-04-14,2721,23,139249,232,2021-04-14,1618358400.0
8173,27,3,2021-04-15,4097,14,143346,246,2021-04-15,1618444800.0
8174,27,3,2021-04-16,4854,7,148200,253,2021-04-16,1618531200.0
8175,27,3,2021-04-17,2181,5,150381,258,2021-04-17,1618617600.0
8176,27,3,2021-04-18,270,0,150651,258,2021-04-18,1618704000.0
8177,27,3,2021-04-19,1011,10,151662,268,2021-04-19,1618790400.0
8178,27,3,2021-04-20,2081,18,153743,286,2021-04-20,1618876800.0
8179,27,3,2021-04-21,1583,60,155326,346,2021-04-21,1618963200.0
8180,27,3,2021-04-22,2391,87,157717,433,2021-04-22,1619049600.0
8181,27,3,2021-04-23,3296,93,161013,526,2021-04-23,1619136000.0
8182,27,3,2021-04-24,1604,38,162617,564,2021-04-24,1619222400.0
8183,27,3,2021-04-25,87,0,162704,564,2021-04-25,1619308800.0
8184,27,3,2021-04-26,731,34,163435,598,2021-04-26,1619395200.0
8185,27,3,2021-04-27,1787,42,165222,640,2021-04-27,1619481600.0
8186,27,3,2021-04-28,1156,127,166378,767,2021-04-28,1619568000.0
8187,27,3,2021-04-29,2458,317,168836,1084,2021-04-29,1619654400.0
8188,27,3,2021-04-30,3021,381,171857,1465,2021-04-30,1619740800.0
8189,27,3,2021-05-01,221,166,172078,1631,2021-05-01,1619827200.0
8190,27,3,2021-05-02,18,20,172096,1651,2021-05-02,1619913600.0
8191,27,3,2021-05-03,531,173,172627,1824,2021-05-03,1620000000.0
8192,27,3,2021-05-04,1135,369,173762,2193,2021-05-04,1620086400.0
8193,27,3,2021-05-05,758,471,174520,2664,2021-05-05,1620172800.0
8194,27,3,2021-05-06,1788,922,176308,3586,2021-05-06,1620259200.0
8195,27,3,2021-05-07,2324,1411,178632,4997,2021-05-07,1620345600.0
8196,27,3,2021-05-08,284,279,178916,5276,2021-05-08,1620432000.0
8197,27,3,2021-05-09,70,122,178986,5398,2021-05-09,1620518400.0
8198,27,3,2021-05-10,663,497,179649,5895,2021-05-10,1620604800.0
8199,27,3,2021-05-11,1353,1233,181002,7128,2021-05-11,1620691200.0
8200,27,3,2021-05-12,808,1109,181810,8237,2021-05-12,1620777600.0
8201,27,3,2021-05-13,86,183,181896,8420,2021-05-13,1620864000.0
8202,27,3,2021-05-14,699,974,182595,9394,2021-05-14,1620950400.0
8203,27,3,2021-05-15,307,1054,182902,10448,2021-05-15,1621036800.0
8204,27,3,2021-05-16,18,21,182920,10469,2021-05-16,1621123200.0
8205,27,3,2021-05-17,315,539,183235,11008,2021-05-17,1621206000.0
8206,27,3,2021-05-18,532,1296,183767,12304,2021-05-18,1621292400.0
8207,27,3,2021-05-19,351,1229,184118,13533,2021-05-19,1621378800.0
8208,27,3,2021-05-20,568,2041,184686,15574,2021-05-20,1621465200.0
8209,27,3,2021-05-21,659,2617,185345,18191,2021-05-21,1621551600.0
8210,27,3,2021-05-22,284,1663,185629,19854,2021-05-22,1621638000.0
8211,27,3,2021-05-23,23,104,185652,19958,2021-05-23,1621724400.0
8212,27,3,2021-05-24,50,179,185702,20137,2021-05-24,1621810800.0
8213,27,3,2021-05-25,111,1905,185813,22042,2021-05-25,1621897200.0
8214,27,3,2021-05-26,195,2009,186008,24051,2021-05-26,1621983600.0
8215,27,3,2021-05-27,254,3228,186262,27279,2021-05-27,1622070000.0
8216,27,3,2021-05-28,356,3907,186618,31186,2021-05-28,1622156400.0
8217,27,3,2021-05-29,158,2215,186776,33401,2021-05-29,1622242800.0
8218,27,3,2021-05-30,34,99,186810,33500,2021-05-30,1622329200.0
8219,27,3,2021-05-31,91,1374,186901,34874,2021-05-31,1622415600.0
8220,27,3,2021-06-01,121,2915,187022,37789,2021-06-01,1622502000.0
8221,27,3,2021-06-02,81,2577,187103,40366,2021-06-02,1622588400.0
8222,27,3,2021-06-03,150,3565,187253,43931,2021-06-03,1622674800.0
8223,27,3,2021-06-04,171,3993,187424,47924,2021-06-04,1622761200.0
8224,27,3,2021-06-05,86,2485,187510,50409,2021-06-05,1622847600.0
8225,27,3,2021-06-06,4,210,187514,50619,2021-06-06,1622934000.0
8226,27,3,2021-06-07,26,1098,187540,51717,2021-06-07,1623020400.0
8227,27,3,2021-06-08,64,2352,187604,54069,2021-06-08,1623106800.0
8228,27,3,2021-06-09,60,1801,187664,55870,2021-06-09,1623193200.0
8229,27,3,2021-06-10,58,3058,187722,58928,2021-06-10,1623279600.0
8230,27,3,2021-06-11,114,4314,187836,63242,2021-06-11,1623366000.0
8231,27,3,2021-06-12,40,1945,187876,65187,2021-06-12,1623452400.0
8232,27,3,2021-06-13,21,226,187897,65413,2021-06-13,1623538800.0
8233,27,3,2021-06-14,28,1818,187925,67231,2021-06-14,1623625200.0
8234,27,3,2021-06-15,72,3789,187997,71020,2021-06-15,1623711600.0
8235,27,3,2021-06-16,56,2881,188053,73901,2021-06-16,1623798000.0
8236,27,3,2021-06-17,53,4734,188106,78635,2021-06-17,1623884400.0
8237,27,3,2021-06-18,83,5237,188189,83872,2021-06-18,1623970800.0
8238,27,3,2021-06-19,27,1427,188216,85299,2021-06-19,1624057200.0
8239,27,3,2021-06-20,0,74,188216,85373,2021-06-20,1624143600.0
8240,27,3,2021-06-21,10,1614,188226,86987,2021-06-21,1624230000.0
8241,27,3,2021-06-22,42,3398,188268,90385,2021-06-22,1624316400.0
8242,27,3,2021-06-23,24,2124,188292,92509,2021-06-23,1624402800.0
8243,27,3,2021-06-24,62,3659,188354,96168,2021-06-24,1624489200.0
8244,27,3,2021-06-25,73,4183,188427,100351,2021-06-25,1624575600.0
8245,27,3,2021-06-26,21,1526,188448,101877,2021-06-26,1624662000.0
8246,27,3,2021-06-27,21,167,188469,102044,2021-06-27,1624748400.0
8247,27,3,2021-06-28,19,1156,188488,103200,2021-06-28,1624834800.0
8248,27,3,2021-06-29,23,2858,188511,106058,2021-06-29,1624921200.0
8249,27,3,2021-06-30,25,1807,188536,107865,2021-06-30,1625007600.0
8250,27,3,2021-07-01,53,3393,188589,111258,2021-07-01,1625094000.0
8251,27,3,2021-07-02,34,4019,188623,115277,2021-07-02,1625180400.0
8252,27,3,2021-07-03,25,1401,188648,116678,2021-07-03,1625266800.0
8253,27,3,2021-07-04,7,184,188655,116862,2021-07-04,1625353200.0
8254,27,3,2021-07-05,8,1474,188663,118336,2021-07-05,1625439600.0
8255,27,3,2021-07-06,24,2721,188687,121057,2021-07-06,1625526000.0
8256,27,4,2020-12-27,0,0,0,0,2020-12-27,1609023600.0
8257,27,4,2020-12-28,0,0,0,0,2020-12-28,1609110000.0
8258,27,4,2020-12-29,0,0,0,0,2020-12-29,1609196400.0
8259,27,4,2020-12-30,0,0,0,0,2020-12-30,1609282800.0
8260,27,4,2020-12-31,0,0,0,0,2020-12-31,1609369200.0
8261,27,4,2021-01-01,0,0,0,0,2021-01-01,1609455600.0
8262,27,4,2021-01-02,0,0,0,0,2021-01-02,1609542000.0
8263,27,4,2021-01-03,0,0,0,0,2021-01-03,1609628400.0
8264,27,4,2021-01-04,0,0,0,0,2021-01-04,1609714800.0
8265,27,4,2021-01-05,0,0,0,0,2021-01-05,1609801200.0
8266,27,4,2021-01-06,0,0,0,0,2021-01-06,1609887600.0
8267,27,4,2021-01-07,0,0,0,0,2021-01-07,1609974000.0
8268,27,4,2021-01-08,0,0,0,0,2021-01-08,1610060400.0
8269,27,4,2021-01-09,0,0,0,0,2021-01-09,1610146800.0
8270,27,4,2021-01-10,0,0,0,0,2021-01-10,1610233200.0
8271,27,4,2021-01-11,0,0,0,0,2021-01-11,1610319600.0
8272,27,4,2021-01-12,0,0,0,0,2021-01-12,1610406000.0
8273,27,4,2021-01-13,0,0,0,0,2021-01-13,1610492400.0
8274,27,4,2021-01-14,0,0,0,0,2021-01-14,1610578800.0
8275,27,4,2021-01-15,0,0,0,0,2021-01-15,1610665200.0
8276,27,4,2021-01-16,0,0,0,0,2021-01-16,1610751600.0
8277,27,4,2021-01-17,0,0,0,0,2021-01-17,1610838000.0
8278,27,4,2021-01-18,0,0,0,0,2021-01-18,1610924400.0
8279,27,4,2021-01-19,0,0,0,0,2021-01-19,1611010800.0
8280,27,4,2021-01-20,0,0,0,0,2021-01-20,1611097200.0
8281,27,4,2021-01-21,0,0,0,0,2021-01-21,1611183600.0
8282,27,4,2021-01-22,0,0,0,0,2021-01-22,1611270000.0
8283,27,4,2021-01-23,0,0,0,0,2021-01-23,1611356400.0
8284,27,4,2021-01-24,0,0,0,0,2021-01-24,1611442800.0
8285,27,4,2021-01-25,0,0,0,0,2021-01-25,1611529200.0
8286,27,4,2021-01-26,0,0,0,0,2021-01-26,1611615600.0
8287,27,4,2021-01-27,0,0,0,0,2021-01-27,1611702000.0
8288,27,4,2021-01-28,0,0,0,0,2021-01-28,1611788400.0
8289,27,4,2021-01-29,0,0,0,0,2021-01-29,1611874800.0
8290,27,4,2021-01-30,0,0,0,0,2021-01-30,1611961200.0
8291,27,4,2021-01-31,0,0,0,0,2021-01-31,1612047600.0
8292,27,4,2021-02-01,0,0,0,0,2021-02-01,1612134000.0
8293,27,4,2021-02-02,0,0,0,0,2021-02-02,1612220400.0
8294,27,4,2021-02-03,0,0,0,0,2021-02-03,1612306800.0
8295,27,4,2021-02-04,0,0,0,0,2021-02-04,1612393200.0
8296,27,4,2021-02-05,0,0,0,0,2021-02-05,1612479600.0
8297,27,4,2021-02-06,0,0,0,0,2021-02-06,1612566000.0
8298,27,4,2021-02-07,0,0,0,0,2021-02-07,1612652400.0
8299,27,4,2021-02-08,0,0,0,0,2021-02-08,1612738800.0
8300,27,4,2021-02-09,0,0,0,0,2021-02-09,1612825200.0
8301,27,4,2021-02-10,0,0,0,0,2021-02-10,1612911600.0
8302,27,4,2021-02-11,0,0,0,0,2021-02-11,1612998000.0
8303,27,4,2021-02-12,0,0,0,0,2021-02-12,1613084400.0
8304,27,4,2021-02-13,0,0,0,0,2021-02-13,1613170800.0
8305,27,4,2021-02-14,0,0,0,0,2021-02-14,1613257200.0
8306,27,4,2021-02-15,0,0,0,0,2021-02-15,1613343600.0
8307,27,4,2021-02-16,0,0,0,0,2021-02-16,1613430000.0
8308,27,4,2021-02-17,0,0,0,0,2021-02-17,1613516400.0
8309,27,4,2021-02-18,0,0,0,0,2021-02-18,1613602800.0
8310,27,4,2021-02-19,0,0,0,0,2021-02-19,1613689200.0
8311,27,4,2021-02-20,0,0,0,0,2021-02-20,1613775600.0
8312,27,4,2021-02-21,0,0,0,0,2021-02-21,1613862000.0
8313,27,4,2021-02-22,0,0,0,0,2021-02-22,1613948400.0
8314,27,4,2021-02-23,0,0,0,0,2021-02-23,1614034800.0
8315,27,4,2021-02-24,0,0,0,0,2021-02-24,1614121200.0
8316,27,4,2021-02-25,0,0,0,0,2021-02-25,1614207600.0
8317,27,4,2021-02-26,0,0,0,0,2021-02-26,1614294000.0
8318,27,4,2021-02-27,0,0,0,0,2021-02-27,1614380400.0
8319,27,4,2021-02-28,0,0,0,0,2021-02-28,1614466800.0
8320,27,4,2021-03-01,0,0,0,0,2021-03-01,1614553200.0
8321,27,4,2021-03-02,0,0,0,0,2021-03-02,1614639600.0
8322,27,4,2021-03-03,0,0,0,0,2021-03-03,1614726000.0
8323,27,4,2021-03-04,0,0,0,0,2021-03-04,1614812400.0
8324,27,4,2021-03-05,0,0,0,0,2021-03-05,1614898800.0
8325,27,4,2021-03-06,0,0,0,0,2021-03-06,1614985200.0
8326,27,4,2021-03-07,0,0,0,0,2021-03-07,1615071600.0
8327,27,4,2021-03-08,0,0,0,0,2021-03-08,1615158000.0
8328,27,4,2021-03-09,0,0,0,0,2021-03-09,1615244400.0
8329,27,4,2021-03-10,0,0,0,0,2021-03-10,1615330800.0
8330,27,4,2021-03-11,0,0,0,0,2021-03-11,1615417200.0
8331,27,4,2021-03-12,0,0,0,0,2021-03-12,1615503600.0
8332,27,4,2021-03-13,0,0,0,0,2021-03-13,1615590000.0
8333,27,4,2021-03-14,0,0,0,0,2021-03-14,1615676400.0
8334,27,4,2021-03-15,0,0,0,0,2021-03-15,1615762800.0
8335,27,4,2021-03-16,0,0,0,0,2021-03-16,1615849200.0
8336,27,4,2021-03-17,0,0,0,0,2021-03-17,1615935600.0
8337,27,4,2021-03-18,0,0,0,0,2021-03-18,1616022000.0
8338,27,4,2021-03-19,0,0,0,0,2021-03-19,1616108400.0
8339,27,4,2021-03-20,0,0,0,0,2021-03-20,1616194800.0
8340,27,4,2021-03-21,0,0,0,0,2021-03-21,1616281200.0
8341,27,4,2021-03-22,0,0,0,0,2021-03-22,1616367600.0
8342,27,4,2021-03-23,0,0,0,0,2021-03-23,1616454000.0
8343,27,4,2021-03-24,0,0,0,0,2021-03-24,1616540400.0
8344,27,4,2021-03-25,0,0,0,0,2021-03-25,1616626800.0
8345,27,4,2021-03-26,0,0,0,0,2021-03-26,1616713200.0
8346,27,4,2021-03-27,0,0,0,0,2021-03-27,1616799600.0
8347,27,4,2021-03-28,0,0,0,0,2021-03-28,1616886000.0
8348,27,4,2021-03-29,0,0,0,0,2021-03-29,1616972400.0
8349,27,4,2021-03-30,0,0,0,0,2021-03-30,1617058800.0
8350,27,4,2021-03-31,0,0,0,0,2021-03-31,1617145200.0
8351,27,4,2021-04-01,0,0,0,0,2021-04-01,1617231600.0
8352,27,4,2021-04-02,0,0,0,0,2021-04-02,1617318000.0
8353,27,4,2021-04-03,0,0,0,0,2021-04-03,1617404400.0
8354,27,4,2021-04-04,0,0,0,0,2021-04-04,1617490800.0
8355,27,4,2021-04-05,0,0,0,0,2021-04-05,1617577200.0
8356,27,4,2021-04-06,0,0,0,0,2021-04-06,1617663600.0
8357,27,4,2021-04-07,0,0,0,0,2021-04-07,1617750000.0
8358,27,4,2021-04-08,0,0,0,0,2021-04-08,1617836400.0
8359,27,4,2021-04-09,0,0,0,0,2021-04-09,1617922800.0
8360,27,4,2021-04-10,0,0,0,0,2021-04-10,1618009200.0
8361,27,4,2021-04-11,0,0,0,0,2021-04-11,1618095600.0
8362,27,4,2021-04-12,0,0,0,0,2021-04-12,1618185600.0
8363,27,4,2021-04-13,0,0,0,0,2021-04-13,1618272000.0
8364,27,4,2021-04-14,0,0,0,0,2021-04-14,1618358400.0
8365,27,4,2021-04-15,0,0,0,0,2021-04-15,1618444800.0
8366,27,4,2021-04-16,0,0,0,0,2021-04-16,1618531200.0
8367,27,4,2021-04-17,0,0,0,0,2021-04-17,1618617600.0
8368,27,4,2021-04-18,0,0,0,0,2021-04-18,1618704000.0
8369,27,4,2021-04-19,0,0,0,0,2021-04-19,1618790400.0
8370,27,4,2021-04-20,0,0,0,0,2021-04-20,1618876800.0
8371,27,4,2021-04-21,0,0,0,0,2021-04-21,1618963200.0
8372,27,4,2021-04-22,0,0,0,0,2021-04-22,1619049600.0
8373,27,4,2021-04-23,8,0,8,0,2021-04-23,1619136000.0
8374,27,4,2021-04-24,0,0,8,0,2021-04-24,1619222400.0
8375,27,4,2021-04-25,0,0,8,0,2021-04-25,1619308800.0
8376,27,4,2021-04-26,6,0,14,0,2021-04-26,1619395200.0
8377,27,4,2021-04-27,223,0,237,0,2021-04-27,1619481600.0
8378,27,4,2021-04-28,446,0,683,0,2021-04-28,1619568000.0
8379,27,4,2021-04-29,899,1,1582,1,2021-04-29,1619654400.0
8380,27,4,2021-04-30,1032,1,2614,2,2021-04-30,1619740800.0
8381,27,4,2021-05-01,90,0,2704,2,2021-05-01,1619827200.0
8382,27,4,2021-05-02,18,0,2722,2,2021-05-02,1619913600.0
8383,27,4,2021-05-03,218,0,2940,2,2021-05-03,1620000000.0
8384,27,4,2021-05-04,501,0,3441,2,2021-05-04,1620086400.0
8385,27,4,2021-05-05,257,0,3698,2,2021-05-05,1620172800.0
8386,27,4,2021-05-06,598,0,4296,2,2021-05-06,1620259200.0
8387,27,4,2021-05-07,859,0,5155,2,2021-05-07,1620345600.0
8388,27,4,2021-05-08,164,0,5319,2,2021-05-08,1620432000.0
8389,27,4,2021-05-09,10,0,5329,2,2021-05-09,1620518400.0
8390,27,4,2021-05-10,351,1,5680,3,2021-05-10,1620604800.0
8391,27,4,2021-05-11,623,0,6303,3,2021-05-11,1620691200.0
8392,27,4,2021-05-12,420,0,6723,3,2021-05-12,1620777600.0
8393,27,4,2021-05-13,45,0,6768,3,2021-05-13,1620864000.0
8394,27,4,2021-05-14,383,0,7151,3,2021-05-14,1620950400.0
8395,27,4,2021-05-15,106,0,7257,3,2021-05-15,1621036800.0
8396,27,4,2021-05-16,1,0,7258,3,2021-05-16,1621123200.0
8397,27,4,2021-05-17,137,0,7395,3,2021-05-17,1621206000.0
8398,27,4,2021-05-18,246,0,7641,3,2021-05-18,1621292400.0
8399,27,4,2021-05-19,229,0,7870,3,2021-05-19,1621378800.0
8400,27,4,2021-05-20,364,2,8234,5,2021-05-20,1621465200.0
8401,27,4,2021-05-21,517,0,8751,5,2021-05-21,1621551600.0
8402,27,4,2021-05-22,289,0,9040,5,2021-05-22,1621638000.0
8403,27,4,2021-05-23,11,0,9051,5,2021-05-23,1621724400.0
8404,27,4,2021-05-24,78,0,9129,5,2021-05-24,1621810800.0
8405,27,4,2021-05-25,267,0,9396,5,2021-05-25,1621897200.0
8406,27,4,2021-05-26,346,2,9742,7,2021-05-26,1621983600.0
8407,27,4,2021-05-27,702,1,10444,8,2021-05-27,1622070000.0
8408,27,4,2021-05-28,1290,2,11734,10,2021-05-28,1622156400.0
8409,27,4,2021-05-29,560,0,12294,10,2021-05-29,1622242800.0
8410,27,4,2021-05-30,35,0,12329,10,2021-05-30,1622329200.0
8411,27,4,2021-05-31,568,0,12897,10,2021-05-31,1622415600.0
8412,27,4,2021-06-01,890,1,13787,11,2021-06-01,1622502000.0
8413,27,4,2021-06-02,516,0,14303,11,2021-06-02,1622588400.0
8414,27,4,2021-06-03,847,0,15150,11,2021-06-03,1622674800.0
8415,27,4,2021-06-04,1071,2,16221,13,2021-06-04,1622761200.0
8416,27,4,2021-06-05,478,0,16699,13,2021-06-05,1622847600.0
8417,27,4,2021-06-06,62,0,16761,13,2021-06-06,1622934000.0
8418,27,4,2021-06-07,431,1,17192,14,2021-06-07,1623020400.0
8419,27,4,2021-06-08,575,0,17767,14,2021-06-08,1623106800.0
8420,27,4,2021-06-09,452,0,18219,14,2021-06-09,1623193200.0
8421,27,4,2021-06-10,683,0,18902,14,2021-06-10,1623279600.0
8422,27,4,2021-06-11,745,0,19647,14,2021-06-11,1623366000.0
8423,27,4,2021-06-12,352,0,19999,14,2021-06-12,1623452400.0
8424,27,4,2021-06-13,60,1,20059,15,2021-06-13,1623538800.0
8425,27,4,2021-06-14,260,3,20319,18,2021-06-14,1623625200.0
8426,27,4,2021-06-15,471,1,20790,19,2021-06-15,1623711600.0
8427,27,4,2021-06-16,361,0,21151,19,2021-06-16,1623798000.0
8428,27,4,2021-06-17,448,0,21599,19,2021-06-17,1623884400.0
8429,27,4,2021-06-18,530,0,22129,19,2021-06-18,1623970800.0
8430,27,4,2021-06-19,324,0,22453,19,2021-06-19,1624057200.0
8431,27,4,2021-06-20,13,0,22466,19,2021-06-20,1624143600.0
8432,27,4,2021-06-21,224,0,22690,19,2021-06-21,1624230000.0
8433,27,4,2021-06-22,287,1,22977,20,2021-06-22,1624316400.0
8434,27,4,2021-06-23,250,0,23227,20,2021-06-23,1624402800.0
8435,27,4,2021-06-24,387,4,23614,24,2021-06-24,1624489200.0
8436,27,4,2021-06-25,446,1,24060,25,2021-06-25,1624575600.0
8437,27,4,2021-06-26,226,3,24286,28,2021-06-26,1624662000.0
8438,27,4,2021-06-27,13,0,24299,28,2021-06-27,1624748400.0
8439,27,4,2021-06-28,194,0,24493,28,2021-06-28,1624834800.0
8440,27,4,2021-06-29,283,1,24776,29,2021-06-29,1624921200.0
8441,27,4,2021-06-30,239,0,25015,29,2021-06-30,1625007600.0
8442,27,4,2021-07-01,357,1,25372,30,2021-07-01,1625094000.0
8443,27,4,2021-07-02,344,0,25716,30,2021-07-02,1625180400.0
8444,27,4,2021-07-03,200,0,25916,30,2021-07-03,1625266800.0
8445,27,4,2021-07-04,20,0,25936,30,2021-07-04,1625353200.0
8446,27,4,2021-07-05,167,0,26103,30,2021-07-05,1625439600.0
8447,27,4,2021-07-06,273,2,26376,32,2021-07-06,1625526000.0
8448,28,1,2020-12-27,0,0,0,0,2020-12-27,1609023600.0
8449,28,1,2020-12-28,1,0,1,0,2020-12-28,1609110000.0
8450,28,1,2020-12-29,2,0,3,0,2020-12-29,1609196400.0
8451,28,1,2020-12-30,0,0,3,0,2020-12-30,1609282800.0
8452,28,1,2020-12-31,1,0,4,0,2020-12-31,1609369200.0
8453,28,1,2021-01-01,1,0,5,0,2021-01-01,1609455600.0
8454,28,1,2021-01-02,1,0,6,0,2021-01-02,1609542000.0
8455,28,1,2021-01-03,1,0,7,0,2021-01-03,1609628400.0
8456,28,1,2021-01-04,16,0,23,0,2021-01-04,1609714800.0
8457,28,1,2021-01-05,169,0,192,0,2021-01-05,1609801200.0
8458,28,1,2021-01-06,1393,0,1585,0,2021-01-06,1609887600.0
8459,28,1,2021-01-07,2600,0,4185,0,2021-01-07,1609974000.0
8460,28,1,2021-01-08,3428,0,7613,0,2021-01-08,1610060400.0
8461,28,1,2021-01-09,1333,0,8946,0,2021-01-09,1610146800.0
8462,28,1,2021-01-10,705,0,9651,0,2021-01-10,1610233200.0
8463,28,1,2021-01-11,3178,0,12829,0,2021-01-11,1610319600.0
8464,28,1,2021-01-12,3977,0,16806,0,2021-01-12,1610406000.0
8465,28,1,2021-01-13,4302,0,21108,0,2021-01-13,1610492400.0
8466,28,1,2021-01-14,8098,0,29206,0,2021-01-14,1610578800.0
8467,28,1,2021-01-15,6218,0,35424,0,2021-01-15,1610665200.0
8468,28,1,2021-01-16,2087,8,37511,8,2021-01-16,1610751600.0
8469,28,1,2021-01-17,4073,16,41584,24,2021-01-17,1610838000.0
8470,28,1,2021-01-18,8784,8,50368,32,2021-01-18,1610924400.0
8471,28,1,2021-01-19,7141,2,57509,34,2021-01-19,1611010800.0
8472,28,1,2021-01-20,6509,4,64018,38,2021-01-20,1611097200.0
8473,28,1,2021-01-21,5992,3,70010,41,2021-01-21,1611183600.0
8474,28,1,2021-01-22,5440,7,75450,48,2021-01-22,1611270000.0
8475,28,1,2021-01-23,2019,6,77469,54,2021-01-23,1611356400.0
8476,28,1,2021-01-24,1447,11,78916,65,2021-01-24,1611442800.0
8477,28,1,2021-01-25,6240,173,85156,238,2021-01-25,1611529200.0
8478,28,1,2021-01-26,4576,391,89732,629,2021-01-26,1611615600.0
8479,28,1,2021-01-27,4034,762,93766,1391,2021-01-27,1611702000.0
8480,28,1,2021-01-28,3755,1044,97521,2435,2021-01-28,1611788400.0
8481,28,1,2021-01-29,3489,1298,101010,3733,2021-01-29,1611874800.0
8482,28,1,2021-01-30,1386,516,102396,4249,2021-01-30,1611961200.0
8483,28,1,2021-01-31,195,124,102591,4373,2021-01-31,1612047600.0
8484,28,1,2021-02-01,2781,1659,105372,6032,2021-02-01,1612134000.0
8485,28,1,2021-02-02,2984,2388,108356,8420,2021-02-02,1612220400.0
8486,28,1,2021-02-03,2948,2665,111304,11085,2021-02-03,1612306800.0
8487,28,1,2021-02-04,3726,5199,115030,16284,2021-02-04,1612393200.0
8488,28,1,2021-02-05,3887,4380,118917,20664,2021-02-05,1612479600.0
8489,28,1,2021-02-06,1126,1546,120043,22210,2021-02-06,1612566000.0
8490,28,1,2021-02-07,632,1971,120675,24181,2021-02-07,1612652400.0
8491,28,1,2021-02-08,3257,6841,123932,31022,2021-02-08,1612738800.0
8492,28,1,2021-02-09,2715,6003,126647,37025,2021-02-09,1612825200.0
8493,28,1,2021-02-10,2127,5048,128774,42073,2021-02-10,1612911600.0
8494,28,1,2021-02-11,1922,4848,130696,46921,2021-02-11,1612998000.0
8495,28,1,2021-02-12,1923,4579,132619,51500,2021-02-12,1613084400.0
8496,28,1,2021-02-13,672,1570,133291,53070,2021-02-13,1613170800.0
8497,28,1,2021-02-14,263,1385,133554,54455,2021-02-14,1613257200.0
8498,28,1,2021-02-15,1124,6247,134678,60702,2021-02-15,1613343600.0
8499,28,1,2021-02-16,1036,5617,135714,66319,2021-02-16,1613430000.0
8500,28,1,2021-02-17,851,4548,136565,70867,2021-02-17,1613516400.0
8501,28,1,2021-02-18,749,4255,137314,75122,2021-02-18,1613602800.0
8502,28,1,2021-02-19,735,3660,138049,78782,2021-02-19,1613689200.0
8503,28,1,2021-02-20,451,1252,138500,80034,2021-02-20,1613775600.0
8504,28,1,2021-02-21,18,416,138518,80450,2021-02-21,1613862000.0
8505,28,1,2021-02-22,791,4173,139309,84623,2021-02-22,1613948400.0
8506,28,1,2021-02-23,1096,3801,140405,88424,2021-02-23,1614034800.0
8507,28,1,2021-02-24,1099,3869,141504,92293,2021-02-24,1614121200.0
8508,28,1,2021-02-25,1361,4128,142865,96421,2021-02-25,1614207600.0
8509,28,1,2021-02-26,1465,3662,144330,100083,2021-02-26,1614294000.0
8510,28,1,2021-02-27,483,1010,144813,101093,2021-02-27,1614380400.0
8511,28,1,2021-02-28,156,383,144969,101476,2021-02-28,1614466800.0
8512,28,1,2021-03-01,1757,4622,146726,106098,2021-03-01,1614553200.0
8513,28,1,2021-03-02,2082,4040,148808,110138,2021-03-02,1614639600.0
8514,28,1,2021-03-03,2281,3452,151089,113590,2021-03-03,1614726000.0
8515,28,1,2021-03-04,2851,2796,153940,116386,2021-03-04,1614812400.0
8516,28,1,2021-03-05,3898,2349,157838,118735,2021-03-05,1614898800.0
8517,28,1,2021-03-06,5103,688,162941,119423,2021-03-06,1614985200.0
8518,28,1,2021-03-07,2754,100,165695,119523,2021-03-07,1615071600.0
8519,28,1,2021-03-08,3896,2660,169591,122183,2021-03-08,1615158000.0
8520,28,1,2021-03-09,5248,2131,174839,124314,2021-03-09,1615244400.0
8521,28,1,2021-03-10,5784,1808,180623,126122,2021-03-10,1615330800.0
8522,28,1,2021-03-11,6518,1277,187141,127399,2021-03-11,1615417200.0
8523,28,1,2021-03-12,7202,1030,194343,128429,2021-03-12,1615503600.0
8524,28,1,2021-03-13,3301,420,197644,128849,2021-03-13,1615590000.0
8525,28,1,2021-03-14,1505,69,199149,128918,2021-03-14,1615676400.0
8526,28,1,2021-03-15,6828,645,205977,129563,2021-03-15,1615762800.0
8527,28,1,2021-03-16,6929,704,212906,130267,2021-03-16,1615849200.0
8528,28,1,2021-03-17,7121,951,220027,131218,2021-03-17,1615935600.0
8529,28,1,2021-03-18,7531,964,227558,132182,2021-03-18,1616022000.0
8530,28,1,2021-03-19,7310,770,234868,132952,2021-03-19,1616108400.0
8531,28,1,2021-03-20,4964,148,239832,133100,2021-03-20,1616194800.0
8532,28,1,2021-03-21,1747,7,241579,133107,2021-03-21,1616281200.0
8533,28,1,2021-03-22,6993,1192,248572,134299,2021-03-22,1616367600.0
8534,28,1,2021-03-23,7297,1069,255869,135368,2021-03-23,1616454000.0
8535,28,1,2021-03-24,7117,1237,262986,136605,2021-03-24,1616540400.0
8536,28,1,2021-03-25,8102,1368,271088,137973,2021-03-25,1616626800.0
8537,28,1,2021-03-26,8261,1152,279349,139125,2021-03-26,1616713200.0
8538,28,1,2021-03-27,5345,579,284694,139704,2021-03-27,1616799600.0
8539,28,1,2021-03-28,1392,48,286086,139752,2021-03-28,1616886000.0
8540,28,1,2021-03-29,7596,2729,293682,142481,2021-03-29,1616972400.0
8541,28,1,2021-03-30,8417,2742,302099,145223,2021-03-30,1617058800.0
8542,28,1,2021-03-31,9643,2962,311742,148185,2021-03-31,1617145200.0
8543,28,1,2021-04-01,11826,4537,323568,152722,2021-04-01,1617231600.0
8544,28,1,2021-04-02,10445,5517,334013,158239,2021-04-02,1617318000.0
8545,28,1,2021-04-03,4175,2969,338188,161208,2021-04-03,1617404400.0
8546,28,1,2021-04-04,1500,175,339688,161383,2021-04-04,1617490800.0
8547,28,1,2021-04-05,2294,671,341982,162054,2021-04-05,1617577200.0
8548,28,1,2021-04-06,8495,6574,350477,168628,2021-04-06,1617663600.0
8549,28,1,2021-04-07,10269,6360,360746,174988,2021-04-07,1617750000.0
8550,28,1,2021-04-08,11331,6806,372077,181794,2021-04-08,1617836400.0
8551,28,1,2021-04-09,11405,7038,383482,188832,2021-04-09,1617922800.0
8552,28,1,2021-04-10,9029,3113,392511,191945,2021-04-10,1618009200.0
8553,28,1,2021-04-11,2572,790,395083,192735,2021-04-11,1618095600.0
8554,28,1,2021-04-12,9265,7416,404348,200151,2021-04-12,1618185600.0
8555,28,1,2021-04-13,10373,7341,414721,207492,2021-04-13,1618272000.0
8556,28,1,2021-04-14,9669,7148,424390,214640,2021-04-14,1618358400.0
8557,28,1,2021-04-15,10462,7446,434852,222086,2021-04-15,1618444800.0
8558,28,1,2021-04-16,11092,6995,445944,229081,2021-04-16,1618531200.0
8559,28,1,2021-04-17,7578,4020,453522,233101,2021-04-17,1618617600.0
8560,28,1,2021-04-18,1567,1027,455089,234128,2021-04-18,1618704000.0
8561,28,1,2021-04-19,8348,7523,463437,241651,2021-04-19,1618790400.0
8562,28,1,2021-04-20,9684,7761,473121,249412,2021-04-20,1618876800.0
8563,28,1,2021-04-21,9705,7996,482826,257408,2021-04-21,1618963200.0
8564,28,1,2021-04-22,10143,9924,492969,267332,2021-04-22,1619049600.0
8565,28,1,2021-04-23,9823,9685,502792,277017,2021-04-23,1619136000.0
8566,28,1,2021-04-24,8980,5080,511772,282097,2021-04-24,1619222400.0
8567,28,1,2021-04-25,2888,546,514660,282643,2021-04-25,1619308800.0
8568,28,1,2021-04-26,9222,8456,523882,291099,2021-04-26,1619395200.0
8569,28,1,2021-04-27,10907,8714,534789,299813,2021-04-27,1619481600.0
8570,28,1,2021-04-28,11013,7637,545802,307450,2021-04-28,1619568000.0
8571,28,1,2021-04-29,13016,7975,558818,315425,2021-04-29,1619654400.0
8572,28,1,2021-04-30,13743,7709,572561,323134,2021-04-30,1619740800.0
8573,28,1,2021-05-01,7948,1893,580509,325027,2021-05-01,1619827200.0
8574,28,1,2021-05-02,5715,1399,586224,326426,2021-05-02,1619913600.0
8575,28,1,2021-05-03,11181,8009,597405,334435,2021-05-03,1620000000.0
8576,28,1,2021-05-04,10983,10346,608388,344781,2021-05-04,1620086400.0
8577,28,1,2021-05-05,11845,11825,620233,356606,2021-05-05,1620172800.0
8578,28,1,2021-05-06,14516,10936,634749,367542,2021-05-06,1620259200.0
8579,28,1,2021-05-07,12613,12161,647362,379703,2021-05-07,1620345600.0
8580,28,1,2021-05-08,8446,3702,655808,383405,2021-05-08,1620432000.0
8581,28,1,2021-05-09,4953,1286,660761,384691,2021-05-09,1620518400.0
8582,28,1,2021-05-10,11722,11637,672483,396328,2021-05-10,1620604800.0
8583,28,1,2021-05-11,13581,11293,686064,407621,2021-05-11,1620691200.0
8584,28,1,2021-05-12,14592,10215,700656,417836,2021-05-12,1620777600.0
8585,28,1,2021-05-13,16275,1969,716931,419805,2021-05-13,1620864000.0
8586,28,1,2021-05-14,21807,8137,738738,427942,2021-05-14,1620950400.0
8587,28,1,2021-05-15,18546,4569,757284,432511,2021-05-15,1621036800.0
8588,28,1,2021-05-16,7486,676,764770,433187,2021-05-16,1621123200.0
8589,28,1,2021-05-17,14450,6994,779220,440181,2021-05-17,1621206000.0
8590,28,1,2021-05-18,18323,5537,797543,445718,2021-05-18,1621292400.0
8591,28,1,2021-05-19,18502,5307,816045,451025,2021-05-19,1621378800.0
8592,28,1,2021-05-20,19532,4646,835577,455671,2021-05-20,1621465200.0
8593,28,1,2021-05-21,17161,5942,852738,461613,2021-05-21,1621551600.0
8594,28,1,2021-05-22,11922,2591,864660,464204,2021-05-22,1621638000.0
8595,28,1,2021-05-23,4139,357,868799,464561,2021-05-23,1621724400.0
8596,28,1,2021-05-24,12733,2054,881532,466615,2021-05-24,1621810800.0
8597,28,1,2021-05-25,17796,8163,899328,474778,2021-05-25,1621897200.0
8598,28,1,2021-05-26,17910,6013,917238,480791,2021-05-26,1621983600.0
8599,28,1,2021-05-27,19323,6293,936561,487084,2021-05-27,1622070000.0
8600,28,1,2021-05-28,17886,7594,954447,494678,2021-05-28,1622156400.0
8601,28,1,2021-05-29,13041,4525,967488,499203,2021-05-29,1622242800.0
8602,28,1,2021-05-30,5855,646,973343,499849,2021-05-30,1622329200.0
8603,28,1,2021-05-31,17202,7353,990545,507202,2021-05-31,1622415600.0
8604,28,1,2021-06-01,18661,7551,1009206,514753,2021-06-01,1622502000.0
8605,28,1,2021-06-02,17807,6714,1027013,521467,2021-06-02,1622588400.0
8606,28,1,2021-06-03,21181,6656,1048194,528123,2021-06-03,1622674800.0
8607,28,1,2021-06-04,18294,8226,1066488,536349,2021-06-04,1622761200.0
8608,28,1,2021-06-05,15008,6981,1081496,543330,2021-06-05,1622847600.0
8609,28,1,2021-06-06,7083,1705,1088579,545035,2021-06-06,1622934000.0
8610,28,1,2021-06-07,16919,10003,1105498,555038,2021-06-07,1623020400.0
8611,28,1,2021-06-08,18847,10346,1124345,565384,2021-06-08,1623106800.0
8612,28,1,2021-06-09,17170,9328,1141515,574712,2021-06-09,1623193200.0
8613,28,1,2021-06-10,17984,7472,1159499,582184,2021-06-10,1623279600.0
8614,28,1,2021-06-11,16826,11174,1176325,593358,2021-06-11,1623366000.0
8615,28,1,2021-06-12,15250,9344,1191575,602702,2021-06-12,1623452400.0
8616,28,1,2021-06-13,6147,4129,1197722,606831,2021-06-13,1623538800.0
8617,28,1,2021-06-14,11832,13483,1209554,620314,2021-06-14,1623625200.0
8618,28,1,2021-06-15,13425,12133,1222979,632447,2021-06-15,1623711600.0
8619,28,1,2021-06-16,14400,12117,1237379,644564,2021-06-16,1623798000.0
8620,28,1,2021-06-17,14113,11670,1251492,656234,2021-06-17,1623884400.0
8621,28,1,2021-06-18,14683,13040,1266175,669274,2021-06-18,1623970800.0
8622,28,1,2021-06-19,12577,9164,1278752,678438,2021-06-19,1624057200.0
8623,28,1,2021-06-20,4809,3732,1283561,682170,2021-06-20,1624143600.0
8624,28,1,2021-06-21,9887,15958,1293448,698128,2021-06-21,1624230000.0
8625,28,1,2021-06-22,10395,16465,1303843,714593,2021-06-22,1624316400.0
8626,28,1,2021-06-23,10177,16188,1314020,730781,2021-06-23,1624402800.0
8627,28,1,2021-06-24,10164,15407,1324184,746188,2021-06-24,1624489200.0
8628,28,1,2021-06-25,9553,19230,1333737,765418,2021-06-25,1624575600.0
8629,28,1,2021-06-26,7824,14975,1341561,780393,2021-06-26,1624662000.0
8630,28,1,2021-06-27,2657,5203,1344218,785596,2021-06-27,1624748400.0
8631,28,1,2021-06-28,7498,18178,1351716,803774,2021-06-28,1624834800.0
8632,28,1,2021-06-29,8130,19885,1359846,823659,2021-06-29,1624921200.0
8633,28,1,2021-06-30,9704,18380,1369550,842039,2021-06-30,1625007600.0
8634,28,1,2021-07-01,10506,15517,1380056,857556,2021-07-01,1625094000.0
8635,28,1,2021-07-02,9114,18566,1389170,876122,2021-07-02,1625180400.0
8636,28,1,2021-07-03,7107,12253,1396277,888375,2021-07-03,1625266800.0
8637,28,1,2021-07-04,2768,4565,1399045,892940,2021-07-04,1625353200.0
8638,28,1,2021-07-05,7791,18179,1406836,911119,2021-07-05,1625439600.0
8639,28,1,2021-07-06,8517,19928,1415353,931047,2021-07-06,1625526000.0
8640,28,2,2020-12-27,0,0,0,0,2020-12-27,1609023600.0
8641,28,2,2020-12-28,0,0,0,0,2020-12-28,1609110000.0
8642,28,2,2020-12-29,0,0,0,0,2020-12-29,1609196400.0
8643,28,2,2020-12-30,0,0,0,0,2020-12-30,1609282800.0
8644,28,2,2020-12-31,0,0,0,0,2020-12-31,1609369200.0
8645,28,2,2021-01-01,0,0,0,0,2021-01-01,1609455600.0
8646,28,2,2021-01-02,0,0,0,0,2021-01-02,1609542000.0
8647,28,2,2021-01-03,0,0,0,0,2021-01-03,1609628400.0
8648,28,2,2021-01-04,0,0,0,0,2021-01-04,1609714800.0
8649,28,2,2021-01-05,0,0,0,0,2021-01-05,1609801200.0
8650,28,2,2021-01-06,0,0,0,0,2021-01-06,1609887600.0
8651,28,2,2021-01-07,0,0,0,0,2021-01-07,1609974000.0
8652,28,2,2021-01-08,0,0,0,0,2021-01-08,1610060400.0
8653,28,2,2021-01-09,0,0,0,0,2021-01-09,1610146800.0
8654,28,2,2021-01-10,0,0,0,0,2021-01-10,1610233200.0
8655,28,2,2021-01-11,0,0,0,0,2021-01-11,1610319600.0
8656,28,2,2021-01-12,0,0,0,0,2021-01-12,1610406000.0
8657,28,2,2021-01-13,0,0,0,0,2021-01-13,1610492400.0
8658,28,2,2021-01-14,0,0,0,0,2021-01-14,1610578800.0
8659,28,2,2021-01-15,0,0,0,0,2021-01-15,1610665200.0
8660,28,2,2021-01-16,0,0,0,0,2021-01-16,1610751600.0
8661,28,2,2021-01-17,0,0,0,0,2021-01-17,1610838000.0
8662,28,2,2021-01-18,1,0,1,0,2021-01-18,1610924400.0
8663,28,2,2021-01-19,1,0,2,0,2021-01-19,1611010800.0
8664,28,2,2021-01-20,0,0,2,0,2021-01-20,1611097200.0
8665,28,2,2021-01-21,0,0,2,0,2021-01-21,1611183600.0
8666,28,2,2021-01-22,0,0,2,0,2021-01-22,1611270000.0
8667,28,2,2021-01-23,0,0,2,0,2021-01-23,1611356400.0
8668,28,2,2021-01-24,0,0,2,0,2021-01-24,1611442800.0
8669,28,2,2021-01-25,2,0,4,0,2021-01-25,1611529200.0
8670,28,2,2021-01-26,1,0,5,0,2021-01-26,1611615600.0
8671,28,2,2021-01-27,0,0,5,0,2021-01-27,1611702000.0
8672,28,2,2021-01-28,0,0,5,0,2021-01-28,1611788400.0
8673,28,2,2021-01-29,0,0,5,0,2021-01-29,1611874800.0
8674,28,2,2021-01-30,0,0,5,0,2021-01-30,1611961200.0
8675,28,2,2021-01-31,0,0,5,0,2021-01-31,1612047600.0
8676,28,2,2021-02-01,1,0,6,0,2021-02-01,1612134000.0
8677,28,2,2021-02-02,1,0,7,0,2021-02-02,1612220400.0
8678,28,2,2021-02-03,0,0,7,0,2021-02-03,1612306800.0
8679,28,2,2021-02-04,0,0,7,0,2021-02-04,1612393200.0
8680,28,2,2021-02-05,0,0,7,0,2021-02-05,1612479600.0
8681,28,2,2021-02-06,1,0,8,0,2021-02-06,1612566000.0
8682,28,2,2021-02-07,0,0,8,0,2021-02-07,1612652400.0
8683,28,2,2021-02-08,414,0,422,0,2021-02-08,1612738800.0
8684,28,2,2021-02-09,520,1,942,1,2021-02-09,1612825200.0
8685,28,2,2021-02-10,575,1,1517,2,2021-02-10,1612911600.0
8686,28,2,2021-02-11,740,0,2257,2,2021-02-11,1612998000.0
8687,28,2,2021-02-12,579,0,2836,2,2021-02-12,1613084400.0
8688,28,2,2021-02-13,29,0,2865,2,2021-02-13,1613170800.0
8689,28,2,2021-02-14,0,0,2865,2,2021-02-14,1613257200.0
8690,28,2,2021-02-15,149,1,3014,3,2021-02-15,1613343600.0
8691,28,2,2021-02-16,458,0,3472,3,2021-02-16,1613430000.0
8692,28,2,2021-02-17,215,1,3687,4,2021-02-17,1613516400.0
8693,28,2,2021-02-18,345,0,4032,4,2021-02-18,1613602800.0
8694,28,2,2021-02-19,454,0,4486,4,2021-02-19,1613689200.0
8695,28,2,2021-02-20,314,1,4800,5,2021-02-20,1613775600.0
8696,28,2,2021-02-21,83,0,4883,5,2021-02-21,1613862000.0
8697,28,2,2021-02-22,289,2,5172,7,2021-02-22,1613948400.0
8698,28,2,2021-02-23,274,3,5446,10,2021-02-23,1614034800.0
8699,28,2,2021-02-24,198,0,5644,10,2021-02-24,1614121200.0
8700,28,2,2021-02-25,232,1,5876,11,2021-02-25,1614207600.0
8701,28,2,2021-02-26,377,1,6253,12,2021-02-26,1614294000.0
8702,28,2,2021-02-27,448,0,6701,12,2021-02-27,1614380400.0
8703,28,2,2021-02-28,96,0,6797,12,2021-02-28,1614466800.0
8704,28,2,2021-03-01,22,1,6819,13,2021-03-01,1614553200.0
8705,28,2,2021-03-02,66,1,6885,14,2021-03-02,1614639600.0
8706,28,2,2021-03-03,216,0,7101,14,2021-03-03,1614726000.0
8707,28,2,2021-03-04,565,2,7666,16,2021-03-04,1614812400.0
8708,28,2,2021-03-05,335,3,8001,19,2021-03-05,1614898800.0
8709,28,2,2021-03-06,900,23,8901,42,2021-03-06,1614985200.0
8710,28,2,2021-03-07,700,17,9601,59,2021-03-07,1615071600.0
8711,28,2,2021-03-08,237,564,9838,623,2021-03-08,1615158000.0
8712,28,2,2021-03-09,456,595,10294,1218,2021-03-09,1615244400.0
8713,28,2,2021-03-10,249,559,10543,1777,2021-03-10,1615330800.0
8714,28,2,2021-03-11,448,626,10991,2403,2021-03-11,1615417200.0
8715,28,2,2021-03-12,363,345,11354,2748,2021-03-12,1615503600.0
8716,28,2,2021-03-13,818,46,12172,2794,2021-03-13,1615590000.0
8717,28,2,2021-03-14,349,11,12521,2805,2021-03-14,1615676400.0
8718,28,2,2021-03-15,265,155,12786,2960,2021-03-15,1615762800.0
8719,28,2,2021-03-16,533,439,13319,3399,2021-03-16,1615849200.0
8720,28,2,2021-03-17,567,173,13886,3572,2021-03-17,1615935600.0
8721,28,2,2021-03-18,595,337,14481,3909,2021-03-18,1616022000.0
8722,28,2,2021-03-19,325,550,14806,4459,2021-03-19,1616108400.0
8723,28,2,2021-03-20,626,300,15432,4759,2021-03-20,1616194800.0
8724,28,2,2021-03-21,220,0,15652,4759,2021-03-21,1616281200.0
8725,28,2,2021-03-22,1150,294,16802,5053,2021-03-22,1616367600.0
8726,28,2,2021-03-23,1588,278,18390,5331,2021-03-23,1616454000.0
8727,28,2,2021-03-24,1789,190,20179,5521,2021-03-24,1616540400.0
8728,28,2,2021-03-25,1596,229,21775,5750,2021-03-25,1616626800.0
8729,28,2,2021-03-26,2102,476,23877,6226,2021-03-26,1616713200.0
8730,28,2,2021-03-27,1746,405,25623,6631,2021-03-27,1616799600.0
8731,28,2,2021-03-28,1283,2,26906,6633,2021-03-28,1616886000.0
8732,28,2,2021-03-29,1353,57,28259,6690,2021-03-29,1616972400.0
8733,28,2,2021-03-30,1842,74,30101,6764,2021-03-30,1617058800.0
8734,28,2,2021-03-31,1779,192,31880,6956,2021-03-31,1617145200.0
8735,28,2,2021-04-01,1806,543,33686,7499,2021-04-01,1617231600.0
8736,28,2,2021-04-02,1321,482,35007,7981,2021-04-02,1617318000.0
8737,28,2,2021-04-03,765,871,35772,8852,2021-04-03,1617404400.0
8738,28,2,2021-04-04,191,591,35963,9443,2021-04-04,1617490800.0
8739,28,2,2021-04-05,955,28,36918,9471,2021-04-05,1617577200.0
8740,28,2,2021-04-06,1174,589,38092,10060,2021-04-06,1617663600.0
8741,28,2,2021-04-07,1103,344,39195,10404,2021-04-07,1617750000.0
8742,28,2,2021-04-08,1628,400,40823,10804,2021-04-08,1617836400.0
8743,28,2,2021-04-09,1676,381,42499,11185,2021-04-09,1617922800.0
8744,28,2,2021-04-10,303,785,42802,11970,2021-04-10,1618009200.0
8745,28,2,2021-04-11,200,340,43002,12310,2021-04-11,1618095600.0
8746,28,2,2021-04-12,1333,336,44335,12646,2021-04-12,1618185600.0
8747,28,2,2021-04-13,1090,394,45425,13040,2021-04-13,1618272000.0
8748,28,2,2021-04-14,1195,515,46620,13555,2021-04-14,1618358400.0
8749,28,2,2021-04-15,1073,532,47693,14087,2021-04-15,1618444800.0
8750,28,2,2021-04-16,1380,300,49073,14387,2021-04-16,1618531200.0
8751,28,2,2021-04-17,1437,669,50510,15056,2021-04-17,1618617600.0
8752,28,2,2021-04-18,222,121,50732,15177,2021-04-18,1618704000.0
8753,28,2,2021-04-19,894,1066,51626,16243,2021-04-19,1618790400.0
8754,28,2,2021-04-20,1539,1624,53165,17867,2021-04-20,1618876800.0
8755,28,2,2021-04-21,1223,1628,54388,19495,2021-04-21,1618963200.0
8756,28,2,2021-04-22,1371,1476,55759,20971,2021-04-22,1619049600.0
8757,28,2,2021-04-23,1596,1928,57355,22899,2021-04-23,1619136000.0
8758,28,2,2021-04-24,690,1626,58045,24525,2021-04-24,1619222400.0
8759,28,2,2021-04-25,96,1265,58141,25790,2021-04-25,1619308800.0
8760,28,2,2021-04-26,1301,1086,59442,26876,2021-04-26,1619395200.0
8761,28,2,2021-04-27,893,1910,60335,28786,2021-04-27,1619481600.0
8762,28,2,2021-04-28,1182,1868,61517,30654,2021-04-28,1619568000.0
8763,28,2,2021-04-29,1001,1852,62518,32506,2021-04-29,1619654400.0
8764,28,2,2021-04-30,1074,1554,63592,34060,2021-04-30,1619740800.0
8765,28,2,2021-05-01,3800,432,67392,34492,2021-05-01,1619827200.0
8766,28,2,2021-05-02,75,193,67467,34685,2021-05-02,1619913600.0
8767,28,2,2021-05-03,628,1152,68095,35837,2021-05-03,1620000000.0
8768,28,2,2021-05-04,574,1369,68669,37206,2021-05-04,1620086400.0
8769,28,2,2021-05-05,589,1213,69258,38419,2021-05-05,1620172800.0
8770,28,2,2021-05-06,579,1518,69837,39937,2021-05-06,1620259200.0
8771,28,2,2021-05-07,974,1669,70811,41606,2021-05-07,1620345600.0
8772,28,2,2021-05-08,3581,129,74392,41735,2021-05-08,1620432000.0
8773,28,2,2021-05-09,2105,200,76497,41935,2021-05-09,1620518400.0
8774,28,2,2021-05-10,764,1530,77261,43465,2021-05-10,1620604800.0
8775,28,2,2021-05-11,1447,1234,78708,44699,2021-05-11,1620691200.0
8776,28,2,2021-05-12,2409,1111,81117,45810,2021-05-12,1620777600.0
8777,28,2,2021-05-13,3244,866,84361,46676,2021-05-13,1620864000.0
8778,28,2,2021-05-14,2802,956,87163,47632,2021-05-14,1620950400.0
8779,28,2,2021-05-15,7740,297,94903,47929,2021-05-15,1621036800.0
8780,28,2,2021-05-16,6564,174,101467,48103,2021-05-16,1621123200.0
8781,28,2,2021-05-17,1032,673,102499,48776,2021-05-17,1621206000.0
8782,28,2,2021-05-18,1397,495,103896,49271,2021-05-18,1621292400.0
8783,28,2,2021-05-19,1318,475,105214,49746,2021-05-19,1621378800.0
8784,28,2,2021-05-20,1995,349,107209,50095,2021-05-20,1621465200.0
8785,28,2,2021-05-21,2504,374,109713,50469,2021-05-21,1621551600.0
8786,28,2,2021-05-22,5050,110,114763,50579,2021-05-22,1621638000.0
8787,28,2,2021-05-23,4954,30,119717,50609,2021-05-23,1621724400.0
8788,28,2,2021-05-24,622,227,120339,50836,2021-05-24,1621810800.0
8789,28,2,2021-05-25,694,430,121033,51266,2021-05-25,1621897200.0
8790,28,2,2021-05-26,736,402,121769,51668,2021-05-26,1621983600.0
8791,28,2,2021-05-27,971,377,122740,52045,2021-05-27,1622070000.0
8792,28,2,2021-05-28,1452,720,124192,52765,2021-05-28,1622156400.0
8793,28,2,2021-05-29,3698,1189,127890,53954,2021-05-29,1622242800.0
8794,28,2,2021-05-30,335,10,128225,53964,2021-05-30,1622329200.0
8795,28,2,2021-05-31,1922,1342,130147,55306,2021-05-31,1622415600.0
8796,28,2,2021-06-01,3687,1059,133834,56365,2021-06-01,1622502000.0
8797,28,2,2021-06-02,2112,1088,135946,57453,2021-06-02,1622588400.0
8798,28,2,2021-06-03,3992,1386,139938,58839,2021-06-03,1622674800.0
8799,28,2,2021-06-04,4465,1729,144403,60568,2021-06-04,1622761200.0
8800,28,2,2021-06-05,2537,324,146940,60892,2021-06-05,1622847600.0
8801,28,2,2021-06-06,480,62,147420,60954,2021-06-06,1622934000.0
8802,28,2,2021-06-07,1663,1063,149083,62017,2021-06-07,1623020400.0
8803,28,2,2021-06-08,2758,814,151841,62831,2021-06-08,1623106800.0
8804,28,2,2021-06-09,1819,1349,153660,64180,2021-06-09,1623193200.0
8805,28,2,2021-06-10,2278,1034,155938,65214,2021-06-10,1623279600.0
8806,28,2,2021-06-11,2989,1229,158927,66443,2021-06-11,1623366000.0
8807,28,2,2021-06-12,2162,3916,161089,70359,2021-06-12,1623452400.0
8808,28,2,2021-06-13,133,1092,161222,71451,2021-06-13,1623538800.0
8809,28,2,2021-06-14,1657,1044,162879,72495,2021-06-14,1623625200.0
8810,28,2,2021-06-15,2056,959,164935,73454,2021-06-15,1623711600.0
8811,28,2,2021-06-16,1725,1633,166660,75087,2021-06-16,1623798000.0
8812,28,2,2021-06-17,2366,1329,169026,76416,2021-06-17,1623884400.0
8813,28,2,2021-06-18,2943,1461,171969,77877,2021-06-18,1623970800.0
8814,28,2,2021-06-19,1886,2840,173855,80717,2021-06-19,1624057200.0
8815,28,2,2021-06-20,136,895,173991,81612,2021-06-20,1624143600.0
8816,28,2,2021-06-21,1136,1407,175127,83019,2021-06-21,1624230000.0
8817,28,2,2021-06-22,1773,2081,176900,85100,2021-06-22,1624316400.0
8818,28,2,2021-06-23,1329,3779,178229,88879,2021-06-23,1624402800.0
8819,28,2,2021-06-24,1908,2997,180137,91876,2021-06-24,1624489200.0
8820,28,2,2021-06-25,2175,2734,182312,94610,2021-06-25,1624575600.0
8821,28,2,2021-06-26,996,5195,183308,99805,2021-06-26,1624662000.0
8822,28,2,2021-06-27,214,4346,183522,104151,2021-06-27,1624748400.0
8823,28,2,2021-06-28,555,1734,184077,105885,2021-06-28,1624834800.0
8824,28,2,2021-06-29,1181,1601,185258,107486,2021-06-29,1624921200.0
8825,28,2,2021-06-30,1033,1757,186291,109243,2021-06-30,1625007600.0
8826,28,2,2021-07-01,1163,2212,187454,111455,2021-07-01,1625094000.0
8827,28,2,2021-07-02,1359,2818,188813,114273,2021-07-02,1625180400.0
8828,28,2,2021-07-03,664,5474,189477,119747,2021-07-03,1625266800.0
8829,28,2,2021-07-04,110,3990,189587,123737,2021-07-04,1625353200.0
8830,28,2,2021-07-05,393,1280,189980,125017,2021-07-05,1625439600.0
8831,28,2,2021-07-06,708,1668,190688,126685,2021-07-06,1625526000.0
8832,28,3,2020-12-27,0,0,0,0,2020-12-27,1609023600.0
8833,28,3,2020-12-28,0,0,0,0,2020-12-28,1609110000.0
8834,28,3,2020-12-29,0,0,0,0,2020-12-29,1609196400.0
8835,28,3,2020-12-30,0,0,0,0,2020-12-30,1609282800.0
8836,28,3,2020-12-31,0,0,0,0,2020-12-31,1609369200.0
8837,28,3,2021-01-01,0,0,0,0,2021-01-01,1609455600.0
8838,28,3,2021-01-02,0,0,0,0,2021-01-02,1609542000.0
8839,28,3,2021-01-03,0,0,0,0,2021-01-03,1609628400.0
8840,28,3,2021-01-04,0,0,0,0,2021-01-04,1609714800.0
8841,28,3,2021-01-05,0,0,0,0,2021-01-05,1609801200.0
8842,28,3,2021-01-06,0,0,0,0,2021-01-06,1609887600.0
8843,28,3,2021-01-07,0,0,0,0,2021-01-07,1609974000.0
8844,28,3,2021-01-08,0,0,0,0,2021-01-08,1610060400.0
8845,28,3,2021-01-09,0,0,0,0,2021-01-09,1610146800.0
8846,28,3,2021-01-10,0,0,0,0,2021-01-10,1610233200.0
8847,28,3,2021-01-11,0,0,0,0,2021-01-11,1610319600.0
8848,28,3,2021-01-12,0,0,0,0,2021-01-12,1610406000.0
8849,28,3,2021-01-13,0,0,0,0,2021-01-13,1610492400.0
8850,28,3,2021-01-14,0,0,0,0,2021-01-14,1610578800.0
8851,28,3,2021-01-15,0,0,0,0,2021-01-15,1610665200.0
8852,28,3,2021-01-16,0,0,0,0,2021-01-16,1610751600.0
8853,28,3,2021-01-17,0,0,0,0,2021-01-17,1610838000.0
8854,28,3,2021-01-18,0,0,0,0,2021-01-18,1610924400.0
8855,28,3,2021-01-19,0,0,0,0,2021-01-19,1611010800.0
8856,28,3,2021-01-20,0,0,0,0,2021-01-20,1611097200.0
8857,28,3,2021-01-21,0,0,0,0,2021-01-21,1611183600.0
8858,28,3,2021-01-22,0,0,0,0,2021-01-22,1611270000.0
8859,28,3,2021-01-23,0,0,0,0,2021-01-23,1611356400.0
8860,28,3,2021-01-24,0,0,0,0,2021-01-24,1611442800.0
8861,28,3,2021-01-25,0,0,0,0,2021-01-25,1611529200.0
8862,28,3,2021-01-26,0,0,0,0,2021-01-26,1611615600.0
8863,28,3,2021-01-27,0,0,0,0,2021-01-27,1611702000.0
8864,28,3,2021-01-28,0,0,0,0,2021-01-28,1611788400.0
8865,28,3,2021-01-29,0,0,0,0,2021-01-29,1611874800.0
8866,28,3,2021-01-30,0,0,0,0,2021-01-30,1611961200.0
8867,28,3,2021-01-31,0,0,0,0,2021-01-31,1612047600.0
8868,28,3,2021-02-01,0,0,0,0,2021-02-01,1612134000.0
8869,28,3,2021-02-02,0,0,0,0,2021-02-02,1612220400.0
8870,28,3,2021-02-03,0,0,0,0,2021-02-03,1612306800.0
8871,28,3,2021-02-04,0,0,0,0,2021-02-04,1612393200.0
8872,28,3,2021-02-05,0,0,0,0,2021-02-05,1612479600.0
8873,28,3,2021-02-06,13,0,13,0,2021-02-06,1612566000.0
8874,28,3,2021-02-07,83,0,96,0,2021-02-07,1612652400.0
8875,28,3,2021-02-08,131,0,227,0,2021-02-08,1612738800.0
8876,28,3,2021-02-09,226,0,453,0,2021-02-09,1612825200.0
8877,28,3,2021-02-10,752,0,1205,0,2021-02-10,1612911600.0
8878,28,3,2021-02-11,1549,0,2754,0,2021-02-11,1612998000.0
8879,28,3,2021-02-12,1540,0,4294,0,2021-02-12,1613084400.0
8880,28,3,2021-02-13,423,0,4717,0,2021-02-13,1613170800.0
8881,28,3,2021-02-14,22,0,4739,0,2021-02-14,1613257200.0
8882,28,3,2021-02-15,938,0,5677,0,2021-02-15,1613343600.0
8883,28,3,2021-02-16,1161,0,6838,0,2021-02-16,1613430000.0
8884,28,3,2021-02-17,883,0,7721,0,2021-02-17,1613516400.0
8885,28,3,2021-02-18,1475,0,9196,0,2021-02-18,1613602800.0
8886,28,3,2021-02-19,1359,0,10555,0,2021-02-19,1613689200.0
8887,28,3,2021-02-20,180,0,10735,0,2021-02-20,1613775600.0
8888,28,3,2021-02-21,2,0,10737,0,2021-02-21,1613862000.0
8889,28,3,2021-02-22,586,0,11323,0,2021-02-22,1613948400.0
8890,28,3,2021-02-23,801,0,12124,0,2021-02-23,1614034800.0
8891,28,3,2021-02-24,1075,0,13199,0,2021-02-24,1614121200.0
8892,28,3,2021-02-25,3179,0,16378,0,2021-02-25,1614207600.0
8893,28,3,2021-02-26,4119,0,20497,0,2021-02-26,1614294000.0
8894,28,3,2021-02-27,2077,1,22574,1,2021-02-27,1614380400.0
8895,28,3,2021-02-28,88,0,22662,1,2021-02-28,1614466800.0
8896,28,3,2021-03-01,747,1,23409,2,2021-03-01,1614553200.0
8897,28,3,2021-03-02,1752,2,25161,4,2021-03-02,1614639600.0
8898,28,3,2021-03-03,2295,0,27456,4,2021-03-03,1614726000.0
8899,28,3,2021-03-04,3889,1,31345,5,2021-03-04,1614812400.0
8900,28,3,2021-03-05,5914,0,37259,5,2021-03-05,1614898800.0
8901,28,3,2021-03-06,3806,3,41065,8,2021-03-06,1614985200.0
8902,28,3,2021-03-07,318,0,41383,8,2021-03-07,1615071600.0
8903,28,3,2021-03-08,1734,0,43117,8,2021-03-08,1615158000.0
8904,28,3,2021-03-09,3579,1,46696,9,2021-03-09,1615244400.0
8905,28,3,2021-03-10,3771,2,50467,11,2021-03-10,1615330800.0
8906,28,3,2021-03-11,6997,1,57464,12,2021-03-11,1615417200.0
8907,28,3,2021-03-12,10427,6,67891,18,2021-03-12,1615503600.0
8908,28,3,2021-03-13,7035,3,74926,21,2021-03-13,1615590000.0
8909,28,3,2021-03-14,405,0,75331,21,2021-03-14,1615676400.0
8910,28,3,2021-03-15,1557,0,76888,21,2021-03-15,1615762800.0
8911,28,3,2021-03-16,27,0,76915,21,2021-03-16,1615849200.0
8912,28,3,2021-03-17,31,0,76946,21,2021-03-17,1615935600.0
8913,28,3,2021-03-18,39,0,76985,21,2021-03-18,1616022000.0
8914,28,3,2021-03-19,3928,1,80913,22,2021-03-19,1616108400.0
8915,28,3,2021-03-20,4080,1,84993,23,2021-03-20,1616194800.0
8916,28,3,2021-03-21,443,0,85436,23,2021-03-21,1616281200.0
8917,28,3,2021-03-22,1242,3,86678,26,2021-03-22,1616367600.0
8918,28,3,2021-03-23,3599,0,90277,26,2021-03-23,1616454000.0
8919,28,3,2021-03-24,4351,1,94628,27,2021-03-24,1616540400.0
8920,28,3,2021-03-25,7920,2,102548,29,2021-03-25,1616626800.0
8921,28,3,2021-03-26,10465,7,113013,36,2021-03-26,1616713200.0
8922,28,3,2021-03-27,4407,2,117420,38,2021-03-27,1616799600.0
8923,28,3,2021-03-28,291,0,117711,38,2021-03-28,1616886000.0
8924,28,3,2021-03-29,2822,3,120533,41,2021-03-29,1616972400.0
8925,28,3,2021-03-30,4160,1,124693,42,2021-03-30,1617058800.0
8926,28,3,2021-03-31,2972,1,127665,43,2021-03-31,1617145200.0
8927,28,3,2021-04-01,4405,2,132070,45,2021-04-01,1617231600.0
8928,28,3,2021-04-02,5047,2,137117,47,2021-04-02,1617318000.0
8929,28,3,2021-04-03,2064,5,139181,52,2021-04-03,1617404400.0
8930,28,3,2021-04-04,87,0,139268,52,2021-04-04,1617490800.0
8931,28,3,2021-04-05,41,0,139309,52,2021-04-05,1617577200.0
8932,28,3,2021-04-06,1144,4,140453,56,2021-04-06,1617663600.0
8933,28,3,2021-04-07,1321,2,141774,58,2021-04-07,1617750000.0
8934,28,3,2021-04-08,4715,14,146489,72,2021-04-08,1617836400.0
8935,28,3,2021-04-09,10740,15,157229,87,2021-04-09,1617922800.0
8936,28,3,2021-04-10,4509,15,161738,102,2021-04-10,1618009200.0
8937,28,3,2021-04-11,256,0,161994,102,2021-04-11,1618095600.0
8938,28,3,2021-04-12,3189,3,165183,105,2021-04-12,1618185600.0
8939,28,3,2021-04-13,4720,8,169903,113,2021-04-13,1618272000.0
8940,28,3,2021-04-14,3456,23,173359,136,2021-04-14,1618358400.0
8941,28,3,2021-04-15,5689,31,179048,167,2021-04-15,1618444800.0
8942,28,3,2021-04-16,7808,67,186856,234,2021-04-16,1618531200.0
8943,28,3,2021-04-17,3733,29,190589,263,2021-04-17,1618617600.0
8944,28,3,2021-04-18,500,0,191089,263,2021-04-18,1618704000.0
8945,28,3,2021-04-19,1625,15,192714,278,2021-04-19,1618790400.0
8946,28,3,2021-04-20,2678,26,195392,304,2021-04-20,1618876800.0
8947,28,3,2021-04-21,2354,17,197746,321,2021-04-21,1618963200.0
8948,28,3,2021-04-22,3780,80,201526,401,2021-04-22,1619049600.0
8949,28,3,2021-04-23,4985,74,206511,475,2021-04-23,1619136000.0
8950,28,3,2021-04-24,2811,82,209322,557,2021-04-24,1619222400.0
8951,28,3,2021-04-25,303,10,209625,567,2021-04-25,1619308800.0
8952,28,3,2021-04-26,1775,75,211400,642,2021-04-26,1619395200.0
8953,28,3,2021-04-27,2389,55,213789,697,2021-04-27,1619481600.0
8954,28,3,2021-04-28,2263,203,216052,900,2021-04-28,1619568000.0
8955,28,3,2021-04-29,3484,424,219536,1324,2021-04-29,1619654400.0
8956,28,3,2021-04-30,4288,703,223824,2027,2021-04-30,1619740800.0
8957,28,3,2021-05-01,935,94,224759,2121,2021-05-01,1619827200.0
8958,28,3,2021-05-02,185,44,224944,2165,2021-05-02,1619913600.0
8959,28,3,2021-05-03,770,153,225714,2318,2021-05-03,1620000000.0
8960,28,3,2021-05-04,1653,360,227367,2678,2021-05-04,1620086400.0
8961,28,3,2021-05-05,1157,613,228524,3291,2021-05-05,1620172800.0
8962,28,3,2021-05-06,2545,1272,231069,4563,2021-05-06,1620259200.0
8963,28,3,2021-05-07,2953,1576,234022,6139,2021-05-07,1620345600.0
8964,28,3,2021-05-08,503,379,234525,6518,2021-05-08,1620432000.0
8965,28,3,2021-05-09,73,61,234598,6579,2021-05-09,1620518400.0
8966,28,3,2021-05-10,1330,680,235928,7259,2021-05-10,1620604800.0
8967,28,3,2021-05-11,2280,1348,238208,8607,2021-05-11,1620691200.0
8968,28,3,2021-05-12,1307,1418,239515,10025,2021-05-12,1620777600.0
8969,28,3,2021-05-13,101,118,239616,10143,2021-05-13,1620864000.0
8970,28,3,2021-05-14,1218,1789,240834,11932,2021-05-14,1620950400.0
8971,28,3,2021-05-15,447,985,241281,12917,2021-05-15,1621036800.0
8972,28,3,2021-05-16,70,128,241351,13045,2021-05-16,1621123200.0
8973,28,3,2021-05-17,560,924,241911,13969,2021-05-17,1621206000.0
8974,28,3,2021-05-18,1009,1472,242920,15441,2021-05-18,1621292400.0
8975,28,3,2021-05-19,817,1568,243737,17009,2021-05-19,1621378800.0
8976,28,3,2021-05-20,1055,3136,244792,20145,2021-05-20,1621465200.0
8977,28,3,2021-05-21,928,3982,245720,24127,2021-05-21,1621551600.0
8978,28,3,2021-05-22,310,2208,246030,26335,2021-05-22,1621638000.0
8979,28,3,2021-05-23,38,174,246068,26509,2021-05-23,1621724400.0
8980,28,3,2021-05-24,20,214,246088,26723,2021-05-24,1621810800.0
8981,28,3,2021-05-25,322,1648,246410,28371,2021-05-25,1621897200.0
8982,28,3,2021-05-26,315,2200,246725,30571,2021-05-26,1621983600.0
8983,28,3,2021-05-27,442,3525,247167,34096,2021-05-27,1622070000.0
8984,28,3,2021-05-28,514,5380,247681,39476,2021-05-28,1622156400.0
8985,28,3,2021-05-29,207,2971,247888,42447,2021-05-29,1622242800.0
8986,28,3,2021-05-30,31,250,247919,42697,2021-05-30,1622329200.0
8987,28,3,2021-05-31,107,1658,248026,44355,2021-05-31,1622415600.0
8988,28,3,2021-06-01,191,2943,248217,47298,2021-06-01,1622502000.0
8989,28,3,2021-06-02,141,2639,248358,49937,2021-06-02,1622588400.0
8990,28,3,2021-06-03,180,4298,248538,54235,2021-06-03,1622674800.0
8991,28,3,2021-06-04,256,6151,248794,60386,2021-06-04,1622761200.0
8992,28,3,2021-06-05,123,3152,248917,63538,2021-06-05,1622847600.0
8993,28,3,2021-06-06,32,185,248949,63723,2021-06-06,1622934000.0
8994,28,3,2021-06-07,63,1456,249012,65179,2021-06-07,1623020400.0
8995,28,3,2021-06-08,87,2225,249099,67404,2021-06-08,1623106800.0
8996,28,3,2021-06-09,91,2229,249190,69633,2021-06-09,1623193200.0
8997,28,3,2021-06-10,132,4234,249322,73867,2021-06-10,1623279600.0
8998,28,3,2021-06-11,135,6484,249457,80351,2021-06-11,1623366000.0
8999,28,3,2021-06-12,77,2514,249534,82865,2021-06-12,1623452400.0
9000,28,3,2021-06-13,5,243,249539,83108,2021-06-13,1623538800.0
9001,28,3,2021-06-14,67,2026,249606,85134,2021-06-14,1623625200.0
9002,28,3,2021-06-15,80,4035,249686,89169,2021-06-15,1623711600.0
9003,28,3,2021-06-16,73,3381,249759,92550,2021-06-16,1623798000.0
9004,28,3,2021-06-17,54,5659,249813,98209,2021-06-17,1623884400.0
9005,28,3,2021-06-18,119,7929,249932,106138,2021-06-18,1623970800.0
9006,28,3,2021-06-19,34,2576,249966,108714,2021-06-19,1624057200.0
9007,28,3,2021-06-20,4,114,249970,108828,2021-06-20,1624143600.0
9008,28,3,2021-06-21,40,2304,250010,111132,2021-06-21,1624230000.0
9009,28,3,2021-06-22,34,3769,250044,114901,2021-06-22,1624316400.0
9010,28,3,2021-06-23,22,2345,250066,117246,2021-06-23,1624402800.0
9011,28,3,2021-06-24,52,4390,250118,121636,2021-06-24,1624489200.0
9012,28,3,2021-06-25,103,5703,250221,127339,2021-06-25,1624575600.0
9013,28,3,2021-06-26,35,2084,250256,129423,2021-06-26,1624662000.0
9014,28,3,2021-06-27,3,254,250259,129677,2021-06-27,1624748400.0
9015,28,3,2021-06-28,27,1998,250286,131675,2021-06-28,1624834800.0
9016,28,3,2021-06-29,48,3234,250334,134909,2021-06-29,1624921200.0
9017,28,3,2021-06-30,46,2669,250380,137578,2021-06-30,1625007600.0
9018,28,3,2021-07-01,55,4210,250435,141788,2021-07-01,1625094000.0
9019,28,3,2021-07-02,53,6421,250488,148209,2021-07-02,1625180400.0
9020,28,3,2021-07-03,42,2271,250530,150480,2021-07-03,1625266800.0
9021,28,3,2021-07-04,1,207,250531,150687,2021-07-04,1625353200.0
9022,28,3,2021-07-05,32,2094,250563,152781,2021-07-05,1625439600.0
9023,28,3,2021-07-06,48,3750,250611,156531,2021-07-06,1625526000.0
9024,28,4,2020-12-27,0,0,0,0,2020-12-27,1609023600.0
9025,28,4,2020-12-28,0,0,0,0,2020-12-28,1609110000.0
9026,28,4,2020-12-29,0,0,0,0,2020-12-29,1609196400.0
9027,28,4,2020-12-30,0,0,0,0,2020-12-30,1609282800.0
9028,28,4,2020-12-31,0,0,0,0,2020-12-31,1609369200.0
9029,28,4,2021-01-01,0,0,0,0,2021-01-01,1609455600.0
9030,28,4,2021-01-02,0,0,0,0,2021-01-02,1609542000.0
9031,28,4,2021-01-03,0,0,0,0,2021-01-03,1609628400.0
9032,28,4,2021-01-04,0,0,0,0,2021-01-04,1609714800.0
9033,28,4,2021-01-05,0,0,0,0,2021-01-05,1609801200.0
9034,28,4,2021-01-06,0,0,0,0,2021-01-06,1609887600.0
9035,28,4,2021-01-07,0,0,0,0,2021-01-07,1609974000.0
9036,28,4,2021-01-08,0,0,0,0,2021-01-08,1610060400.0
9037,28,4,2021-01-09,0,0,0,0,2021-01-09,1610146800.0
9038,28,4,2021-01-10,0,0,0,0,2021-01-10,1610233200.0
9039,28,4,2021-01-11,0,0,0,0,2021-01-11,1610319600.0
9040,28,4,2021-01-12,0,0,0,0,2021-01-12,1610406000.0
9041,28,4,2021-01-13,0,0,0,0,2021-01-13,1610492400.0
9042,28,4,2021-01-14,0,0,0,0,2021-01-14,1610578800.0
9043,28,4,2021-01-15,0,0,0,0,2021-01-15,1610665200.0
9044,28,4,2021-01-16,0,0,0,0,2021-01-16,1610751600.0
9045,28,4,2021-01-17,0,0,0,0,2021-01-17,1610838000.0
9046,28,4,2021-01-18,0,0,0,0,2021-01-18,1610924400.0
9047,28,4,2021-01-19,0,0,0,0,2021-01-19,1611010800.0
9048,28,4,2021-01-20,0,0,0,0,2021-01-20,1611097200.0
9049,28,4,2021-01-21,0,0,0,0,2021-01-21,1611183600.0
9050,28,4,2021-01-22,0,0,0,0,2021-01-22,1611270000.0
9051,28,4,2021-01-23,0,0,0,0,2021-01-23,1611356400.0
9052,28,4,2021-01-24,0,0,0,0,2021-01-24,1611442800.0
9053,28,4,2021-01-25,0,0,0,0,2021-01-25,1611529200.0
9054,28,4,2021-01-26,0,0,0,0,2021-01-26,1611615600.0
9055,28,4,2021-01-27,0,0,0,0,2021-01-27,1611702000.0
9056,28,4,2021-01-28,0,0,0,0,2021-01-28,1611788400.0
9057,28,4,2021-01-29,0,0,0,0,2021-01-29,1611874800.0
9058,28,4,2021-01-30,0,0,0,0,2021-01-30,1611961200.0
9059,28,4,2021-01-31,0,0,0,0,2021-01-31,1612047600.0
9060,28,4,2021-02-01,0,0,0,0,2021-02-01,1612134000.0
9061,28,4,2021-02-02,0,0,0,0,2021-02-02,1612220400.0
9062,28,4,2021-02-03,0,0,0,0,2021-02-03,1612306800.0
9063,28,4,2021-02-04,0,0,0,0,2021-02-04,1612393200.0
9064,28,4,2021-02-05,0,0,0,0,2021-02-05,1612479600.0
9065,28,4,2021-02-06,0,0,0,0,2021-02-06,1612566000.0
9066,28,4,2021-02-07,0,0,0,0,2021-02-07,1612652400.0
9067,28,4,2021-02-08,0,0,0,0,2021-02-08,1612738800.0
9068,28,4,2021-02-09,0,0,0,0,2021-02-09,1612825200.0
9069,28,4,2021-02-10,0,0,0,0,2021-02-10,1612911600.0
9070,28,4,2021-02-11,0,0,0,0,2021-02-11,1612998000.0
9071,28,4,2021-02-12,0,0,0,0,2021-02-12,1613084400.0
9072,28,4,2021-02-13,0,0,0,0,2021-02-13,1613170800.0
9073,28,4,2021-02-14,0,0,0,0,2021-02-14,1613257200.0
9074,28,4,2021-02-15,0,0,0,0,2021-02-15,1613343600.0
9075,28,4,2021-02-16,0,0,0,0,2021-02-16,1613430000.0
9076,28,4,2021-02-17,0,0,0,0,2021-02-17,1613516400.0
9077,28,4,2021-02-18,0,0,0,0,2021-02-18,1613602800.0
9078,28,4,2021-02-19,0,0,0,0,2021-02-19,1613689200.0
9079,28,4,2021-02-20,0,0,0,0,2021-02-20,1613775600.0
9080,28,4,2021-02-21,0,0,0,0,2021-02-21,1613862000.0
9081,28,4,2021-02-22,0,0,0,0,2021-02-22,1613948400.0
9082,28,4,2021-02-23,0,0,0,0,2021-02-23,1614034800.0
9083,28,4,2021-02-24,0,0,0,0,2021-02-24,1614121200.0
9084,28,4,2021-02-25,0,0,0,0,2021-02-25,1614207600.0
9085,28,4,2021-02-26,0,0,0,0,2021-02-26,1614294000.0
9086,28,4,2021-02-27,0,0,0,0,2021-02-27,1614380400.0
9087,28,4,2021-02-28,0,0,0,0,2021-02-28,1614466800.0
9088,28,4,2021-03-01,0,0,0,0,2021-03-01,1614553200.0
9089,28,4,2021-03-02,0,0,0,0,2021-03-02,1614639600.0
9090,28,4,2021-03-03,0,0,0,0,2021-03-03,1614726000.0
9091,28,4,2021-03-04,0,0,0,0,2021-03-04,1614812400.0
9092,28,4,2021-03-05,0,0,0,0,2021-03-05,1614898800.0
9093,28,4,2021-03-06,0,0,0,0,2021-03-06,1614985200.0
9094,28,4,2021-03-07,0,0,0,0,2021-03-07,1615071600.0
9095,28,4,2021-03-08,0,0,0,0,2021-03-08,1615158000.0
9096,28,4,2021-03-09,0,0,0,0,2021-03-09,1615244400.0
9097,28,4,2021-03-10,0,0,0,0,2021-03-10,1615330800.0
9098,28,4,2021-03-11,0,0,0,0,2021-03-11,1615417200.0
9099,28,4,2021-03-12,0,0,0,0,2021-03-12,1615503600.0
9100,28,4,2021-03-13,0,0,0,0,2021-03-13,1615590000.0
9101,28,4,2021-03-14,0,0,0,0,2021-03-14,1615676400.0
9102,28,4,2021-03-15,0,0,0,0,2021-03-15,1615762800.0
9103,28,4,2021-03-16,0,0,0,0,2021-03-16,1615849200.0
9104,28,4,2021-03-17,0,0,0,0,2021-03-17,1615935600.0
9105,28,4,2021-03-18,0,0,0,0,2021-03-18,1616022000.0
9106,28,4,2021-03-19,0,0,0,0,2021-03-19,1616108400.0
9107,28,4,2021-03-20,0,0,0,0,2021-03-20,1616194800.0
9108,28,4,2021-03-21,0,0,0,0,2021-03-21,1616281200.0
9109,28,4,2021-03-22,0,0,0,0,2021-03-22,1616367600.0
9110,28,4,2021-03-23,0,0,0,0,2021-03-23,1616454000.0
9111,28,4,2021-03-24,0,0,0,0,2021-03-24,1616540400.0
9112,28,4,2021-03-25,0,0,0,0,2021-03-25,1616626800.0
9113,28,4,2021-03-26,0,0,0,0,2021-03-26,1616713200.0
9114,28,4,2021-03-27,0,0,0,0,2021-03-27,1616799600.0
9115,28,4,2021-03-28,0,0,0,0,2021-03-28,1616886000.0
9116,28,4,2021-03-29,0,0,0,0,2021-03-29,1616972400.0
9117,28,4,2021-03-30,0,0,0,0,2021-03-30,1617058800.0
9118,28,4,2021-03-31,0,0,0,0,2021-03-31,1617145200.0
9119,28,4,2021-04-01,0,0,0,0,2021-04-01,1617231600.0
9120,28,4,2021-04-02,0,0,0,0,2021-04-02,1617318000.0
9121,28,4,2021-04-03,0,0,0,0,2021-04-03,1617404400.0
9122,28,4,2021-04-04,0,0,0,0,2021-04-04,1617490800.0
9123,28,4,2021-04-05,0,0,0,0,2021-04-05,1617577200.0
9124,28,4,2021-04-06,0,0,0,0,2021-04-06,1617663600.0
9125,28,4,2021-04-07,0,0,0,0,2021-04-07,1617750000.0
9126,28,4,2021-04-08,0,0,0,0,2021-04-08,1617836400.0
9127,28,4,2021-04-09,0,0,0,0,2021-04-09,1617922800.0
9128,28,4,2021-04-10,0,0,0,0,2021-04-10,1618009200.0
9129,28,4,2021-04-11,0,0,0,0,2021-04-11,1618095600.0
9130,28,4,2021-04-12,0,0,0,0,2021-04-12,1618185600.0
9131,28,4,2021-04-13,0,0,0,0,2021-04-13,1618272000.0
9132,28,4,2021-04-14,0,0,0,0,2021-04-14,1618358400.0
9133,28,4,2021-04-15,0,0,0,0,2021-04-15,1618444800.0
9134,28,4,2021-04-16,0,0,0,0,2021-04-16,1618531200.0
9135,28,4,2021-04-17,0,0,0,0,2021-04-17,1618617600.0
9136,28,4,2021-04-18,0,0,0,0,2021-04-18,1618704000.0
9137,28,4,2021-04-19,0,0,0,0,2021-04-19,1618790400.0
9138,28,4,2021-04-20,0,0,0,0,2021-04-20,1618876800.0
9139,28,4,2021-04-21,0,0,0,0,2021-04-21,1618963200.0
9140,28,4,2021-04-22,0,0,0,0,2021-04-22,1619049600.0
9141,28,4,2021-04-23,31,0,31,0,2021-04-23,1619136000.0
9142,28,4,2021-04-24,104,0,135,0,2021-04-24,1619222400.0
9143,28,4,2021-04-25,6,0,141,0,2021-04-25,1619308800.0
9144,28,4,2021-04-26,241,0,382,0,2021-04-26,1619395200.0
9145,28,4,2021-04-27,676,0,1058,0,2021-04-27,1619481600.0
9146,28,4,2021-04-28,587,0,1645,0,2021-04-28,1619568000.0
9147,28,4,2021-04-29,950,1,2595,1,2021-04-29,1619654400.0
9148,28,4,2021-04-30,1285,0,3880,1,2021-04-30,1619740800.0
9149,28,4,2021-05-01,126,0,4006,1,2021-05-01,1619827200.0
9150,28,4,2021-05-02,16,0,4022,1,2021-05-02,1619913600.0
9151,28,4,2021-05-03,277,0,4299,1,2021-05-03,1620000000.0
9152,28,4,2021-05-04,607,1,4906,2,2021-05-04,1620086400.0
9153,28,4,2021-05-05,353,3,5259,5,2021-05-05,1620172800.0
9154,28,4,2021-05-06,673,0,5932,5,2021-05-06,1620259200.0
9155,28,4,2021-05-07,1297,0,7229,5,2021-05-07,1620345600.0
9156,28,4,2021-05-08,98,0,7327,5,2021-05-08,1620432000.0
9157,28,4,2021-05-09,20,1,7347,6,2021-05-09,1620518400.0
9158,28,4,2021-05-10,388,0,7735,6,2021-05-10,1620604800.0
9159,28,4,2021-05-11,799,1,8534,7,2021-05-11,1620691200.0
9160,28,4,2021-05-12,483,0,9017,7,2021-05-12,1620777600.0
9161,28,4,2021-05-13,59,0,9076,7,2021-05-13,1620864000.0
9162,28,4,2021-05-14,532,1,9608,8,2021-05-14,1620950400.0
9163,28,4,2021-05-15,208,0,9816,8,2021-05-15,1621036800.0
9164,28,4,2021-05-16,24,0,9840,8,2021-05-16,1621123200.0
9165,28,4,2021-05-17,176,0,10016,8,2021-05-17,1621206000.0
9166,28,4,2021-05-18,362,0,10378,8,2021-05-18,1621292400.0
9167,28,4,2021-05-19,276,2,10654,10,2021-05-19,1621378800.0
9168,28,4,2021-05-20,562,0,11216,10,2021-05-20,1621465200.0
9169,28,4,2021-05-21,856,1,12072,11,2021-05-21,1621551600.0
9170,28,4,2021-05-22,317,0,12389,11,2021-05-22,1621638000.0
9171,28,4,2021-05-23,6,0,12395,11,2021-05-23,1621724400.0
9172,28,4,2021-05-24,59,0,12454,11,2021-05-24,1621810800.0
9173,28,4,2021-05-25,381,1,12835,12,2021-05-25,1621897200.0
9174,28,4,2021-05-26,430,0,13265,12,2021-05-26,1621983600.0
9175,28,4,2021-05-27,1007,1,14272,13,2021-05-27,1622070000.0
9176,28,4,2021-05-28,1760,2,16032,15,2021-05-28,1622156400.0
9177,28,4,2021-05-29,614,1,16646,16,2021-05-29,1622242800.0
9178,28,4,2021-05-30,52,0,16698,16,2021-05-30,1622329200.0
9179,28,4,2021-05-31,636,0,17334,16,2021-05-31,1622415600.0
9180,28,4,2021-06-01,1193,0,18527,16,2021-06-01,1622502000.0
9181,28,4,2021-06-02,756,1,19283,17,2021-06-02,1622588400.0
9182,28,4,2021-06-03,1098,1,20381,18,2021-06-03,1622674800.0
9183,28,4,2021-06-04,1567,2,21948,20,2021-06-04,1622761200.0
9184,28,4,2021-06-05,691,1,22639,21,2021-06-05,1622847600.0
9185,28,4,2021-06-06,79,0,22718,21,2021-06-06,1622934000.0
9186,28,4,2021-06-07,582,1,23300,22,2021-06-07,1623020400.0
9187,28,4,2021-06-08,945,0,24245,22,2021-06-08,1623106800.0
9188,28,4,2021-06-09,667,1,24912,23,2021-06-09,1623193200.0
9189,28,4,2021-06-10,812,0,25724,23,2021-06-10,1623279600.0
9190,28,4,2021-06-11,1067,4,26791,27,2021-06-11,1623366000.0
9191,28,4,2021-06-12,423,1,27214,28,2021-06-12,1623452400.0
9192,28,4,2021-06-13,56,0,27270,28,2021-06-13,1623538800.0
9193,28,4,2021-06-14,332,1,27602,29,2021-06-14,1623625200.0
9194,28,4,2021-06-15,648,0,28250,29,2021-06-15,1623711600.0
9195,28,4,2021-06-16,482,3,28732,32,2021-06-16,1623798000.0
9196,28,4,2021-06-17,696,3,29428,35,2021-06-17,1623884400.0
9197,28,4,2021-06-18,762,0,30190,35,2021-06-18,1623970800.0
9198,28,4,2021-06-19,293,2,30483,37,2021-06-19,1624057200.0
9199,28,4,2021-06-20,32,0,30515,37,2021-06-20,1624143600.0
9200,28,4,2021-06-21,230,0,30745,37,2021-06-21,1624230000.0
9201,28,4,2021-06-22,527,2,31272,39,2021-06-22,1624316400.0
9202,28,4,2021-06-23,366,1,31638,40,2021-06-23,1624402800.0
9203,28,4,2021-06-24,513,0,32151,40,2021-06-24,1624489200.0
9204,28,4,2021-06-25,629,2,32780,42,2021-06-25,1624575600.0
9205,28,4,2021-06-26,357,0,33137,42,2021-06-26,1624662000.0
9206,28,4,2021-06-27,32,0,33169,42,2021-06-27,1624748400.0
9207,28,4,2021-06-28,205,2,33374,44,2021-06-28,1624834800.0
9208,28,4,2021-06-29,441,1,33815,45,2021-06-29,1624921200.0
9209,28,4,2021-06-30,331,0,34146,45,2021-06-30,1625007600.0
9210,28,4,2021-07-01,426,3,34572,48,2021-07-01,1625094000.0
9211,28,4,2021-07-02,533,3,35105,51,2021-07-02,1625180400.0
9212,28,4,2021-07-03,270,0,35375,51,2021-07-03,1625266800.0
9213,28,4,2021-07-04,28,0,35403,51,2021-07-04,1625353200.0
9214,28,4,2021-07-05,202,1,35605,52,2021-07-05,1625439600.0
9215,28,4,2021-07-06,452,1,36057,53,2021-07-06,1625526000.0
9216,32,1,2020-12-27,1,0,1,0,2020-12-27,1609023600.0
9217,32,1,2020-12-28,27,0,28,0,2020-12-28,1609110000.0
9218,32,1,2020-12-29,12,0,40,0,2020-12-29,1609196400.0
9219,32,1,2020-12-30,0,0,40,0,2020-12-30,1609282800.0
9220,32,1,2020-12-31,0,0,40,0,2020-12-31,1609369200.0
9221,32,1,2021-01-01,1,0,41,0,2021-01-01,1609455600.0
9222,32,1,2021-01-02,6,0,47,0,2021-01-02,1609542000.0
9223,32,1,2021-01-03,4,0,51,0,2021-01-03,1609628400.0
9224,32,1,2021-01-04,82,0,133,0,2021-01-04,1609714800.0
9225,32,1,2021-01-05,300,0,433,0,2021-01-05,1609801200.0
9226,32,1,2021-01-06,788,0,1221,0,2021-01-06,1609887600.0
9227,32,1,2021-01-07,2430,0,3651,0,2021-01-07,1609974000.0
9228,32,1,2021-01-08,3167,0,6818,0,2021-01-08,1610060400.0
9229,32,1,2021-01-09,957,0,7775,0,2021-01-09,1610146800.0
9230,32,1,2021-01-10,641,0,8416,0,2021-01-10,1610233200.0
9231,32,1,2021-01-11,3269,0,11685,0,2021-01-11,1610319600.0
9232,32,1,2021-01-12,5023,0,16708,0,2021-01-12,1610406000.0
9233,32,1,2021-01-13,4943,0,21651,0,2021-01-13,1610492400.0
9234,32,1,2021-01-14,5723,0,27374,0,2021-01-14,1610578800.0
9235,32,1,2021-01-15,5228,0,32602,0,2021-01-15,1610665200.0
9236,32,1,2021-01-16,1636,8,34238,8,2021-01-16,1610751600.0
9237,32,1,2021-01-17,860,2,35098,10,2021-01-17,1610838000.0
9238,32,1,2021-01-18,7234,16,42332,26,2021-01-18,1610924400.0
9239,32,1,2021-01-19,9900,26,52232,52,2021-01-19,1611010800.0
9240,32,1,2021-01-20,10368,15,62600,67,2021-01-20,1611097200.0
9241,32,1,2021-01-21,12715,29,75315,96,2021-01-21,1611183600.0
9242,32,1,2021-01-22,9881,11,85196,107,2021-01-22,1611270000.0
9243,32,1,2021-01-23,3412,1,88608,108,2021-01-23,1611356400.0
9244,32,1,2021-01-24,1119,2,89727,110,2021-01-24,1611442800.0
9245,32,1,2021-01-25,6865,68,96592,178,2021-01-25,1611529200.0
9246,32,1,2021-01-26,7446,163,104038,341,2021-01-26,1611615600.0
9247,32,1,2021-01-27,4837,506,108875,847,2021-01-27,1611702000.0
9248,32,1,2021-01-28,8597,1668,117472,2515,2021-01-28,1611788400.0
9249,32,1,2021-01-29,5384,1835,122856,4350,2021-01-29,1611874800.0
9250,32,1,2021-01-30,534,413,123390,4763,2021-01-30,1611961200.0
9251,32,1,2021-01-31,67,74,123457,4837,2021-01-31,1612047600.0
9252,32,1,2021-02-01,192,1814,123649,6651,2021-02-01,1612134000.0
9253,32,1,2021-02-02,765,3159,124414,9810,2021-02-02,1612220400.0
9254,32,1,2021-02-03,3856,3176,128270,12986,2021-02-03,1612306800.0
9255,32,1,2021-02-04,3137,3601,131407,16587,2021-02-04,1612393200.0
9256,32,1,2021-02-05,1243,3264,132650,19851,2021-02-05,1612479600.0
9257,32,1,2021-02-06,190,873,132840,20724,2021-02-06,1612566000.0
9258,32,1,2021-02-07,159,80,132999,20804,2021-02-07,1612652400.0
9259,32,1,2021-02-08,841,3662,133840,24466,2021-02-08,1612738800.0
9260,32,1,2021-02-09,1208,4341,135048,28807,2021-02-09,1612825200.0
9261,32,1,2021-02-10,1332,5307,136380,34114,2021-02-10,1612911600.0
9262,32,1,2021-02-11,2342,6135,138722,40249,2021-02-11,1612998000.0
9263,32,1,2021-02-12,2199,4556,140921,44805,2021-02-12,1613084400.0
9264,32,1,2021-02-13,652,1890,141573,46695,2021-02-13,1613170800.0
9265,32,1,2021-02-14,95,710,141668,47405,2021-02-14,1613257200.0
9266,32,1,2021-02-15,2277,6869,143945,54274,2021-02-15,1613343600.0
9267,32,1,2021-02-16,2802,8191,146747,62465,2021-02-16,1613430000.0
9268,32,1,2021-02-17,3107,8621,149854,71086,2021-02-17,1613516400.0
9269,32,1,2021-02-18,5030,11288,154884,82374,2021-02-18,1613602800.0
9270,32,1,2021-02-19,5525,8180,160409,90554,2021-02-19,1613689200.0
9271,32,1,2021-02-20,1995,2982,162404,93536,2021-02-20,1613775600.0
9272,32,1,2021-02-21,203,484,162607,94020,2021-02-21,1613862000.0
9273,32,1,2021-02-22,2441,5292,165048,99312,2021-02-22,1613948400.0
9274,32,1,2021-02-23,3944,5852,168992,105164,2021-02-23,1614034800.0
9275,32,1,2021-02-24,5576,5974,174568,111138,2021-02-24,1614121200.0
9276,32,1,2021-02-25,6442,4836,181010,115974,2021-02-25,1614207600.0
9277,32,1,2021-02-26,5938,2673,186948,118647,2021-02-26,1614294000.0
9278,32,1,2021-02-27,1460,199,188408,118846,2021-02-27,1614380400.0
9279,32,1,2021-02-28,90,131,188498,118977,2021-02-28,1614466800.0
9280,32,1,2021-03-01,5580,766,194078,119743,2021-03-01,1614553200.0
9281,32,1,2021-03-02,7217,739,201295,120482,2021-03-02,1614639600.0
9282,32,1,2021-03-03,7088,1309,208383,121791,2021-03-03,1614726000.0
9283,32,1,2021-03-04,6787,1708,215170,123499,2021-03-04,1614812400.0
9284,32,1,2021-03-05,7325,1285,222495,124784,2021-03-05,1614898800.0
9285,32,1,2021-03-06,15208,467,237703,125251,2021-03-06,1614985200.0
9286,32,1,2021-03-07,14532,269,252235,125520,2021-03-07,1615071600.0
9287,32,1,2021-03-08,6059,1538,258294,127058,2021-03-08,1615158000.0
9288,32,1,2021-03-09,7600,1977,265894,129035,2021-03-09,1615244400.0
9289,32,1,2021-03-10,8302,1666,274196,130701,2021-03-10,1615330800.0
9290,32,1,2021-03-11,8925,3160,283121,133861,2021-03-11,1615417200.0
9291,32,1,2021-03-12,8393,2617,291514,136478,2021-03-12,1615503600.0
9292,32,1,2021-03-13,22223,1269,313737,137747,2021-03-13,1615590000.0
9293,32,1,2021-03-14,18045,317,331782,138064,2021-03-14,1615676400.0
9294,32,1,2021-03-15,6927,2897,338709,140961,2021-03-15,1615762800.0
9295,32,1,2021-03-16,9535,3076,348244,144037,2021-03-16,1615849200.0
9296,32,1,2021-03-17,9449,3733,357693,147770,2021-03-17,1615935600.0
9297,32,1,2021-03-18,9530,4283,367223,152053,2021-03-18,1616022000.0
9298,32,1,2021-03-19,9775,3250,376998,155303,2021-03-19,1616108400.0
9299,32,1,2021-03-20,14497,1200,391495,156503,2021-03-20,1616194800.0
9300,32,1,2021-03-21,9466,296,400961,156799,2021-03-21,1616281200.0
9301,32,1,2021-03-22,7407,3667,408368,160466,2021-03-22,1616367600.0
9302,32,1,2021-03-23,8833,4982,417201,165448,2021-03-23,1616454000.0
9303,32,1,2021-03-24,8242,5214,425443,170662,2021-03-24,1616540400.0
9304,32,1,2021-03-25,10124,4519,435567,175181,2021-03-25,1616626800.0
9305,32,1,2021-03-26,11617,4735,447184,179916,2021-03-26,1616713200.0
9306,32,1,2021-03-27,25587,1142,472771,181058,2021-03-27,1616799600.0
9307,32,1,2021-03-28,14005,132,486776,181190,2021-03-28,1616886000.0
9308,32,1,2021-03-29,9273,6310,496049,187500,2021-03-29,1616972400.0
9309,32,1,2021-03-30,10785,7704,506834,195204,2021-03-30,1617058800.0
9310,32,1,2021-03-31,9329,8267,516163,203471,2021-03-31,1617145200.0
9311,32,1,2021-04-01,10379,9796,526542,213267,2021-04-01,1617231600.0
9312,32,1,2021-04-02,9534,11552,536076,224819,2021-04-02,1617318000.0
9313,32,1,2021-04-03,22895,9108,558971,233927,2021-04-03,1617404400.0
9314,32,1,2021-04-04,9675,4288,568646,238215,2021-04-04,1617490800.0
9315,32,1,2021-04-05,7360,1904,576006,240119,2021-04-05,1617577200.0
9316,32,1,2021-04-06,10102,10176,586108,250295,2021-04-06,1617663600.0
9317,32,1,2021-04-07,13389,11504,599497,261799,2021-04-07,1617750000.0
9318,32,1,2021-04-08,15137,11254,614634,273053,2021-04-08,1617836400.0
9319,32,1,2021-04-09,11578,11571,626212,284624,2021-04-09,1617922800.0
9320,32,1,2021-04-10,11340,17430,637552,302054,2021-04-10,1618009200.0
9321,32,1,2021-04-11,5903,11358,643455,313412,2021-04-11,1618095600.0
9322,32,1,2021-04-12,9002,8357,652457,321769,2021-04-12,1618185600.0
9323,32,1,2021-04-13,11505,10468,663962,332237,2021-04-13,1618272000.0
9324,32,1,2021-04-14,13999,9983,677961,342220,2021-04-14,1618358400.0
9325,32,1,2021-04-15,14868,9519,692829,351739,2021-04-15,1618444800.0
9326,32,1,2021-04-16,11653,10525,704482,362264,2021-04-16,1618531200.0
9327,32,1,2021-04-17,7073,11514,711555,373778,2021-04-17,1618617600.0
9328,32,1,2021-04-18,3748,6138,715303,379916,2021-04-18,1618704000.0
9329,32,1,2021-04-19,8719,8189,724022,388105,2021-04-19,1618790400.0
9330,32,1,2021-04-20,11611,9687,735633,397792,2021-04-20,1618876800.0
9331,32,1,2021-04-21,11441,9958,747074,407750,2021-04-21,1618963200.0
9332,32,1,2021-04-22,12218,12109,759292,419859,2021-04-22,1619049600.0
9333,32,1,2021-04-23,10436,12863,769728,432722,2021-04-23,1619136000.0
9334,32,1,2021-04-24,8535,18574,778263,451296,2021-04-24,1619222400.0
9335,32,1,2021-04-25,5328,9043,783591,460339,2021-04-25,1619308800.0
9336,32,1,2021-04-26,10285,8610,793876,468949,2021-04-26,1619395200.0
9337,32,1,2021-04-27,13769,11262,807645,480211,2021-04-27,1619481600.0
9338,32,1,2021-04-28,15316,12095,822961,492306,2021-04-28,1619568000.0
9339,32,1,2021-04-29,15910,15314,838871,507620,2021-04-29,1619654400.0
9340,32,1,2021-04-30,16528,15620,855399,523240,2021-04-30,1619740800.0
9341,32,1,2021-05-01,20880,11580,876279,534820,2021-05-01,1619827200.0
9342,32,1,2021-05-02,20150,8281,896429,543101,2021-05-02,1619913600.0
9343,32,1,2021-05-03,19804,8607,916233,551708,2021-05-03,1620000000.0
9344,32,1,2021-05-04,20934,12196,937167,563904,2021-05-04,1620086400.0
9345,32,1,2021-05-05,21525,12720,958692,576624,2021-05-05,1620172800.0
9346,32,1,2021-05-06,21172,12892,979864,589516,2021-05-06,1620259200.0
9347,32,1,2021-05-07,24463,13100,1004327,602616,2021-05-07,1620345600.0
9348,32,1,2021-05-08,33188,4961,1037515,607577,2021-05-08,1620432000.0
9349,32,1,2021-05-09,25795,3879,1063310,611456,2021-05-09,1620518400.0
9350,32,1,2021-05-10,21630,11316,1084940,622772,2021-05-10,1620604800.0
9351,32,1,2021-05-11,27225,12708,1112165,635480,2021-05-11,1620691200.0
9352,32,1,2021-05-12,32983,10832,1145148,646312,2021-05-12,1620777600.0
9353,32,1,2021-05-13,34995,4102,1180143,650414,2021-05-13,1620864000.0
9354,32,1,2021-05-14,34548,7417,1214691,657831,2021-05-14,1620950400.0
9355,32,1,2021-05-15,50034,3512,1264725,661343,2021-05-15,1621036800.0
9356,32,1,2021-05-16,37583,1131,1302308,662474,2021-05-16,1621123200.0
9357,32,1,2021-05-17,27402,5890,1329710,668364,2021-05-17,1621206000.0
9358,32,1,2021-05-18,31884,5595,1361594,673959,2021-05-18,1621292400.0
9359,32,1,2021-05-19,33884,4514,1395478,678473,2021-05-19,1621378800.0
9360,32,1,2021-05-20,34239,4771,1429717,683244,2021-05-20,1621465200.0
9361,32,1,2021-05-21,35624,4800,1465341,688044,2021-05-21,1621551600.0
9362,32,1,2021-05-22,47669,3085,1513010,691129,2021-05-22,1621638000.0
9363,32,1,2021-05-23,30045,1058,1543055,692187,2021-05-23,1621724400.0
9364,32,1,2021-05-24,26103,955,1569158,693142,2021-05-24,1621810800.0
9365,32,1,2021-05-25,28031,7496,1597189,700638,2021-05-25,1621897200.0
9366,32,1,2021-05-26,31946,7636,1629135,708274,2021-05-26,1621983600.0
9367,32,1,2021-05-27,30887,7741,1660022,716015,2021-05-27,1622070000.0
9368,32,1,2021-05-28,28467,9034,1688489,725049,2021-05-28,1622156400.0
9369,32,1,2021-05-29,32597,6818,1721086,731867,2021-05-29,1622242800.0
9370,32,1,2021-05-30,15154,1434,1736240,733301,2021-05-30,1622329200.0
9371,32,1,2021-05-31,23302,9287,1759542,742588,2021-05-31,1622415600.0
9372,32,1,2021-06-01,26133,11738,1785675,754326,2021-06-01,1622502000.0
9373,32,1,2021-06-02,27484,11137,1813159,765463,2021-06-02,1622588400.0
9374,32,1,2021-06-03,28129,10912,1841288,776375,2021-06-03,1622674800.0
9375,32,1,2021-06-04,27631,12014,1868919,788389,2021-06-04,1622761200.0
9376,32,1,2021-06-05,29042,10446,1897961,798835,2021-06-05,1622847600.0
9377,32,1,2021-06-06,15877,3357,1913838,802192,2021-06-06,1622934000.0
9378,32,1,2021-06-07,17959,12650,1931797,814842,2021-06-07,1623020400.0
9379,32,1,2021-06-08,20923,15027,1952720,829869,2021-06-08,1623106800.0
9380,32,1,2021-06-09,19911,16187,1972631,846056,2021-06-09,1623193200.0
9381,32,1,2021-06-10,19393,15510,1992024,861566,2021-06-10,1623279600.0
9382,32,1,2021-06-11,18940,20770,2010964,882336,2021-06-11,1623366000.0
9383,32,1,2021-06-12,21064,20995,2032028,903331,2021-06-12,1623452400.0
9384,32,1,2021-06-13,11293,12559,2043321,915890,2021-06-13,1623538800.0
9385,32,1,2021-06-14,10623,20521,2053944,936411,2021-06-14,1623625200.0
9386,32,1,2021-06-15,15453,23797,2069397,960208,2021-06-15,1623711600.0
9387,32,1,2021-06-16,17056,22587,2086453,982795,2021-06-16,1623798000.0
9388,32,1,2021-06-17,17215,21157,2103668,1003952,2021-06-17,1623884400.0
9389,32,1,2021-06-18,16051,25946,2119719,1029898,2021-06-18,1623970800.0
9390,32,1,2021-06-19,18106,33232,2137825,1063130,2021-06-19,1624057200.0
9391,32,1,2021-06-20,8949,16812,2146774,1079942,2021-06-20,1624143600.0
9392,32,1,2021-06-21,9342,28027,2156116,1107969,2021-06-21,1624230000.0
9393,32,1,2021-06-22,10240,31553,2166356,1139522,2021-06-22,1624316400.0
9394,32,1,2021-06-23,11658,33882,2178014,1173404,2021-06-23,1624402800.0
9395,32,1,2021-06-24,11736,30279,2189750,1203683,2021-06-24,1624489200.0
9396,32,1,2021-06-25,10430,34183,2200180,1237866,2021-06-25,1624575600.0
9397,32,1,2021-06-26,11843,42457,2212023,1280323,2021-06-26,1624662000.0
9398,32,1,2021-06-27,7084,24896,2219107,1305219,2021-06-27,1624748400.0
9399,32,1,2021-06-28,8650,30792,2227757,1336011,2021-06-28,1624834800.0
9400,32,1,2021-06-29,10762,33093,2238519,1369104,2021-06-29,1624921200.0
9401,32,1,2021-06-30,12422,32762,2250941,1401866,2021-06-30,1625007600.0
9402,32,1,2021-07-01,12519,31131,2263460,1432997,2021-07-01,1625094000.0
9403,32,1,2021-07-02,12797,32263,2276257,1465260,2021-07-02,1625180400.0
9404,32,1,2021-07-03,10668,42324,2286925,1507584,2021-07-03,1625266800.0
9405,32,1,2021-07-04,7472,23228,2294397,1530812,2021-07-04,1625353200.0
9406,32,1,2021-07-05,9852,26408,2304249,1557220,2021-07-05,1625439600.0
9407,32,1,2021-07-06,13001,29277,2317250,1586497,2021-07-06,1625526000.0
9408,32,2,2020-12-27,0,0,0,0,2020-12-27,1609023600.0
9409,32,2,2020-12-28,0,0,0,0,2020-12-28,1609110000.0
9410,32,2,2020-12-29,0,0,0,0,2020-12-29,1609196400.0
9411,32,2,2020-12-30,0,0,0,0,2020-12-30,1609282800.0
9412,32,2,2020-12-31,0,0,0,0,2020-12-31,1609369200.0
9413,32,2,2021-01-01,0,0,0,0,2021-01-01,1609455600.0
9414,32,2,2021-01-02,0,0,0,0,2021-01-02,1609542000.0
9415,32,2,2021-01-03,0,0,0,0,2021-01-03,1609628400.0
9416,32,2,2021-01-04,0,0,0,0,2021-01-04,1609714800.0
9417,32,2,2021-01-05,0,0,0,0,2021-01-05,1609801200.0
9418,32,2,2021-01-06,0,0,0,0,2021-01-06,1609887600.0
9419,32,2,2021-01-07,0,0,0,0,2021-01-07,1609974000.0
9420,32,2,2021-01-08,0,0,0,0,2021-01-08,1610060400.0
9421,32,2,2021-01-09,0,0,0,0,2021-01-09,1610146800.0
9422,32,2,2021-01-10,0,0,0,0,2021-01-10,1610233200.0
9423,32,2,2021-01-11,0,0,0,0,2021-01-11,1610319600.0
9424,32,2,2021-01-12,0,0,0,0,2021-01-12,1610406000.0
9425,32,2,2021-01-13,0,0,0,0,2021-01-13,1610492400.0
9426,32,2,2021-01-14,0,0,0,0,2021-01-14,1610578800.0
9427,32,2,2021-01-15,0,0,0,0,2021-01-15,1610665200.0
9428,32,2,2021-01-16,1,0,1,0,2021-01-16,1610751600.0
9429,32,2,2021-01-17,0,0,1,0,2021-01-17,1610838000.0
9430,32,2,2021-01-18,0,0,1,0,2021-01-18,1610924400.0
9431,32,2,2021-01-19,1,0,2,0,2021-01-19,1611010800.0
9432,32,2,2021-01-20,1,0,3,0,2021-01-20,1611097200.0
9433,32,2,2021-01-21,2,0,5,0,2021-01-21,1611183600.0
9434,32,2,2021-01-22,2,0,7,0,2021-01-22,1611270000.0
9435,32,2,2021-01-23,0,0,7,0,2021-01-23,1611356400.0
9436,32,2,2021-01-24,0,0,7,0,2021-01-24,1611442800.0
9437,32,2,2021-01-25,2,0,9,0,2021-01-25,1611529200.0
9438,32,2,2021-01-26,1,0,10,0,2021-01-26,1611615600.0
9439,32,2,2021-01-27,0,0,10,0,2021-01-27,1611702000.0
9440,32,2,2021-01-28,1,0,11,0,2021-01-28,1611788400.0
9441,32,2,2021-01-29,1,0,12,0,2021-01-29,1611874800.0
9442,32,2,2021-01-30,0,0,12,0,2021-01-30,1611961200.0
9443,32,2,2021-01-31,0,0,12,0,2021-01-31,1612047600.0
9444,32,2,2021-02-01,0,0,12,0,2021-02-01,1612134000.0
9445,32,2,2021-02-02,22,0,34,0,2021-02-02,1612220400.0
9446,32,2,2021-02-03,220,0,254,0,2021-02-03,1612306800.0
9447,32,2,2021-02-04,550,0,804,0,2021-02-04,1612393200.0
9448,32,2,2021-02-05,719,0,1523,0,2021-02-05,1612479600.0
9449,32,2,2021-02-06,275,0,1798,0,2021-02-06,1612566000.0
9450,32,2,2021-02-07,26,0,1824,0,2021-02-07,1612652400.0
9451,32,2,2021-02-08,866,2,2690,2,2021-02-08,1612738800.0
9452,32,2,2021-02-09,1060,2,3750,4,2021-02-09,1612825200.0
9453,32,2,2021-02-10,1046,0,4796,4,2021-02-10,1612911600.0
9454,32,2,2021-02-11,1248,0,6044,4,2021-02-11,1612998000.0
9455,32,2,2021-02-12,1343,1,7387,5,2021-02-12,1613084400.0
9456,32,2,2021-02-13,214,1,7601,6,2021-02-13,1613170800.0
9457,32,2,2021-02-14,21,0,7622,6,2021-02-14,1613257200.0
9458,32,2,2021-02-15,405,2,8027,8,2021-02-15,1613343600.0
9459,32,2,2021-02-16,304,0,8331,8,2021-02-16,1613430000.0
9460,32,2,2021-02-17,163,2,8494,10,2021-02-17,1613516400.0
9461,32,2,2021-02-18,363,1,8857,11,2021-02-18,1613602800.0
9462,32,2,2021-02-19,183,1,9040,12,2021-02-19,1613689200.0
9463,32,2,2021-02-20,40,0,9080,12,2021-02-20,1613775600.0
9464,32,2,2021-02-21,0,0,9080,12,2021-02-21,1613862000.0
9465,32,2,2021-02-22,280,0,9360,12,2021-02-22,1613948400.0
9466,32,2,2021-02-23,486,2,9846,14,2021-02-23,1614034800.0
9467,32,2,2021-02-24,437,1,10283,15,2021-02-24,1614121200.0
9468,32,2,2021-02-25,489,0,10772,15,2021-02-25,1614207600.0
9469,32,2,2021-02-26,342,0,11114,15,2021-02-26,1614294000.0
9470,32,2,2021-02-27,33,0,11147,15,2021-02-27,1614380400.0
9471,32,2,2021-02-28,0,0,11147,15,2021-02-28,1614466800.0
9472,32,2,2021-03-01,317,21,11464,36,2021-03-01,1614553200.0
9473,32,2,2021-03-02,422,98,11886,134,2021-03-02,1614639600.0
9474,32,2,2021-03-03,469,239,12355,373,2021-03-03,1614726000.0
9475,32,2,2021-03-04,560,474,12915,847,2021-03-04,1614812400.0
9476,32,2,2021-03-05,383,514,13298,1361,2021-03-05,1614898800.0
9477,32,2,2021-03-06,128,246,13426,1607,2021-03-06,1614985200.0
9478,32,2,2021-03-07,50,0,13476,1607,2021-03-07,1615071600.0
9479,32,2,2021-03-08,222,888,13698,2495,2021-03-08,1615158000.0
9480,32,2,2021-03-09,106,1081,13804,3576,2021-03-09,1615244400.0
9481,32,2,2021-03-10,194,1271,13998,4847,2021-03-10,1615330800.0
9482,32,2,2021-03-11,641,1117,14639,5964,2021-03-11,1615417200.0
9483,32,2,2021-03-12,371,1052,15010,7016,2021-03-12,1615503600.0
9484,32,2,2021-03-13,302,203,15312,7219,2021-03-13,1615590000.0
9485,32,2,2021-03-14,278,10,15590,7229,2021-03-14,1615676400.0
9486,32,2,2021-03-15,610,359,16200,7588,2021-03-15,1615762800.0
9487,32,2,2021-03-16,208,237,16408,7825,2021-03-16,1615849200.0
9488,32,2,2021-03-17,223,186,16631,8011,2021-03-17,1615935600.0
9489,32,2,2021-03-18,414,489,17045,8500,2021-03-18,1616022000.0
9490,32,2,2021-03-19,720,185,17765,8685,2021-03-19,1616108400.0
9491,32,2,2021-03-20,12432,62,30197,8747,2021-03-20,1616194800.0
9492,32,2,2021-03-21,9689,33,39886,8780,2021-03-21,1616281200.0
9493,32,2,2021-03-22,1562,304,41448,9084,2021-03-22,1616367600.0
9494,32,2,2021-03-23,1368,458,42816,9542,2021-03-23,1616454000.0
9495,32,2,2021-03-24,1411,427,44227,9969,2021-03-24,1616540400.0
9496,32,2,2021-03-25,1045,495,45272,10464,2021-03-25,1616626800.0
9497,32,2,2021-03-26,1321,336,46593,10800,2021-03-26,1616713200.0
9498,32,2,2021-03-27,1420,36,48013,10836,2021-03-27,1616799600.0
9499,32,2,2021-03-28,3081,3,51094,10839,2021-03-28,1616886000.0
9500,32,2,2021-03-29,990,292,52084,11131,2021-03-29,1616972400.0
9501,32,2,2021-03-30,445,399,52529,11530,2021-03-30,1617058800.0
9502,32,2,2021-03-31,1227,457,53756,11987,2021-03-31,1617145200.0
9503,32,2,2021-04-01,1020,539,54776,12526,2021-04-01,1617231600.0
9504,32,2,2021-04-02,1446,367,56222,12893,2021-04-02,1617318000.0
9505,32,2,2021-04-03,266,43,56488,12936,2021-04-03,1617404400.0
9506,32,2,2021-04-04,602,45,57090,12981,2021-04-04,1617490800.0
9507,32,2,2021-04-05,72,106,57162,13087,2021-04-05,1617577200.0
9508,32,2,2021-04-06,1251,130,58413,13217,2021-04-06,1617663600.0
9509,32,2,2021-04-07,1707,132,60120,13349,2021-04-07,1617750000.0
9510,32,2,2021-04-08,1782,538,61902,13887,2021-04-08,1617836400.0
9511,32,2,2021-04-09,1836,301,63738,14188,2021-04-09,1617922800.0
9512,32,2,2021-04-10,856,326,64594,14514,2021-04-10,1618009200.0
9513,32,2,2021-04-11,565,250,65159,14764,2021-04-11,1618095600.0
9514,32,2,2021-04-12,1019,511,66178,15275,2021-04-12,1618185600.0
9515,32,2,2021-04-13,1216,173,67394,15448,2021-04-13,1618272000.0
9516,32,2,2021-04-14,1231,205,68625,15653,2021-04-14,1618358400.0
9517,32,2,2021-04-15,1385,382,70010,16035,2021-04-15,1618444800.0
9518,32,2,2021-04-16,1182,759,71192,16794,2021-04-16,1618531200.0
9519,32,2,2021-04-17,1394,10587,72586,27381,2021-04-17,1618617600.0
9520,32,2,2021-04-18,962,7536,73548,34917,2021-04-18,1618704000.0
9521,32,2,2021-04-19,404,997,73952,35914,2021-04-19,1618790400.0
9522,32,2,2021-04-20,626,1870,74578,37784,2021-04-20,1618876800.0
9523,32,2,2021-04-21,613,1772,75191,39556,2021-04-21,1618963200.0
9524,32,2,2021-04-22,1215,1729,76406,41285,2021-04-22,1619049600.0
9525,32,2,2021-04-23,983,1975,77389,43260,2021-04-23,1619136000.0
9526,32,2,2021-04-24,534,1356,77923,44616,2021-04-24,1619222400.0
9527,32,2,2021-04-25,148,2791,78071,47407,2021-04-25,1619308800.0
9528,32,2,2021-04-26,460,970,78531,48377,2021-04-26,1619395200.0
9529,32,2,2021-04-27,711,512,79242,48889,2021-04-27,1619481600.0
9530,32,2,2021-04-28,632,1247,79874,50136,2021-04-28,1619568000.0
9531,32,2,2021-04-29,617,863,80491,50999,2021-04-29,1619654400.0
9532,32,2,2021-04-30,920,1251,81411,52250,2021-04-30,1619740800.0
9533,32,2,2021-05-01,108,316,81519,52566,2021-05-01,1619827200.0
9534,32,2,2021-05-02,88,718,81607,53284,2021-05-02,1619913600.0
9535,32,2,2021-05-03,431,595,82038,53879,2021-05-03,1620000000.0
9536,32,2,2021-05-04,347,1196,82385,55075,2021-05-04,1620086400.0
9537,32,2,2021-05-05,391,1729,82776,56804,2021-05-05,1620172800.0
9538,32,2,2021-05-06,389,2066,83165,58870,2021-05-06,1620259200.0
9539,32,2,2021-05-07,332,1882,83497,60752,2021-05-07,1620345600.0
9540,32,2,2021-05-08,151,324,83648,61076,2021-05-08,1620432000.0
9541,32,2,2021-05-09,748,133,84396,61209,2021-05-09,1620518400.0
9542,32,2,2021-05-10,421,1548,84817,62757,2021-05-10,1620604800.0
9543,32,2,2021-05-11,588,947,85405,63704,2021-05-11,1620691200.0
9544,32,2,2021-05-12,1592,1716,86997,65420,2021-05-12,1620777600.0
9545,32,2,2021-05-13,5192,110,92189,65530,2021-05-13,1620864000.0
9546,32,2,2021-05-14,4743,777,96932,66307,2021-05-14,1620950400.0
9547,32,2,2021-05-15,7698,522,104630,66829,2021-05-15,1621036800.0
9548,32,2,2021-05-16,10091,118,114721,66947,2021-05-16,1621123200.0
9549,32,2,2021-05-17,3014,557,117735,67504,2021-05-17,1621206000.0
9550,32,2,2021-05-18,2897,411,120632,67915,2021-05-18,1621292400.0
9551,32,2,2021-05-19,3483,394,124115,68309,2021-05-19,1621378800.0
9552,32,2,2021-05-20,3370,430,127485,68739,2021-05-20,1621465200.0
9553,32,2,2021-05-21,4156,589,131641,69328,2021-05-21,1621551600.0
9554,32,2,2021-05-22,8780,124,140421,69452,2021-05-22,1621638000.0
9555,32,2,2021-05-23,8797,68,149218,69520,2021-05-23,1621724400.0
9556,32,2,2021-05-24,2244,67,151462,69587,2021-05-24,1621810800.0
9557,32,2,2021-05-25,2035,632,153497,70219,2021-05-25,1621897200.0
9558,32,2,2021-05-26,1258,943,154755,71162,2021-05-26,1621983600.0
9559,32,2,2021-05-27,1908,989,156663,72151,2021-05-27,1622070000.0
9560,32,2,2021-05-28,2510,1077,159173,73228,2021-05-28,1622156400.0
9561,32,2,2021-05-29,2959,553,162132,73781,2021-05-29,1622242800.0
9562,32,2,2021-05-30,773,53,162905,73834,2021-05-30,1622329200.0
9563,32,2,2021-05-31,3164,927,166069,74761,2021-05-31,1622415600.0
9564,32,2,2021-06-01,4635,1121,170704,75882,2021-06-01,1622502000.0
9565,32,2,2021-06-02,3173,733,173877,76615,2021-06-02,1622588400.0
9566,32,2,2021-06-03,4302,1362,178179,77977,2021-06-03,1622674800.0
9567,32,2,2021-06-04,5804,778,183983,78755,2021-06-04,1622761200.0
9568,32,2,2021-06-05,3936,696,187919,79451,2021-06-05,1622847600.0
9569,32,2,2021-06-06,529,73,188448,79524,2021-06-06,1622934000.0
9570,32,2,2021-06-07,2459,775,190907,80299,2021-06-07,1623020400.0
9571,32,2,2021-06-08,3959,1029,194866,81328,2021-06-08,1623106800.0
9572,32,2,2021-06-09,3232,704,198098,82032,2021-06-09,1623193200.0
9573,32,2,2021-06-10,4038,685,202136,82717,2021-06-10,1623279600.0
9574,32,2,2021-06-11,5550,1061,207686,83778,2021-06-11,1623366000.0
9575,32,2,2021-06-12,3922,464,211608,84242,2021-06-12,1623452400.0
9576,32,2,2021-06-13,357,196,211965,84438,2021-06-13,1623538800.0
9577,32,2,2021-06-14,1998,994,213963,85432,2021-06-14,1623625200.0
9578,32,2,2021-06-15,3241,603,217204,86035,2021-06-15,1623711600.0
9579,32,2,2021-06-16,2681,572,219885,86607,2021-06-16,1623798000.0
9580,32,2,2021-06-17,3270,818,223155,87425,2021-06-17,1623884400.0
9581,32,2,2021-06-18,4228,883,227383,88308,2021-06-18,1623970800.0
9582,32,2,2021-06-19,3665,885,231048,89193,2021-06-19,1624057200.0
9583,32,2,2021-06-20,212,557,231260,89750,2021-06-20,1624143600.0
9584,32,2,2021-06-21,1648,1154,232908,90904,2021-06-21,1624230000.0
9585,32,2,2021-06-22,2697,1247,235605,92151,2021-06-22,1624316400.0
9586,32,2,2021-06-23,2031,2084,237636,94235,2021-06-23,1624402800.0
9587,32,2,2021-06-24,2676,5080,240312,99315,2021-06-24,1624489200.0
9588,32,2,2021-06-25,3362,6431,243674,105746,2021-06-25,1624575600.0
9589,32,2,2021-06-26,2507,7912,246181,113658,2021-06-26,1624662000.0
9590,32,2,2021-06-27,270,6487,246451,120145,2021-06-27,1624748400.0
9591,32,2,2021-06-28,1306,2555,247757,122700,2021-06-28,1624834800.0
9592,32,2,2021-06-29,1830,3614,249587,126314,2021-06-29,1624921200.0
9593,32,2,2021-06-30,1838,3669,251425,129983,2021-06-30,1625007600.0
9594,32,2,2021-07-01,2331,3769,253756,133752,2021-07-01,1625094000.0
9595,32,2,2021-07-02,2534,5640,256290,139392,2021-07-02,1625180400.0
9596,32,2,2021-07-03,1836,7913,258126,147305,2021-07-03,1625266800.0
9597,32,2,2021-07-04,236,6008,258362,153313,2021-07-04,1625353200.0
9598,32,2,2021-07-05,911,2544,259273,155857,2021-07-05,1625439600.0
9599,32,2,2021-07-06,1130,2145,260403,158002,2021-07-06,1625526000.0
9600,32,3,2020-12-27,0,0,0,0,2020-12-27,1609023600.0
9601,32,3,2020-12-28,0,0,0,0,2020-12-28,1609110000.0
9602,32,3,2020-12-29,0,0,0,0,2020-12-29,1609196400.0
9603,32,3,2020-12-30,0,0,0,0,2020-12-30,1609282800.0
9604,32,3,2020-12-31,0,0,0,0,2020-12-31,1609369200.0
9605,32,3,2021-01-01,0,0,0,0,2021-01-01,1609455600.0
9606,32,3,2021-01-02,0,0,0,0,2021-01-02,1609542000.0
9607,32,3,2021-01-03,0,0,0,0,2021-01-03,1609628400.0
9608,32,3,2021-01-04,0,0,0,0,2021-01-04,1609714800.0
9609,32,3,2021-01-05,0,0,0,0,2021-01-05,1609801200.0
9610,32,3,2021-01-06,0,0,0,0,2021-01-06,1609887600.0
9611,32,3,2021-01-07,0,0,0,0,2021-01-07,1609974000.0
9612,32,3,2021-01-08,0,0,0,0,2021-01-08,1610060400.0
9613,32,3,2021-01-09,0,0,0,0,2021-01-09,1610146800.0
9614,32,3,2021-01-10,0,0,0,0,2021-01-10,1610233200.0
9615,32,3,2021-01-11,0,0,0,0,2021-01-11,1610319600.0
9616,32,3,2021-01-12,0,0,0,0,2021-01-12,1610406000.0
9617,32,3,2021-01-13,0,0,0,0,2021-01-13,1610492400.0
9618,32,3,2021-01-14,0,0,0,0,2021-01-14,1610578800.0
9619,32,3,2021-01-15,0,0,0,0,2021-01-15,1610665200.0
9620,32,3,2021-01-16,0,0,0,0,2021-01-16,1610751600.0
9621,32,3,2021-01-17,0,0,0,0,2021-01-17,1610838000.0
9622,32,3,2021-01-18,0,0,0,0,2021-01-18,1610924400.0
9623,32,3,2021-01-19,0,0,0,0,2021-01-19,1611010800.0
9624,32,3,2021-01-20,0,0,0,0,2021-01-20,1611097200.0
9625,32,3,2021-01-21,0,0,0,0,2021-01-21,1611183600.0
9626,32,3,2021-01-22,0,0,0,0,2021-01-22,1611270000.0
9627,32,3,2021-01-23,0,0,0,0,2021-01-23,1611356400.0
9628,32,3,2021-01-24,0,0,0,0,2021-01-24,1611442800.0
9629,32,3,2021-01-25,0,0,0,0,2021-01-25,1611529200.0
9630,32,3,2021-01-26,0,0,0,0,2021-01-26,1611615600.0
9631,32,3,2021-01-27,0,0,0,0,2021-01-27,1611702000.0
9632,32,3,2021-01-28,0,0,0,0,2021-01-28,1611788400.0
9633,32,3,2021-01-29,0,0,0,0,2021-01-29,1611874800.0
9634,32,3,2021-01-30,0,0,0,0,2021-01-30,1611961200.0
9635,32,3,2021-01-31,0,0,0,0,2021-01-31,1612047600.0
9636,32,3,2021-02-01,0,0,0,0,2021-02-01,1612134000.0
9637,32,3,2021-02-02,0,0,0,0,2021-02-02,1612220400.0
9638,32,3,2021-02-03,0,0,0,0,2021-02-03,1612306800.0
9639,32,3,2021-02-04,0,0,0,0,2021-02-04,1612393200.0
9640,32,3,2021-02-05,0,0,0,0,2021-02-05,1612479600.0
9641,32,3,2021-02-06,52,0,52,0,2021-02-06,1612566000.0
9642,32,3,2021-02-07,356,0,408,0,2021-02-07,1612652400.0
9643,32,3,2021-02-08,158,0,566,0,2021-02-08,1612738800.0
9644,32,3,2021-02-09,282,0,848,0,2021-02-09,1612825200.0
9645,32,3,2021-02-10,606,0,1454,0,2021-02-10,1612911600.0
9646,32,3,2021-02-11,1191,0,2645,0,2021-02-11,1612998000.0
9647,32,3,2021-02-12,1551,0,4196,0,2021-02-12,1613084400.0
9648,32,3,2021-02-13,73,0,4269,0,2021-02-13,1613170800.0
9649,32,3,2021-02-14,0,0,4269,0,2021-02-14,1613257200.0
9650,32,3,2021-02-15,932,0,5201,0,2021-02-15,1613343600.0
9651,32,3,2021-02-16,922,0,6123,0,2021-02-16,1613430000.0
9652,32,3,2021-02-17,1034,0,7157,0,2021-02-17,1613516400.0
9653,32,3,2021-02-18,1647,0,8804,0,2021-02-18,1613602800.0
9654,32,3,2021-02-19,1376,0,10180,0,2021-02-19,1613689200.0
9655,32,3,2021-02-20,483,0,10663,0,2021-02-20,1613775600.0
9656,32,3,2021-02-21,231,0,10894,0,2021-02-21,1613862000.0
9657,32,3,2021-02-22,541,0,11435,0,2021-02-22,1613948400.0
9658,32,3,2021-02-23,1075,0,12510,0,2021-02-23,1614034800.0
9659,32,3,2021-02-24,1432,0,13942,0,2021-02-24,1614121200.0
9660,32,3,2021-02-25,5902,0,19844,0,2021-02-25,1614207600.0
9661,32,3,2021-02-26,6265,0,26109,0,2021-02-26,1614294000.0
9662,32,3,2021-02-27,5000,2,31109,2,2021-02-27,1614380400.0
9663,32,3,2021-02-28,274,0,31383,2,2021-02-28,1614466800.0
9664,32,3,2021-03-01,1350,0,32733,2,2021-03-01,1614553200.0
9665,32,3,2021-03-02,3324,0,36057,2,2021-03-02,1614639600.0
9666,32,3,2021-03-03,4441,2,40498,4,2021-03-03,1614726000.0
9667,32,3,2021-03-04,7759,3,48257,7,2021-03-04,1614812400.0
9668,32,3,2021-03-05,9421,1,57678,8,2021-03-05,1614898800.0
9669,32,3,2021-03-06,12764,5,70442,13,2021-03-06,1614985200.0
9670,32,3,2021-03-07,5280,5,75722,18,2021-03-07,1615071600.0
9671,32,3,2021-03-08,2646,1,78368,19,2021-03-08,1615158000.0
9672,32,3,2021-03-09,6592,0,84960,19,2021-03-09,1615244400.0
9673,32,3,2021-03-10,7278,5,92238,24,2021-03-10,1615330800.0
9674,32,3,2021-03-11,11360,7,103598,31,2021-03-11,1615417200.0
9675,32,3,2021-03-12,17307,4,120905,35,2021-03-12,1615503600.0
9676,32,3,2021-03-13,19103,2,140008,37,2021-03-13,1615590000.0
9677,32,3,2021-03-14,1776,1,141784,38,2021-03-14,1615676400.0
9678,32,3,2021-03-15,5519,3,147303,41,2021-03-15,1615762800.0
9679,32,3,2021-03-16,47,5,147350,46,2021-03-16,1615849200.0
9680,32,3,2021-03-17,42,1,147392,47,2021-03-17,1615935600.0
9681,32,3,2021-03-18,73,1,147465,48,2021-03-18,1616022000.0
9682,32,3,2021-03-19,7453,1,154918,49,2021-03-19,1616108400.0
9683,32,3,2021-03-20,9575,5,164493,54,2021-03-20,1616194800.0
9684,32,3,2021-03-21,685,0,165178,54,2021-03-21,1616281200.0
9685,32,3,2021-03-22,3184,3,168362,57,2021-03-22,1616367600.0
9686,32,3,2021-03-23,8729,4,177091,61,2021-03-23,1616454000.0
9687,32,3,2021-03-24,8277,7,185368,68,2021-03-24,1616540400.0
9688,32,3,2021-03-25,14135,7,199503,75,2021-03-25,1616626800.0
9689,32,3,2021-03-26,16051,28,215554,103,2021-03-26,1616713200.0
9690,32,3,2021-03-27,9677,13,225231,116,2021-03-27,1616799600.0
9691,32,3,2021-03-28,1560,2,226791,118,2021-03-28,1616886000.0
9692,32,3,2021-03-29,4314,10,231105,128,2021-03-29,1616972400.0
9693,32,3,2021-03-30,7646,3,238751,131,2021-03-30,1617058800.0
9694,32,3,2021-03-31,5240,14,243991,145,2021-03-31,1617145200.0
9695,32,3,2021-04-01,6827,13,250818,158,2021-04-01,1617231600.0
9696,32,3,2021-04-02,8996,4,259814,162,2021-04-02,1617318000.0
9697,32,3,2021-04-03,6871,20,266685,182,2021-04-03,1617404400.0
9698,32,3,2021-04-04,1377,1,268062,183,2021-04-04,1617490800.0
9699,32,3,2021-04-05,2166,2,270228,185,2021-04-05,1617577200.0
9700,32,3,2021-04-06,2920,3,273148,188,2021-04-06,1617663600.0
9701,32,3,2021-04-07,2987,4,276135,192,2021-04-07,1617750000.0
9702,32,3,2021-04-08,6595,32,282730,224,2021-04-08,1617836400.0
9703,32,3,2021-04-09,16541,24,299271,248,2021-04-09,1617922800.0
9704,32,3,2021-04-10,13976,66,313247,314,2021-04-10,1618009200.0
9705,32,3,2021-04-11,2682,1,315929,315,2021-04-11,1618095600.0
9706,32,3,2021-04-12,5376,19,321305,334,2021-04-12,1618185600.0
9707,32,3,2021-04-13,9073,6,330378,340,2021-04-13,1618272000.0
9708,32,3,2021-04-14,7262,10,337640,350,2021-04-14,1618358400.0
9709,32,3,2021-04-15,9487,35,347127,385,2021-04-15,1618444800.0
9710,32,3,2021-04-16,12485,47,359612,432,2021-04-16,1618531200.0
9711,32,3,2021-04-17,9527,47,369139,479,2021-04-17,1618617600.0
9712,32,3,2021-04-18,1681,3,370820,482,2021-04-18,1618704000.0
9713,32,3,2021-04-19,2536,27,373356,509,2021-04-19,1618790400.0
9714,32,3,2021-04-20,4176,9,377532,518,2021-04-20,1618876800.0
9715,32,3,2021-04-21,3733,23,381265,541,2021-04-21,1618963200.0
9716,32,3,2021-04-22,5598,65,386863,606,2021-04-22,1619049600.0
9717,32,3,2021-04-23,8153,115,395016,721,2021-04-23,1619136000.0
9718,32,3,2021-04-24,6140,121,401156,842,2021-04-24,1619222400.0
9719,32,3,2021-04-25,1475,35,402631,877,2021-04-25,1619308800.0
9720,32,3,2021-04-26,2103,72,404734,949,2021-04-26,1619395200.0
9721,32,3,2021-04-27,3033,212,407767,1161,2021-04-27,1619481600.0
9722,32,3,2021-04-28,2990,345,410757,1506,2021-04-28,1619568000.0
9723,32,3,2021-04-29,4267,925,415024,2431,2021-04-29,1619654400.0
9724,32,3,2021-04-30,5463,1178,420487,3609,2021-04-30,1619740800.0
9725,32,3,2021-05-01,1618,316,422105,3925,2021-05-01,1619827200.0
9726,32,3,2021-05-02,632,92,422737,4017,2021-05-02,1619913600.0
9727,32,3,2021-05-03,1275,393,424012,4410,2021-05-03,1620000000.0
9728,32,3,2021-05-04,1762,644,425774,5054,2021-05-04,1620086400.0
9729,32,3,2021-05-05,1539,1044,427313,6098,2021-05-05,1620172800.0
9730,32,3,2021-05-06,3112,2282,430425,8380,2021-05-06,1620259200.0
9731,32,3,2021-05-07,3843,2500,434268,10880,2021-05-07,1620345600.0
9732,32,3,2021-05-08,940,1472,435208,12352,2021-05-08,1620432000.0
9733,32,3,2021-05-09,206,862,435414,13214,2021-05-09,1620518400.0
9734,32,3,2021-05-10,1340,815,436754,14029,2021-05-10,1620604800.0
9735,32,3,2021-05-11,2187,2085,438941,16114,2021-05-11,1620691200.0
9736,32,3,2021-05-12,1559,2854,440500,18968,2021-05-12,1620777600.0
9737,32,3,2021-05-13,247,476,440747,19444,2021-05-13,1620864000.0
9738,32,3,2021-05-14,1637,2813,442384,22257,2021-05-14,1620950400.0
9739,32,3,2021-05-15,1261,3664,443645,25921,2021-05-15,1621036800.0
9740,32,3,2021-05-16,142,472,443787,26393,2021-05-16,1621123200.0
9741,32,3,2021-05-17,685,1637,444472,28030,2021-05-17,1621206000.0
9742,32,3,2021-05-18,1216,3079,445688,31109,2021-05-18,1621292400.0
9743,32,3,2021-05-19,903,3182,446591,34291,2021-05-19,1621378800.0
9744,32,3,2021-05-20,1343,5827,447934,40118,2021-05-20,1621465200.0
9745,32,3,2021-05-21,1252,7073,449186,47191,2021-05-21,1621551600.0
9746,32,3,2021-05-22,688,5116,449874,52307,2021-05-22,1621638000.0
9747,32,3,2021-05-23,57,373,449931,52680,2021-05-23,1621724400.0
9748,32,3,2021-05-24,84,493,450015,53173,2021-05-24,1621810800.0
9749,32,3,2021-05-25,437,3497,450452,56670,2021-05-25,1621897200.0
9750,32,3,2021-05-26,448,4878,450900,61548,2021-05-26,1621983600.0
9751,32,3,2021-05-27,627,7968,451527,69516,2021-05-27,1622070000.0
9752,32,3,2021-05-28,693,9573,452220,79089,2021-05-28,1622156400.0
9753,32,3,2021-05-29,453,7970,452673,87059,2021-05-29,1622242800.0
9754,32,3,2021-05-30,56,627,452729,87686,2021-05-30,1622329200.0
9755,32,3,2021-05-31,185,2864,452914,90550,2021-05-31,1622415600.0
9756,32,3,2021-06-01,282,6704,453196,97254,2021-06-01,1622502000.0
9757,32,3,2021-06-02,259,5631,453455,102885,2021-06-02,1622588400.0
9758,32,3,2021-06-03,265,8186,453720,111071,2021-06-03,1622674800.0
9759,32,3,2021-06-04,434,9828,454154,120899,2021-06-04,1622761200.0
9760,32,3,2021-06-05,257,7634,454411,128533,2021-06-05,1622847600.0
9761,32,3,2021-06-06,44,754,454455,129287,2021-06-06,1622934000.0
9762,32,3,2021-06-07,103,3280,454558,132567,2021-06-07,1623020400.0
9763,32,3,2021-06-08,158,4556,454716,137123,2021-06-08,1623106800.0
9764,32,3,2021-06-09,102,3985,454818,141108,2021-06-09,1623193200.0
9765,32,3,2021-06-10,184,6375,455002,147483,2021-06-10,1623279600.0
9766,32,3,2021-06-11,234,9936,455236,157419,2021-06-11,1623366000.0
9767,32,3,2021-06-12,156,6574,455392,163993,2021-06-12,1623452400.0
9768,32,3,2021-06-13,23,670,455415,164663,2021-06-13,1623538800.0
9769,32,3,2021-06-14,74,4552,455489,169215,2021-06-14,1623625200.0
9770,32,3,2021-06-15,82,7329,455571,176544,2021-06-15,1623711600.0
9771,32,3,2021-06-16,101,6390,455672,182934,2021-06-16,1623798000.0
9772,32,3,2021-06-17,133,9789,455805,192723,2021-06-17,1623884400.0
9773,32,3,2021-06-18,176,12308,455981,205031,2021-06-18,1623970800.0
9774,32,3,2021-06-19,106,6586,456087,211617,2021-06-19,1624057200.0
9775,32,3,2021-06-20,7,503,456094,212120,2021-06-20,1624143600.0
9776,32,3,2021-06-21,26,3832,456120,215952,2021-06-21,1624230000.0
9777,32,3,2021-06-22,97,6467,456217,222419,2021-06-22,1624316400.0
9778,32,3,2021-06-23,77,5021,456294,227440,2021-06-23,1624402800.0
9779,32,3,2021-06-24,118,7383,456412,234823,2021-06-24,1624489200.0
9780,32,3,2021-06-25,139,9684,456551,244507,2021-06-25,1624575600.0
9781,32,3,2021-06-26,64,6326,456615,250833,2021-06-26,1624662000.0
9782,32,3,2021-06-27,10,993,456625,251826,2021-06-27,1624748400.0
9783,32,3,2021-06-28,40,3653,456665,255479,2021-06-28,1624834800.0
9784,32,3,2021-06-29,63,5519,456728,260998,2021-06-29,1624921200.0
9785,32,3,2021-06-30,68,4652,456796,265650,2021-06-30,1625007600.0
9786,32,3,2021-07-01,91,6405,456887,272055,2021-07-01,1625094000.0
9787,32,3,2021-07-02,154,10398,457041,282453,2021-07-02,1625180400.0
9788,32,3,2021-07-03,98,6795,457139,289248,2021-07-03,1625266800.0
9789,32,3,2021-07-04,13,964,457152,290212,2021-07-04,1625353200.0
9790,32,3,2021-07-05,48,4246,457200,294458,2021-07-05,1625439600.0
9791,32,3,2021-07-06,96,5540,457296,299998,2021-07-06,1625526000.0
9792,32,4,2020-12-27,0,0,0,0,2020-12-27,1609023600.0
9793,32,4,2020-12-28,0,0,0,0,2020-12-28,1609110000.0
9794,32,4,2020-12-29,0,0,0,0,2020-12-29,1609196400.0
9795,32,4,2020-12-30,0,0,0,0,2020-12-30,1609282800.0
9796,32,4,2020-12-31,0,0,0,0,2020-12-31,1609369200.0
9797,32,4,2021-01-01,0,0,0,0,2021-01-01,1609455600.0
9798,32,4,2021-01-02,0,0,0,0,2021-01-02,1609542000.0
9799,32,4,2021-01-03,0,0,0,0,2021-01-03,1609628400.0
9800,32,4,2021-01-04,0,0,0,0,2021-01-04,1609714800.0
9801,32,4,2021-01-05,0,0,0,0,2021-01-05,1609801200.0
9802,32,4,2021-01-06,0,0,0,0,2021-01-06,1609887600.0
9803,32,4,2021-01-07,0,0,0,0,2021-01-07,1609974000.0
9804,32,4,2021-01-08,0,0,0,0,2021-01-08,1610060400.0
9805,32,4,2021-01-09,0,0,0,0,2021-01-09,1610146800.0
9806,32,4,2021-01-10,0,0,0,0,2021-01-10,1610233200.0
9807,32,4,2021-01-11,0,0,0,0,2021-01-11,1610319600.0
9808,32,4,2021-01-12,0,0,0,0,2021-01-12,1610406000.0
9809,32,4,2021-01-13,0,0,0,0,2021-01-13,1610492400.0
9810,32,4,2021-01-14,0,0,0,0,2021-01-14,1610578800.0
9811,32,4,2021-01-15,0,0,0,0,2021-01-15,1610665200.0
9812,32,4,2021-01-16,0,0,0,0,2021-01-16,1610751600.0
9813,32,4,2021-01-17,0,0,0,0,2021-01-17,1610838000.0
9814,32,4,2021-01-18,0,0,0,0,2021-01-18,1610924400.0
9815,32,4,2021-01-19,0,0,0,0,2021-01-19,1611010800.0
9816,32,4,2021-01-20,0,0,0,0,2021-01-20,1611097200.0
9817,32,4,2021-01-21,0,0,0,0,2021-01-21,1611183600.0
9818,32,4,2021-01-22,0,0,0,0,2021-01-22,1611270000.0
9819,32,4,2021-01-23,0,0,0,0,2021-01-23,1611356400.0
9820,32,4,2021-01-24,0,0,0,0,2021-01-24,1611442800.0
9821,32,4,2021-01-25,0,0,0,0,2021-01-25,1611529200.0
9822,32,4,2021-01-26,0,0,0,0,2021-01-26,1611615600.0
9823,32,4,2021-01-27,0,0,0,0,2021-01-27,1611702000.0
9824,32,4,2021-01-28,0,0,0,0,2021-01-28,1611788400.0
9825,32,4,2021-01-29,0,0,0,0,2021-01-29,1611874800.0
9826,32,4,2021-01-30,0,0,0,0,2021-01-30,1611961200.0
9827,32,4,2021-01-31,0,0,0,0,2021-01-31,1612047600.0
9828,32,4,2021-02-01,0,0,0,0,2021-02-01,1612134000.0
9829,32,4,2021-02-02,0,0,0,0,2021-02-02,1612220400.0
9830,32,4,2021-02-03,0,0,0,0,2021-02-03,1612306800.0
9831,32,4,2021-02-04,0,0,0,0,2021-02-04,1612393200.0
9832,32,4,2021-02-05,0,0,0,0,2021-02-05,1612479600.0
9833,32,4,2021-02-06,0,0,0,0,2021-02-06,1612566000.0
9834,32,4,2021-02-07,0,0,0,0,2021-02-07,1612652400.0
9835,32,4,2021-02-08,0,0,0,0,2021-02-08,1612738800.0
9836,32,4,2021-02-09,0,0,0,0,2021-02-09,1612825200.0
9837,32,4,2021-02-10,0,0,0,0,2021-02-10,1612911600.0
9838,32,4,2021-02-11,0,0,0,0,2021-02-11,1612998000.0
9839,32,4,2021-02-12,0,0,0,0,2021-02-12,1613084400.0
9840,32,4,2021-02-13,0,0,0,0,2021-02-13,1613170800.0
9841,32,4,2021-02-14,0,0,0,0,2021-02-14,1613257200.0
9842,32,4,2021-02-15,0,0,0,0,2021-02-15,1613343600.0
9843,32,4,2021-02-16,0,0,0,0,2021-02-16,1613430000.0
9844,32,4,2021-02-17,0,0,0,0,2021-02-17,1613516400.0
9845,32,4,2021-02-18,0,0,0,0,2021-02-18,1613602800.0
9846,32,4,2021-02-19,0,0,0,0,2021-02-19,1613689200.0
9847,32,4,2021-02-20,0,0,0,0,2021-02-20,1613775600.0
9848,32,4,2021-02-21,0,0,0,0,2021-02-21,1613862000.0
9849,32,4,2021-02-22,0,0,0,0,2021-02-22,1613948400.0
9850,32,4,2021-02-23,0,0,0,0,2021-02-23,1614034800.0
9851,32,4,2021-02-24,0,0,0,0,2021-02-24,1614121200.0
9852,32,4,2021-02-25,0,0,0,0,2021-02-25,1614207600.0
9853,32,4,2021-02-26,0,0,0,0,2021-02-26,1614294000.0
9854,32,4,2021-02-27,0,0,0,0,2021-02-27,1614380400.0
9855,32,4,2021-02-28,0,0,0,0,2021-02-28,1614466800.0
9856,32,4,2021-03-01,0,0,0,0,2021-03-01,1614553200.0
9857,32,4,2021-03-02,0,0,0,0,2021-03-02,1614639600.0
9858,32,4,2021-03-03,0,0,0,0,2021-03-03,1614726000.0
9859,32,4,2021-03-04,0,0,0,0,2021-03-04,1614812400.0
9860,32,4,2021-03-05,0,0,0,0,2021-03-05,1614898800.0
9861,32,4,2021-03-06,0,0,0,0,2021-03-06,1614985200.0
9862,32,4,2021-03-07,0,0,0,0,2021-03-07,1615071600.0
9863,32,4,2021-03-08,0,0,0,0,2021-03-08,1615158000.0
9864,32,4,2021-03-09,0,0,0,0,2021-03-09,1615244400.0
9865,32,4,2021-03-10,0,0,0,0,2021-03-10,1615330800.0
9866,32,4,2021-03-11,0,0,0,0,2021-03-11,1615417200.0
9867,32,4,2021-03-12,0,0,0,0,2021-03-12,1615503600.0
9868,32,4,2021-03-13,0,0,0,0,2021-03-13,1615590000.0
9869,32,4,2021-03-14,0,0,0,0,2021-03-14,1615676400.0
9870,32,4,2021-03-15,0,0,0,0,2021-03-15,1615762800.0
9871,32,4,2021-03-16,0,0,0,0,2021-03-16,1615849200.0
9872,32,4,2021-03-17,0,0,0,0,2021-03-17,1615935600.0
9873,32,4,2021-03-18,0,0,0,0,2021-03-18,1616022000.0
9874,32,4,2021-03-19,0,0,0,0,2021-03-19,1616108400.0
9875,32,4,2021-03-20,0,0,0,0,2021-03-20,1616194800.0
9876,32,4,2021-03-21,0,0,0,0,2021-03-21,1616281200.0
9877,32,4,2021-03-22,0,0,0,0,2021-03-22,1616367600.0
9878,32,4,2021-03-23,0,0,0,0,2021-03-23,1616454000.0
9879,32,4,2021-03-24,0,0,0,0,2021-03-24,1616540400.0
9880,32,4,2021-03-25,0,0,0,0,2021-03-25,1616626800.0
9881,32,4,2021-03-26,0,0,0,0,2021-03-26,1616713200.0
9882,32,4,2021-03-27,0,0,0,0,2021-03-27,1616799600.0
9883,32,4,2021-03-28,0,0,0,0,2021-03-28,1616886000.0
9884,32,4,2021-03-29,0,0,0,0,2021-03-29,1616972400.0
9885,32,4,2021-03-30,0,0,0,0,2021-03-30,1617058800.0
9886,32,4,2021-03-31,0,0,0,0,2021-03-31,1617145200.0
9887,32,4,2021-04-01,0,0,0,0,2021-04-01,1617231600.0
9888,32,4,2021-04-02,0,0,0,0,2021-04-02,1617318000.0
9889,32,4,2021-04-03,0,0,0,0,2021-04-03,1617404400.0
9890,32,4,2021-04-04,0,0,0,0,2021-04-04,1617490800.0
9891,32,4,2021-04-05,0,0,0,0,2021-04-05,1617577200.0
9892,32,4,2021-04-06,0,0,0,0,2021-04-06,1617663600.0
9893,32,4,2021-04-07,0,0,0,0,2021-04-07,1617750000.0
9894,32,4,2021-04-08,0,0,0,0,2021-04-08,1617836400.0
9895,32,4,2021-04-09,0,0,0,0,2021-04-09,1617922800.0
9896,32,4,2021-04-10,0,0,0,0,2021-04-10,1618009200.0
9897,32,4,2021-04-11,0,0,0,0,2021-04-11,1618095600.0
9898,32,4,2021-04-12,0,0,0,0,2021-04-12,1618185600.0
9899,32,4,2021-04-13,0,0,0,0,2021-04-13,1618272000.0
9900,32,4,2021-04-14,0,0,0,0,2021-04-14,1618358400.0
9901,32,4,2021-04-15,0,0,0,0,2021-04-15,1618444800.0
9902,32,4,2021-04-16,0,0,0,0,2021-04-16,1618531200.0
9903,32,4,2021-04-17,0,0,0,0,2021-04-17,1618617600.0
9904,32,4,2021-04-18,0,0,0,0,2021-04-18,1618704000.0
9905,32,4,2021-04-19,0,0,0,0,2021-04-19,1618790400.0
9906,32,4,2021-04-20,0,0,0,0,2021-04-20,1618876800.0
9907,32,4,2021-04-21,0,0,0,0,2021-04-21,1618963200.0
9908,32,4,2021-04-22,0,0,0,0,2021-04-22,1619049600.0
9909,32,4,2021-04-23,74,0,74,0,2021-04-23,1619136000.0
9910,32,4,2021-04-24,252,0,326,0,2021-04-24,1619222400.0
9911,32,4,2021-04-25,11,0,337,0,2021-04-25,1619308800.0
9912,32,4,2021-04-26,363,0,700,0,2021-04-26,1619395200.0
9913,32,4,2021-04-27,1179,1,1879,1,2021-04-27,1619481600.0
9914,32,4,2021-04-28,1254,1,3133,2,2021-04-28,1619568000.0
9915,32,4,2021-04-29,1608,0,4741,2,2021-04-29,1619654400.0
9916,32,4,2021-04-30,2098,0,6839,2,2021-04-30,1619740800.0
9917,32,4,2021-05-01,431,0,7270,2,2021-05-01,1619827200.0
9918,32,4,2021-05-02,78,0,7348,2,2021-05-02,1619913600.0
9919,32,4,2021-05-03,421,0,7769,2,2021-05-03,1620000000.0
9920,32,4,2021-05-04,802,0,8571,2,2021-05-04,1620086400.0
9921,32,4,2021-05-05,488,0,9059,2,2021-05-05,1620172800.0
9922,32,4,2021-05-06,1054,1,10113,3,2021-05-06,1620259200.0
9923,32,4,2021-05-07,2094,0,12207,3,2021-05-07,1620345600.0
9924,32,4,2021-05-08,312,0,12519,3,2021-05-08,1620432000.0
9925,32,4,2021-05-09,51,0,12570,3,2021-05-09,1620518400.0
9926,32,4,2021-05-10,827,0,13397,3,2021-05-10,1620604800.0
9927,32,4,2021-05-11,1304,0,14701,3,2021-05-11,1620691200.0
9928,32,4,2021-05-12,1148,0,15849,3,2021-05-12,1620777600.0
9929,32,4,2021-05-13,93,0,15942,3,2021-05-13,1620864000.0
9930,32,4,2021-05-14,856,0,16798,3,2021-05-14,1620950400.0
9931,32,4,2021-05-15,662,0,17460,3,2021-05-15,1621036800.0
9932,32,4,2021-05-16,66,0,17526,3,2021-05-16,1621123200.0
9933,32,4,2021-05-17,364,0,17890,3,2021-05-17,1621206000.0
9934,32,4,2021-05-18,829,0,18719,3,2021-05-18,1621292400.0
9935,32,4,2021-05-19,579,0,19298,3,2021-05-19,1621378800.0
9936,32,4,2021-05-20,848,1,20146,4,2021-05-20,1621465200.0
9937,32,4,2021-05-21,1363,3,21509,7,2021-05-21,1621551600.0
9938,32,4,2021-05-22,737,1,22246,8,2021-05-22,1621638000.0
9939,32,4,2021-05-23,85,0,22331,8,2021-05-23,1621724400.0
9940,32,4,2021-05-24,100,0,22431,8,2021-05-24,1621810800.0
9941,32,4,2021-05-25,689,2,23120,10,2021-05-25,1621897200.0
9942,32,4,2021-05-26,565,1,23685,11,2021-05-26,1621983600.0
9943,32,4,2021-05-27,1270,5,24955,16,2021-05-27,1622070000.0
9944,32,4,2021-05-28,2637,3,27592,19,2021-05-28,1622156400.0
9945,32,4,2021-05-29,1432,2,29024,21,2021-05-29,1622242800.0
9946,32,4,2021-05-30,122,0,29146,21,2021-05-30,1622329200.0
9947,32,4,2021-05-31,1248,0,30394,21,2021-05-31,1622415600.0
9948,32,4,2021-06-01,1720,1,32114,22,2021-06-01,1622502000.0
9949,32,4,2021-06-02,1344,1,33458,23,2021-06-02,1622588400.0
9950,32,4,2021-06-03,1651,2,35109,25,2021-06-03,1622674800.0
9951,32,4,2021-06-04,2033,1,37142,26,2021-06-04,1622761200.0
9952,32,4,2021-06-05,1168,2,38310,28,2021-06-05,1622847600.0
9953,32,4,2021-06-06,78,0,38388,28,2021-06-06,1622934000.0
9954,32,4,2021-06-07,658,0,39046,28,2021-06-07,1623020400.0
9955,32,4,2021-06-08,1265,1,40311,29,2021-06-08,1623106800.0
9956,32,4,2021-06-09,1125,1,41436,30,2021-06-09,1623193200.0
9957,32,4,2021-06-10,1358,4,42794,34,2021-06-10,1623279600.0
9958,32,4,2021-06-11,1611,5,44405,39,2021-06-11,1623366000.0
9959,32,4,2021-06-12,836,0,45241,39,2021-06-12,1623452400.0
9960,32,4,2021-06-13,132,0,45373,39,2021-06-13,1623538800.0
9961,32,4,2021-06-14,531,2,45904,41,2021-06-14,1623625200.0
9962,32,4,2021-06-15,823,2,46727,43,2021-06-15,1623711600.0
9963,32,4,2021-06-16,657,1,47384,44,2021-06-16,1623798000.0
9964,32,4,2021-06-17,782,2,48166,46,2021-06-17,1623884400.0
9965,32,4,2021-06-18,1101,4,49267,50,2021-06-18,1623970800.0
9966,32,4,2021-06-19,711,6,49978,56,2021-06-19,1624057200.0
9967,32,4,2021-06-20,48,0,50026,56,2021-06-20,1624143600.0
9968,32,4,2021-06-21,356,0,50382,56,2021-06-21,1624230000.0
9969,32,4,2021-06-22,647,0,51029,56,2021-06-22,1624316400.0
9970,32,4,2021-06-23,564,1,51593,57,2021-06-23,1624402800.0
9971,32,4,2021-06-24,798,2,52391,59,2021-06-24,1624489200.0
9972,32,4,2021-06-25,814,1,53205,60,2021-06-25,1624575600.0
9973,32,4,2021-06-26,574,3,53779,63,2021-06-26,1624662000.0
9974,32,4,2021-06-27,94,0,53873,63,2021-06-27,1624748400.0
9975,32,4,2021-06-28,366,0,54239,63,2021-06-28,1624834800.0
9976,32,4,2021-06-29,521,2,54760,65,2021-06-29,1624921200.0
9977,32,4,2021-06-30,592,1,55352,66,2021-06-30,1625007600.0
9978,32,4,2021-07-01,611,1,55963,67,2021-07-01,1625094000.0
9979,32,4,2021-07-02,799,2,56762,69,2021-07-02,1625180400.0
9980,32,4,2021-07-03,531,0,57293,69,2021-07-03,1625266800.0
9981,32,4,2021-07-04,69,2,57362,71,2021-07-04,1625353200.0
9982,32,4,2021-07-05,324,2,57686,73,2021-07-05,1625439600.0
9983,32,4,2021-07-06,560,0,58246,73,2021-07-06,1625526000.0
9984,44,1,2020-12-27,0,0,0,0,2020-12-27,1609023600.0
9985,44,1,2020-12-28,0,0,0,0,2020-12-28,1609110000.0
9986,44,1,2020-12-29,0,0,0,0,2020-12-29,1609196400.0
9987,44,1,2020-12-30,1,0,1,0,2020-12-30,1609282800.0
9988,44,1,2020-12-31,11,0,12,0,2020-12-31,1609369200.0
9989,44,1,2021-01-01,2,0,14,0,2021-01-01,1609455600.0
9990,44,1,2021-01-02,3,0,17,0,2021-01-02,1609542000.0
9991,44,1,2021-01-03,3,0,20,0,2021-01-03,1609628400.0
9992,44,1,2021-01-04,243,0,263,0,2021-01-04,1609714800.0
9993,44,1,2021-01-05,773,0,1036,0,2021-01-05,1609801200.0
9994,44,1,2021-01-06,1246,0,2282,0,2021-01-06,1609887600.0
9995,44,1,2021-01-07,2426,0,4708,0,2021-01-07,1609974000.0
9996,44,1,2021-01-08,3135,0,7843,0,2021-01-08,1610060400.0
9997,44,1,2021-01-09,945,0,8788,0,2021-01-09,1610146800.0
9998,44,1,2021-01-10,241,0,9029,0,2021-01-10,1610233200.0
9999,44,1,2021-01-11,2990,0,12019,0,2021-01-11,1610319600.0
10000,44,1,2021-01-12,5279,0,17298,0,2021-01-12,1610406000.0
10001,44,1,2021-01-13,7668,0,24966,0,2021-01-13,1610492400.0
10002,44,1,2021-01-14,9453,0,34419,0,2021-01-14,1610578800.0
10003,44,1,2021-01-15,6545,0,40964,0,2021-01-15,1610665200.0
10004,44,1,2021-01-16,1771,7,42735,7,2021-01-16,1610751600.0
10005,44,1,2021-01-17,901,1,43636,8,2021-01-17,1610838000.0
10006,44,1,2021-01-18,7772,4,51408,12,2021-01-18,1610924400.0
10007,44,1,2021-01-19,9401,2,60809,14,2021-01-19,1611010800.0
10008,44,1,2021-01-20,9615,8,70424,22,2021-01-20,1611097200.0
10009,44,1,2021-01-21,10227,2,80651,24,2021-01-21,1611183600.0
10010,44,1,2021-01-22,8078,6,88729,30,2021-01-22,1611270000.0
10011,44,1,2021-01-23,2866,15,91595,45,2021-01-23,1611356400.0
10012,44,1,2021-01-24,1515,1,93110,46,2021-01-24,1611442800.0
10013,44,1,2021-01-25,5168,286,98278,332,2021-01-25,1611529200.0
10014,44,1,2021-01-26,4345,415,102623,747,2021-01-26,1611615600.0
10015,44,1,2021-01-27,6005,575,108628,1322,2021-01-27,1611702000.0
10016,44,1,2021-01-28,7247,1221,115875,2543,2021-01-28,1611788400.0
10017,44,1,2021-01-29,5338,1780,121213,4323,2021-01-29,1611874800.0
10018,44,1,2021-01-30,2039,489,123252,4812,2021-01-30,1611961200.0
10019,44,1,2021-01-31,1252,53,124504,4865,2021-01-31,1612047600.0
10020,44,1,2021-02-01,5011,2361,129515,7226,2021-02-01,1612134000.0
10021,44,1,2021-02-02,4791,3789,134306,11015,2021-02-02,1612220400.0
10022,44,1,2021-02-03,4041,4527,138347,15542,2021-02-03,1612306800.0
10023,44,1,2021-02-04,5538,6936,143885,22478,2021-02-04,1612393200.0
10024,44,1,2021-02-05,5559,5210,149444,27688,2021-02-05,1612479600.0
10025,44,1,2021-02-06,1521,1204,150965,28892,2021-02-06,1612566000.0
10026,44,1,2021-02-07,406,591,151371,29483,2021-02-07,1612652400.0
10027,44,1,2021-02-08,3155,4435,154526,33918,2021-02-08,1612738800.0
10028,44,1,2021-02-09,4574,5769,159100,39687,2021-02-09,1612825200.0
10029,44,1,2021-02-10,4826,5955,163926,45642,2021-02-10,1612911600.0
10030,44,1,2021-02-11,5455,6408,169381,52050,2021-02-11,1612998000.0
10031,44,1,2021-02-12,5279,5285,174660,57335,2021-02-12,1613084400.0
10032,44,1,2021-02-13,2214,1108,176874,58443,2021-02-13,1613170800.0
10033,44,1,2021-02-14,1607,815,178481,59258,2021-02-14,1613257200.0
10034,44,1,2021-02-15,2680,6062,181161,65320,2021-02-15,1613343600.0
10035,44,1,2021-02-16,3098,6771,184259,72091,2021-02-16,1613430000.0
10036,44,1,2021-02-17,3237,7121,187496,79212,2021-02-17,1613516400.0
10037,44,1,2021-02-18,4263,7730,191759,86942,2021-02-18,1613602800.0
10038,44,1,2021-02-19,3818,6005,195577,92947,2021-02-19,1613689200.0
10039,44,1,2021-02-20,1881,2403,197458,95350,2021-02-20,1613775600.0
10040,44,1,2021-02-21,530,1301,197988,96651,2021-02-21,1613862000.0
10041,44,1,2021-02-22,3391,5444,201379,102095,2021-02-22,1613948400.0
10042,44,1,2021-02-23,4951,5759,206330,107854,2021-02-23,1614034800.0
10043,44,1,2021-02-24,4646,4438,210976,112292,2021-02-24,1614121200.0
10044,44,1,2021-02-25,5476,5752,216452,118044,2021-02-25,1614207600.0
10045,44,1,2021-02-26,4679,4717,221131,122761,2021-02-26,1614294000.0
10046,44,1,2021-02-27,3623,1581,224754,124342,2021-02-27,1614380400.0
10047,44,1,2021-02-28,1966,471,226720,124813,2021-02-28,1614466800.0
10048,44,1,2021-03-01,4344,3247,231064,128060,2021-03-01,1614553200.0
10049,44,1,2021-03-02,6429,4043,237493,132103,2021-03-02,1614639600.0
10050,44,1,2021-03-03,6543,3842,244036,135945,2021-03-03,1614726000.0
10051,44,1,2021-03-04,6654,4803,250690,140748,2021-03-04,1614812400.0
10052,44,1,2021-03-05,7227,4429,257917,145177,2021-03-05,1614898800.0
10053,44,1,2021-03-06,7914,1415,265831,146592,2021-03-06,1614985200.0
10054,44,1,2021-03-07,5352,544,271183,147136,2021-03-07,1615071600.0
10055,44,1,2021-03-08,5750,3709,276933,150845,2021-03-08,1615158000.0
10056,44,1,2021-03-09,8054,4428,284987,155273,2021-03-09,1615244400.0
10057,44,1,2021-03-10,8639,4690,293626,159963,2021-03-10,1615330800.0
10058,44,1,2021-03-11,10059,5155,303685,165118,2021-03-11,1615417200.0
10059,44,1,2021-03-12,9560,4791,313245,169909,2021-03-12,1615503600.0
10060,44,1,2021-03-13,5286,1931,318531,171840,2021-03-13,1615590000.0
10061,44,1,2021-03-14,2290,734,320821,172574,2021-03-14,1615676400.0
10062,44,1,2021-03-15,8416,3067,329237,175641,2021-03-15,1615762800.0
10063,44,1,2021-03-16,11182,3571,340419,179212,2021-03-16,1615849200.0
10064,44,1,2021-03-17,12665,3189,353084,182401,2021-03-17,1615935600.0
10065,44,1,2021-03-18,13233,3274,366317,185675,2021-03-18,1616022000.0
10066,44,1,2021-03-19,12516,3024,378833,188699,2021-03-19,1616108400.0
10067,44,1,2021-03-20,6220,1447,385053,190146,2021-03-20,1616194800.0
10068,44,1,2021-03-21,723,216,385776,190362,2021-03-21,1616281200.0
10069,44,1,2021-03-22,8711,3372,394487,193734,2021-03-22,1616367600.0
10070,44,1,2021-03-23,11730,4455,406217,198189,2021-03-23,1616454000.0
10071,44,1,2021-03-24,12222,4317,418439,202506,2021-03-24,1616540400.0
10072,44,1,2021-03-25,13173,4864,431612,207370,2021-03-25,1616626800.0
10073,44,1,2021-03-26,13627,4226,445239,211596,2021-03-26,1616713200.0
10074,44,1,2021-03-27,7120,4029,452359,215625,2021-03-27,1616799600.0
10075,44,1,2021-03-28,2900,1891,455259,217516,2021-03-28,1616886000.0
10076,44,1,2021-03-29,8919,5497,464178,223013,2021-03-29,1616972400.0
10077,44,1,2021-03-30,11787,6993,475965,230006,2021-03-30,1617058800.0
10078,44,1,2021-03-31,11984,7091,487949,237097,2021-03-31,1617145200.0
10079,44,1,2021-04-01,13725,8184,501674,245281,2021-04-01,1617231600.0
10080,44,1,2021-04-02,8728,5988,510402,251269,2021-04-02,1617318000.0
10081,44,1,2021-04-03,5725,5305,516127,256574,2021-04-03,1617404400.0
10082,44,1,2021-04-04,2548,1408,518675,257982,2021-04-04,1617490800.0
10083,44,1,2021-04-05,3535,1092,522210,259074,2021-04-05,1617577200.0
10084,44,1,2021-04-06,9763,9192,531973,268266,2021-04-06,1617663600.0
10085,44,1,2021-04-07,12299,10216,544272,278482,2021-04-07,1617750000.0
10086,44,1,2021-04-08,15822,9786,560094,288268,2021-04-08,1617836400.0
10087,44,1,2021-04-09,15697,10067,575791,298335,2021-04-09,1617922800.0
10088,44,1,2021-04-10,9295,5454,585086,303789,2021-04-10,1618009200.0
10089,44,1,2021-04-11,1937,2962,587023,306751,2021-04-11,1618095600.0
10090,44,1,2021-04-12,11842,9135,598865,315886,2021-04-12,1618185600.0
10091,44,1,2021-04-13,15083,11215,613948,327101,2021-04-13,1618272000.0
10092,44,1,2021-04-14,16589,11579,630537,338680,2021-04-14,1618358400.0
10093,44,1,2021-04-15,17951,11721,648488,350401,2021-04-15,1618444800.0
10094,44,1,2021-04-16,17119,11586,665607,361987,2021-04-16,1618531200.0
10095,44,1,2021-04-17,13651,5825,679258,367812,2021-04-17,1618617600.0
10096,44,1,2021-04-18,2234,1164,681492,368976,2021-04-18,1618704000.0
10097,44,1,2021-04-19,13968,9583,695460,378559,2021-04-19,1618790400.0
10098,44,1,2021-04-20,14649,11615,710109,390174,2021-04-20,1618876800.0
10099,44,1,2021-04-21,16844,12402,726953,402576,2021-04-21,1618963200.0
10100,44,1,2021-04-22,17610,13057,744563,415633,2021-04-22,1619049600.0
10101,44,1,2021-04-23,18739,13126,763302,428759,2021-04-23,1619136000.0
10102,44,1,2021-04-24,11461,7043,774763,435802,2021-04-24,1619222400.0
10103,44,1,2021-04-25,4120,2535,778883,438337,2021-04-25,1619308800.0
10104,44,1,2021-04-26,13482,9986,792365,448323,2021-04-26,1619395200.0
10105,44,1,2021-04-27,16414,11061,808779,459384,2021-04-27,1619481600.0
10106,44,1,2021-04-28,19086,10616,827865,470000,2021-04-28,1619568000.0
10107,44,1,2021-04-29,21116,10614,848981,480614,2021-04-29,1619654400.0
10108,44,1,2021-04-30,23809,9215,872790,489829,2021-04-30,1619740800.0
10109,44,1,2021-05-01,13195,3989,885985,493818,2021-05-01,1619827200.0
10110,44,1,2021-05-02,7477,2651,893462,496469,2021-05-02,1619913600.0
10111,44,1,2021-05-03,20667,9170,914129,505639,2021-05-03,1620000000.0
10112,44,1,2021-05-04,22562,12554,936691,518193,2021-05-04,1620086400.0
10113,44,1,2021-05-05,27115,13079,963806,531272,2021-05-05,1620172800.0
10114,44,1,2021-05-06,30095,12582,993901,543854,2021-05-06,1620259200.0
10115,44,1,2021-05-07,28415,15028,1022316,558882,2021-05-07,1620345600.0
10116,44,1,2021-05-08,17324,3301,1039640,562183,2021-05-08,1620432000.0
10117,44,1,2021-05-09,10555,1482,1050195,563665,2021-05-09,1620518400.0
10118,44,1,2021-05-10,20098,16618,1070293,580283,2021-05-10,1620604800.0
10119,44,1,2021-05-11,27195,16797,1097488,597080,2021-05-11,1620691200.0
10120,44,1,2021-05-12,30043,16836,1127531,613916,2021-05-12,1620777600.0
10121,44,1,2021-05-13,22021,3616,1149552,617532,2021-05-13,1620864000.0
10122,44,1,2021-05-14,32473,11155,1182025,628687,2021-05-14,1620950400.0
10123,44,1,2021-05-15,25537,7932,1207562,636619,2021-05-15,1621036800.0
10124,44,1,2021-05-16,12385,767,1219947,637386,2021-05-16,1621123200.0
10125,44,1,2021-05-17,22015,9927,1241962,647313,2021-05-17,1621206000.0
10126,44,1,2021-05-18,27819,9221,1269781,656534,2021-05-18,1621292400.0
10127,44,1,2021-05-19,30875,9294,1300656,665828,2021-05-19,1621378800.0
10128,44,1,2021-05-20,33570,7265,1334226,673093,2021-05-20,1621465200.0
10129,44,1,2021-05-21,34714,8950,1368940,682043,2021-05-21,1621551600.0
10130,44,1,2021-05-22,23393,4586,1392333,686629,2021-05-22,1621638000.0
10131,44,1,2021-05-23,7644,869,1399977,687498,2021-05-23,1621724400.0
10132,44,1,2021-05-24,17051,2628,1417028,690126,2021-05-24,1621810800.0
10133,44,1,2021-05-25,27419,10875,1444447,701001,2021-05-25,1621897200.0
10134,44,1,2021-05-26,30209,11024,1474656,712025,2021-05-26,1621983600.0
10135,44,1,2021-05-27,30731,9861,1505387,721886,2021-05-27,1622070000.0
10136,44,1,2021-05-28,30307,12176,1535694,734062,2021-05-28,1622156400.0
10137,44,1,2021-05-29,21143,8626,1556837,742688,2021-05-29,1622242800.0
10138,44,1,2021-05-30,5646,1765,1562483,744453,2021-05-30,1622329200.0
10139,44,1,2021-05-31,22014,11834,1584497,756287,2021-05-31,1622415600.0
10140,44,1,2021-06-01,25121,12691,1609618,768978,2021-06-01,1622502000.0
10141,44,1,2021-06-02,28627,12103,1638245,781081,2021-06-02,1622588400.0
10142,44,1,2021-06-03,27945,11856,1666190,792937,2021-06-03,1622674800.0
10143,44,1,2021-06-04,31714,15930,1697904,808867,2021-06-04,1622761200.0
10144,44,1,2021-06-05,17706,9232,1715610,818099,2021-06-05,1622847600.0
10145,44,1,2021-06-06,7684,3043,1723294,821142,2021-06-06,1622934000.0
10146,44,1,2021-06-07,25008,15322,1748302,836464,2021-06-07,1623020400.0
10147,44,1,2021-06-08,27920,16893,1776222,853357,2021-06-08,1623106800.0
10148,44,1,2021-06-09,31536,15546,1807758,868903,2021-06-09,1623193200.0
10149,44,1,2021-06-10,29438,14253,1837196,883156,2021-06-10,1623279600.0
10150,44,1,2021-06-11,25524,20378,1862720,903534,2021-06-11,1623366000.0
10151,44,1,2021-06-12,21157,13997,1883877,917531,2021-06-12,1623452400.0
10152,44,1,2021-06-13,6484,4908,1890361,922439,2021-06-13,1623538800.0
10153,44,1,2021-06-14,14703,22164,1905064,944603,2021-06-14,1623625200.0
10154,44,1,2021-06-15,19733,23609,1924797,968212,2021-06-15,1623711600.0
10155,44,1,2021-06-16,20912,26232,1945709,994444,2021-06-16,1623798000.0
10156,44,1,2021-06-17,19542,23511,1965251,1017955,2021-06-17,1623884400.0
10157,44,1,2021-06-18,20634,27266,1985885,1045221,2021-06-18,1623970800.0
10158,44,1,2021-06-19,17387,19776,2003272,1064997,2021-06-19,1624057200.0
10159,44,1,2021-06-20,3347,5248,2006619,1070245,2021-06-20,1624143600.0
10160,44,1,2021-06-21,12708,26335,2019327,1096580,2021-06-21,1624230000.0
10161,44,1,2021-06-22,12401,28005,2031728,1124585,2021-06-22,1624316400.0
10162,44,1,2021-06-23,17269,30027,2048997,1154612,2021-06-23,1624402800.0
10163,44,1,2021-06-24,13393,20098,2062390,1174710,2021-06-24,1624489200.0
10164,44,1,2021-06-25,14446,31671,2076836,1206381,2021-06-25,1624575600.0
10165,44,1,2021-06-26,11429,25638,2088265,1232019,2021-06-26,1624662000.0
10166,44,1,2021-06-27,3126,8316,2091391,1240335,2021-06-27,1624748400.0
10167,44,1,2021-06-28,9861,28814,2101252,1269149,2021-06-28,1624834800.0
10168,44,1,2021-06-29,9964,29942,2111216,1299091,2021-06-29,1624921200.0
10169,44,1,2021-06-30,12844,32916,2124060,1332007,2021-06-30,1625007600.0
10170,44,1,2021-07-01,13084,25807,2137144,1357814,2021-07-01,1625094000.0
10171,44,1,2021-07-02,13256,34451,2150400,1392265,2021-07-02,1625180400.0
10172,44,1,2021-07-03,11321,22305,2161721,1414570,2021-07-03,1625266800.0
10173,44,1,2021-07-04,2893,6946,2164614,1421516,2021-07-04,1625353200.0
10174,44,1,2021-07-05,9069,29921,2173683,1451437,2021-07-05,1625439600.0
10175,44,1,2021-07-06,11481,29742,2185164,1481179,2021-07-06,1625526000.0
10176,44,2,2020-12-27,0,0,0,0,2020-12-27,1609023600.0
10177,44,2,2020-12-28,0,0,0,0,2020-12-28,1609110000.0
10178,44,2,2020-12-29,0,0,0,0,2020-12-29,1609196400.0
10179,44,2,2020-12-30,0,0,0,0,2020-12-30,1609282800.0
10180,44,2,2020-12-31,0,0,0,0,2020-12-31,1609369200.0
10181,44,2,2021-01-01,0,0,0,0,2021-01-01,1609455600.0
10182,44,2,2021-01-02,0,0,0,0,2021-01-02,1609542000.0
10183,44,2,2021-01-03,0,0,0,0,2021-01-03,1609628400.0
10184,44,2,2021-01-04,0,0,0,0,2021-01-04,1609714800.0
10185,44,2,2021-01-05,0,0,0,0,2021-01-05,1609801200.0
10186,44,2,2021-01-06,0,0,0,0,2021-01-06,1609887600.0
10187,44,2,2021-01-07,0,0,0,0,2021-01-07,1609974000.0
10188,44,2,2021-01-08,0,0,0,0,2021-01-08,1610060400.0
10189,44,2,2021-01-09,0,0,0,0,2021-01-09,1610146800.0
10190,44,2,2021-01-10,0,0,0,0,2021-01-10,1610233200.0
10191,44,2,2021-01-11,0,0,0,0,2021-01-11,1610319600.0
10192,44,2,2021-01-12,0,0,0,0,2021-01-12,1610406000.0
10193,44,2,2021-01-13,0,0,0,0,2021-01-13,1610492400.0
10194,44,2,2021-01-14,103,0,103,0,2021-01-14,1610578800.0
10195,44,2,2021-01-15,164,0,267,0,2021-01-15,1610665200.0
10196,44,2,2021-01-16,147,0,414,0,2021-01-16,1610751600.0
10197,44,2,2021-01-17,1,0,415,0,2021-01-17,1610838000.0
10198,44,2,2021-01-18,950,0,1365,0,2021-01-18,1610924400.0
10199,44,2,2021-01-19,1269,0,2634,0,2021-01-19,1611010800.0
10200,44,2,2021-01-20,1415,0,4049,0,2021-01-20,1611097200.0
10201,44,2,2021-01-21,1507,0,5556,0,2021-01-21,1611183600.0
10202,44,2,2021-01-22,1558,0,7114,0,2021-01-22,1611270000.0
10203,44,2,2021-01-23,421,0,7535,0,2021-01-23,1611356400.0
10204,44,2,2021-01-24,54,0,7589,0,2021-01-24,1611442800.0
10205,44,2,2021-01-25,1515,0,9104,0,2021-01-25,1611529200.0
10206,44,2,2021-01-26,1299,0,10403,0,2021-01-26,1611615600.0
10207,44,2,2021-01-27,1375,0,11778,0,2021-01-27,1611702000.0
10208,44,2,2021-01-28,1584,0,13362,0,2021-01-28,1611788400.0
10209,44,2,2021-01-29,1422,0,14784,0,2021-01-29,1611874800.0
10210,44,2,2021-01-30,510,0,15294,0,2021-01-30,1611961200.0
10211,44,2,2021-01-31,0,0,15294,0,2021-01-31,1612047600.0
10212,44,2,2021-02-01,1375,0,16669,0,2021-02-01,1612134000.0
10213,44,2,2021-02-02,1423,0,18092,0,2021-02-02,1612220400.0
10214,44,2,2021-02-03,1561,0,19653,0,2021-02-03,1612306800.0
10215,44,2,2021-02-04,917,1,20570,1,2021-02-04,1612393200.0
10216,44,2,2021-02-05,833,0,21403,1,2021-02-05,1612479600.0
10217,44,2,2021-02-06,437,0,21840,1,2021-02-06,1612566000.0
10218,44,2,2021-02-07,0,0,21840,1,2021-02-07,1612652400.0
10219,44,2,2021-02-08,370,0,22210,1,2021-02-08,1612738800.0
10220,44,2,2021-02-09,218,0,22428,1,2021-02-09,1612825200.0
10221,44,2,2021-02-10,216,0,22644,1,2021-02-10,1612911600.0
10222,44,2,2021-02-11,140,46,22784,47,2021-02-11,1612998000.0
10223,44,2,2021-02-12,315,170,23099,217,2021-02-12,1613084400.0
10224,44,2,2021-02-13,62,131,23161,348,2021-02-13,1613170800.0
10225,44,2,2021-02-14,1,0,23162,348,2021-02-14,1613257200.0
10226,44,2,2021-02-15,131,1082,23293,1430,2021-02-15,1613343600.0
10227,44,2,2021-02-16,186,1136,23479,2566,2021-02-16,1613430000.0
10228,44,2,2021-02-17,169,1333,23648,3899,2021-02-17,1613516400.0
10229,44,2,2021-02-18,156,1431,23804,5330,2021-02-18,1613602800.0
10230,44,2,2021-02-19,384,1401,24188,6731,2021-02-19,1613689200.0
10231,44,2,2021-02-20,239,412,24427,7143,2021-02-20,1613775600.0
10232,44,2,2021-02-21,9,86,24436,7229,2021-02-21,1613862000.0
10233,44,2,2021-02-22,263,1523,24699,8752,2021-02-22,1613948400.0
10234,44,2,2021-02-23,121,1396,24820,10148,2021-02-23,1614034800.0
10235,44,2,2021-02-24,321,1361,25141,11509,2021-02-24,1614121200.0
10236,44,2,2021-02-25,200,1576,25341,13085,2021-02-25,1614207600.0
10237,44,2,2021-02-26,427,1376,25768,14461,2021-02-26,1614294000.0
10238,44,2,2021-02-27,181,479,25949,14940,2021-02-27,1614380400.0
10239,44,2,2021-02-28,0,27,25949,14967,2021-02-28,1614466800.0
10240,44,2,2021-03-01,178,1332,26127,16299,2021-03-01,1614553200.0
10241,44,2,2021-03-02,139,1496,26266,17795,2021-03-02,1614639600.0
10242,44,2,2021-03-03,199,1541,26465,19336,2021-03-03,1614726000.0
10243,44,2,2021-03-04,79,727,26544,20063,2021-03-04,1614812400.0
10244,44,2,2021-03-05,395,900,26939,20963,2021-03-05,1614898800.0
10245,44,2,2021-03-06,758,379,27697,21342,2021-03-06,1614985200.0
10246,44,2,2021-03-07,1143,3,28840,21345,2021-03-07,1615071600.0
10247,44,2,2021-03-08,362,361,29202,21706,2021-03-08,1615158000.0
10248,44,2,2021-03-09,948,236,30150,21942,2021-03-09,1615244400.0
10249,44,2,2021-03-10,1027,225,31177,22167,2021-03-10,1615330800.0
10250,44,2,2021-03-11,859,114,32036,22281,2021-03-11,1615417200.0
10251,44,2,2021-03-12,1063,214,33099,22495,2021-03-12,1615503600.0
10252,44,2,2021-03-13,4686,80,37785,22575,2021-03-13,1615590000.0
10253,44,2,2021-03-14,3019,7,40804,22582,2021-03-14,1615676400.0
10254,44,2,2021-03-15,981,138,41785,22720,2021-03-15,1615762800.0
10255,44,2,2021-03-16,1545,141,43330,22861,2021-03-16,1615849200.0
10256,44,2,2021-03-17,1482,135,44812,22996,2021-03-17,1615935600.0
10257,44,2,2021-03-18,2075,144,46887,23140,2021-03-18,1616022000.0
10258,44,2,2021-03-19,2691,347,49578,23487,2021-03-19,1616108400.0
10259,44,2,2021-03-20,2485,224,52063,23711,2021-03-20,1616194800.0
10260,44,2,2021-03-21,3411,2,55474,23713,2021-03-21,1616281200.0
10261,44,2,2021-03-22,1346,222,56820,23935,2021-03-22,1616367600.0
10262,44,2,2021-03-23,1762,162,58582,24097,2021-03-23,1616454000.0
10263,44,2,2021-03-24,1702,276,60284,24373,2021-03-24,1616540400.0
10264,44,2,2021-03-25,1683,176,61967,24549,2021-03-25,1616626800.0
10265,44,2,2021-03-26,2263,423,64230,24972,2021-03-26,1616713200.0
10266,44,2,2021-03-27,1318,210,65548,25182,2021-03-27,1616799600.0
10267,44,2,2021-03-28,822,1,66370,25183,2021-03-28,1616886000.0
10268,44,2,2021-03-29,1181,138,67551,25321,2021-03-29,1616972400.0
10269,44,2,2021-03-30,1733,118,69284,25439,2021-03-30,1617058800.0
10270,44,2,2021-03-31,2267,198,71551,25637,2021-03-31,1617145200.0
10271,44,2,2021-04-01,3009,206,74560,25843,2021-04-01,1617231600.0
10272,44,2,2021-04-02,2698,287,77258,26130,2021-04-02,1617318000.0
10273,44,2,2021-04-03,1847,196,79105,26326,2021-04-03,1617404400.0
10274,44,2,2021-04-04,501,180,79606,26506,2021-04-04,1617490800.0
10275,44,2,2021-04-05,632,212,80238,26718,2021-04-05,1617577200.0
10276,44,2,2021-04-06,1708,838,81946,27556,2021-04-06,1617663600.0
10277,44,2,2021-04-07,2565,1104,84511,28660,2021-04-07,1617750000.0
10278,44,2,2021-04-08,2940,1237,87451,29897,2021-04-08,1617836400.0
10279,44,2,2021-04-09,2242,1339,89693,31236,2021-04-09,1617922800.0
10280,44,2,2021-04-10,1591,3927,91284,35163,2021-04-10,1618009200.0
10281,44,2,2021-04-11,599,2842,91883,38005,2021-04-11,1618095600.0
10282,44,2,2021-04-12,1217,1421,93100,39426,2021-04-12,1618185600.0
10283,44,2,2021-04-13,925,1642,94025,41068,2021-04-13,1618272000.0
10284,44,2,2021-04-14,1298,1301,95323,42369,2021-04-14,1618358400.0
10285,44,2,2021-04-15,1536,2317,96859,44686,2021-04-15,1618444800.0
10286,44,2,2021-04-16,1765,2361,98624,47047,2021-04-16,1618531200.0
10287,44,2,2021-04-17,957,2488,99581,49535,2021-04-17,1618617600.0
10288,44,2,2021-04-18,1445,3261,101026,52796,2021-04-18,1618704000.0
10289,44,2,2021-04-19,1168,1323,102194,54119,2021-04-19,1618790400.0
10290,44,2,2021-04-20,1164,1700,103358,55819,2021-04-20,1618876800.0
10291,44,2,2021-04-21,1349,1462,104707,57281,2021-04-21,1618963200.0
10292,44,2,2021-04-22,1400,1586,106107,58867,2021-04-22,1619049600.0
10293,44,2,2021-04-23,2398,1835,108505,60702,2021-04-23,1619136000.0
10294,44,2,2021-04-24,2108,1264,110613,61966,2021-04-24,1619222400.0
10295,44,2,2021-04-25,224,801,110837,62767,2021-04-25,1619308800.0
10296,44,2,2021-04-26,1575,1138,112412,63905,2021-04-26,1619395200.0
10297,44,2,2021-04-27,2171,1918,114583,65823,2021-04-27,1619481600.0
10298,44,2,2021-04-28,1683,1966,116266,67789,2021-04-28,1619568000.0
10299,44,2,2021-04-29,2121,2707,118387,70496,2021-04-29,1619654400.0
10300,44,2,2021-04-30,2511,2243,120898,72739,2021-04-30,1619740800.0
10301,44,2,2021-05-01,828,1688,121726,74427,2021-05-01,1619827200.0
10302,44,2,2021-05-02,211,798,121937,75225,2021-05-02,1619913600.0
10303,44,2,2021-05-03,1850,1035,123787,76260,2021-05-03,1620000000.0
10304,44,2,2021-05-04,2139,1842,125926,78102,2021-05-04,1620086400.0
10305,44,2,2021-05-05,1653,2767,127579,80869,2021-05-05,1620172800.0
10306,44,2,2021-05-06,4015,3092,131594,83961,2021-05-06,1620259200.0
10307,44,2,2021-05-07,2304,2505,133898,86466,2021-05-07,1620345600.0
10308,44,2,2021-05-08,1162,1087,135060,87553,2021-05-08,1620432000.0
10309,44,2,2021-05-09,529,517,135589,88070,2021-05-09,1620518400.0
10310,44,2,2021-05-10,2643,1094,138232,89164,2021-05-10,1620604800.0
10311,44,2,2021-05-11,4435,1132,142667,90296,2021-05-11,1620691200.0
10312,44,2,2021-05-12,4616,968,147283,91264,2021-05-12,1620777600.0
10313,44,2,2021-05-13,5497,475,152780,91739,2021-05-13,1620864000.0
10314,44,2,2021-05-14,9504,796,162284,92535,2021-05-14,1620950400.0
10315,44,2,2021-05-15,7189,769,169473,93304,2021-05-15,1621036800.0
10316,44,2,2021-05-16,3116,1364,172589,94668,2021-05-16,1621123200.0
10317,44,2,2021-05-17,4185,1102,176774,95770,2021-05-17,1621206000.0
10318,44,2,2021-05-18,5906,986,182680,96756,2021-05-18,1621292400.0
10319,44,2,2021-05-19,4836,1375,187516,98131,2021-05-19,1621378800.0
10320,44,2,2021-05-20,5670,1197,193186,99328,2021-05-20,1621465200.0
10321,44,2,2021-05-21,5849,1364,199035,100692,2021-05-21,1621551600.0
10322,44,2,2021-05-22,3278,596,202313,101288,2021-05-22,1621638000.0
10323,44,2,2021-05-23,930,24,203243,101312,2021-05-23,1621724400.0
10324,44,2,2021-05-24,847,372,204090,101684,2021-05-24,1621810800.0
10325,44,2,2021-05-25,2049,1256,206139,102940,2021-05-25,1621897200.0
10326,44,2,2021-05-26,1327,945,207466,103885,2021-05-26,1621983600.0
10327,44,2,2021-05-27,1983,699,209449,104584,2021-05-27,1622070000.0
10328,44,2,2021-05-28,4019,1737,213468,106321,2021-05-28,1622156400.0
10329,44,2,2021-05-29,3845,757,217313,107078,2021-05-29,1622242800.0
10330,44,2,2021-05-30,337,58,217650,107136,2021-05-30,1622329200.0
10331,44,2,2021-05-31,3733,1896,221383,109032,2021-05-31,1622415600.0
10332,44,2,2021-06-01,4613,1302,225996,110334,2021-06-01,1622502000.0
10333,44,2,2021-06-02,3540,1425,229536,111759,2021-06-02,1622588400.0
10334,44,2,2021-06-03,4832,1751,234368,113510,2021-06-03,1622674800.0
10335,44,2,2021-06-04,6072,2056,240440,115566,2021-06-04,1622761200.0
10336,44,2,2021-06-05,4066,1888,244506,117454,2021-06-05,1622847600.0
10337,44,2,2021-06-06,529,142,245035,117596,2021-06-06,1622934000.0
10338,44,2,2021-06-07,2438,1741,247473,119337,2021-06-07,1623020400.0
10339,44,2,2021-06-08,3971,2423,251444,121760,2021-06-08,1623106800.0
10340,44,2,2021-06-09,3049,2211,254493,123971,2021-06-09,1623193200.0
10341,44,2,2021-06-10,3851,1790,258344,125761,2021-06-10,1623279600.0
10342,44,2,2021-06-11,5280,2643,263624,128404,2021-06-11,1623366000.0
10343,44,2,2021-06-12,3554,1569,267178,129973,2021-06-12,1623452400.0
10344,44,2,2021-06-13,233,171,267411,130144,2021-06-13,1623538800.0
10345,44,2,2021-06-14,2277,2044,269688,132188,2021-06-14,1623625200.0
10346,44,2,2021-06-15,2986,2427,272674,134615,2021-06-15,1623711600.0
10347,44,2,2021-06-16,2655,1557,275329,136172,2021-06-16,1623798000.0
10348,44,2,2021-06-17,3349,4071,278678,140243,2021-06-17,1623884400.0
10349,44,2,2021-06-18,4623,2260,283301,142503,2021-06-18,1623970800.0
10350,44,2,2021-06-19,2980,1515,286281,144018,2021-06-19,1624057200.0
10351,44,2,2021-06-20,220,556,286501,144574,2021-06-20,1624143600.0
10352,44,2,2021-06-21,1626,2681,288127,147255,2021-06-21,1624230000.0
10353,44,2,2021-06-22,2390,6220,290517,153475,2021-06-22,1624316400.0
10354,44,2,2021-06-23,2155,4194,292672,157669,2021-06-23,1624402800.0
10355,44,2,2021-06-24,2541,5621,295213,163290,2021-06-24,1624489200.0
10356,44,2,2021-06-25,3540,7766,298753,171056,2021-06-25,1624575600.0
10357,44,2,2021-06-26,2094,6408,300847,177464,2021-06-26,1624662000.0
10358,44,2,2021-06-27,258,2525,301105,179989,2021-06-27,1624748400.0
10359,44,2,2021-06-28,1139,4671,302244,184660,2021-06-28,1624834800.0
10360,44,2,2021-06-29,1494,5915,303738,190575,2021-06-29,1624921200.0
10361,44,2,2021-06-30,1381,4751,305119,195326,2021-06-30,1625007600.0
10362,44,2,2021-07-01,1630,5824,306749,201150,2021-07-01,1625094000.0
10363,44,2,2021-07-02,2116,6458,308865,207608,2021-07-02,1625180400.0
10364,44,2,2021-07-03,1274,3528,310139,211136,2021-07-03,1625266800.0
10365,44,2,2021-07-04,111,743,310250,211879,2021-07-04,1625353200.0
10366,44,2,2021-07-05,733,1945,310983,213824,2021-07-05,1625439600.0
10367,44,2,2021-07-06,1098,3381,312081,217205,2021-07-06,1625526000.0
10368,44,3,2020-12-27,0,0,0,0,2020-12-27,1609023600.0
10369,44,3,2020-12-28,0,0,0,0,2020-12-28,1609110000.0
10370,44,3,2020-12-29,0,0,0,0,2020-12-29,1609196400.0
10371,44,3,2020-12-30,0,0,0,0,2020-12-30,1609282800.0
10372,44,3,2020-12-31,0,0,0,0,2020-12-31,1609369200.0
10373,44,3,2021-01-01,0,0,0,0,2021-01-01,1609455600.0
10374,44,3,2021-01-02,0,0,0,0,2021-01-02,1609542000.0
10375,44,3,2021-01-03,0,0,0,0,2021-01-03,1609628400.0
10376,44,3,2021-01-04,0,0,0,0,2021-01-04,1609714800.0
10377,44,3,2021-01-05,0,0,0,0,2021-01-05,1609801200.0
10378,44,3,2021-01-06,0,0,0,0,2021-01-06,1609887600.0
10379,44,3,2021-01-07,0,0,0,0,2021-01-07,1609974000.0
10380,44,3,2021-01-08,0,0,0,0,2021-01-08,1610060400.0
10381,44,3,2021-01-09,0,0,0,0,2021-01-09,1610146800.0
10382,44,3,2021-01-10,0,0,0,0,2021-01-10,1610233200.0
10383,44,3,2021-01-11,0,0,0,0,2021-01-11,1610319600.0
10384,44,3,2021-01-12,0,0,0,0,2021-01-12,1610406000.0
10385,44,3,2021-01-13,0,0,0,0,2021-01-13,1610492400.0
10386,44,3,2021-01-14,0,0,0,0,2021-01-14,1610578800.0
10387,44,3,2021-01-15,0,0,0,0,2021-01-15,1610665200.0
10388,44,3,2021-01-16,0,0,0,0,2021-01-16,1610751600.0
10389,44,3,2021-01-17,0,0,0,0,2021-01-17,1610838000.0
10390,44,3,2021-01-18,0,0,0,0,2021-01-18,1610924400.0
10391,44,3,2021-01-19,0,0,0,0,2021-01-19,1611010800.0
10392,44,3,2021-01-20,0,0,0,0,2021-01-20,1611097200.0
10393,44,3,2021-01-21,0,0,0,0,2021-01-21,1611183600.0
10394,44,3,2021-01-22,0,0,0,0,2021-01-22,1611270000.0
10395,44,3,2021-01-23,0,0,0,0,2021-01-23,1611356400.0
10396,44,3,2021-01-24,0,0,0,0,2021-01-24,1611442800.0
10397,44,3,2021-01-25,0,0,0,0,2021-01-25,1611529200.0
10398,44,3,2021-01-26,0,0,0,0,2021-01-26,1611615600.0
10399,44,3,2021-01-27,0,0,0,0,2021-01-27,1611702000.0
10400,44,3,2021-01-28,0,0,0,0,2021-01-28,1611788400.0
10401,44,3,2021-01-29,0,0,0,0,2021-01-29,1611874800.0
10402,44,3,2021-01-30,0,0,0,0,2021-01-30,1611961200.0
10403,44,3,2021-01-31,0,0,0,0,2021-01-31,1612047600.0
10404,44,3,2021-02-01,0,0,0,0,2021-02-01,1612134000.0
10405,44,3,2021-02-02,0,0,0,0,2021-02-02,1612220400.0
10406,44,3,2021-02-03,0,0,0,0,2021-02-03,1612306800.0
10407,44,3,2021-02-04,0,0,0,0,2021-02-04,1612393200.0
10408,44,3,2021-02-05,0,0,0,0,2021-02-05,1612479600.0
10409,44,3,2021-02-06,13,0,13,0,2021-02-06,1612566000.0
10410,44,3,2021-02-07,0,0,13,0,2021-02-07,1612652400.0
10411,44,3,2021-02-08,300,0,313,0,2021-02-08,1612738800.0
10412,44,3,2021-02-09,928,0,1241,0,2021-02-09,1612825200.0
10413,44,3,2021-02-10,1210,0,2451,0,2021-02-10,1612911600.0
10414,44,3,2021-02-11,1468,0,3919,0,2021-02-11,1612998000.0
10415,44,3,2021-02-12,1683,0,5602,0,2021-02-12,1613084400.0
10416,44,3,2021-02-13,269,0,5871,0,2021-02-13,1613170800.0
10417,44,3,2021-02-14,4,0,5875,0,2021-02-14,1613257200.0
10418,44,3,2021-02-15,1194,0,7069,0,2021-02-15,1613343600.0
10419,44,3,2021-02-16,1280,0,8349,0,2021-02-16,1613430000.0
10420,44,3,2021-02-17,1305,0,9654,0,2021-02-17,1613516400.0
10421,44,3,2021-02-18,1652,0,11306,0,2021-02-18,1613602800.0
10422,44,3,2021-02-19,1344,0,12650,0,2021-02-19,1613689200.0
10423,44,3,2021-02-20,219,0,12869,0,2021-02-20,1613775600.0
10424,44,3,2021-02-21,3,0,12872,0,2021-02-21,1613862000.0
10425,44,3,2021-02-22,833,0,13705,0,2021-02-22,1613948400.0
10426,44,3,2021-02-23,958,0,14663,0,2021-02-23,1614034800.0
10427,44,3,2021-02-24,1636,0,16299,0,2021-02-24,1614121200.0
10428,44,3,2021-02-25,4867,0,21166,0,2021-02-25,1614207600.0
10429,44,3,2021-02-26,7270,0,28436,0,2021-02-26,1614294000.0
10430,44,3,2021-02-27,4086,1,32522,1,2021-02-27,1614380400.0
10431,44,3,2021-02-28,152,0,32674,1,2021-02-28,1614466800.0
10432,44,3,2021-03-01,1558,0,34232,1,2021-03-01,1614553200.0
10433,44,3,2021-03-02,2826,0,37058,1,2021-03-02,1614639600.0
10434,44,3,2021-03-03,4530,1,41588,2,2021-03-03,1614726000.0
10435,44,3,2021-03-04,6533,0,48121,2,2021-03-04,1614812400.0
10436,44,3,2021-03-05,10272,6,58393,8,2021-03-05,1614898800.0
10437,44,3,2021-03-06,12696,1,71089,9,2021-03-06,1614985200.0
10438,44,3,2021-03-07,5708,5,76797,14,2021-03-07,1615071600.0
10439,44,3,2021-03-08,3305,1,80102,15,2021-03-08,1615158000.0
10440,44,3,2021-03-09,6197,4,86299,19,2021-03-09,1615244400.0
10441,44,3,2021-03-10,6937,2,93236,21,2021-03-10,1615330800.0
10442,44,3,2021-03-11,9437,3,102673,24,2021-03-11,1615417200.0
10443,44,3,2021-03-12,16191,7,118864,31,2021-03-12,1615503600.0
10444,44,3,2021-03-13,14249,7,133113,38,2021-03-13,1615590000.0
10445,44,3,2021-03-14,1456,0,134569,38,2021-03-14,1615676400.0
10446,44,3,2021-03-15,3560,3,138129,41,2021-03-15,1615762800.0
10447,44,3,2021-03-16,110,1,138239,42,2021-03-16,1615849200.0
10448,44,3,2021-03-17,48,1,138287,43,2021-03-17,1615935600.0
10449,44,3,2021-03-18,102,0,138389,43,2021-03-18,1616022000.0
10450,44,3,2021-03-19,6208,2,144597,45,2021-03-19,1616108400.0
10451,44,3,2021-03-20,6860,3,151457,48,2021-03-20,1616194800.0
10452,44,3,2021-03-21,485,0,151942,48,2021-03-21,1616281200.0
10453,44,3,2021-03-22,2466,1,154408,49,2021-03-22,1616367600.0
10454,44,3,2021-03-23,5954,1,160362,50,2021-03-23,1616454000.0
10455,44,3,2021-03-24,8124,17,168486,67,2021-03-24,1616540400.0
10456,44,3,2021-03-25,13350,10,181836,77,2021-03-25,1616626800.0
10457,44,3,2021-03-26,14662,5,196498,82,2021-03-26,1616713200.0
10458,44,3,2021-03-27,7793,17,204291,99,2021-03-27,1616799600.0
10459,44,3,2021-03-28,357,0,204648,99,2021-03-28,1616886000.0
10460,44,3,2021-03-29,4208,7,208856,106,2021-03-29,1616972400.0
10461,44,3,2021-03-30,7897,4,216753,110,2021-03-30,1617058800.0
10462,44,3,2021-03-31,5875,4,222628,114,2021-03-31,1617145200.0
10463,44,3,2021-04-01,6836,2,229464,116,2021-04-01,1617231600.0
10464,44,3,2021-04-02,4812,7,234276,123,2021-04-02,1617318000.0
10465,44,3,2021-04-03,2617,13,236893,136,2021-04-03,1617404400.0
10466,44,3,2021-04-04,84,0,236977,136,2021-04-04,1617490800.0
10467,44,3,2021-04-05,258,0,237235,136,2021-04-05,1617577200.0
10468,44,3,2021-04-06,1951,4,239186,140,2021-04-06,1617663600.0
10469,44,3,2021-04-07,2805,11,241991,151,2021-04-07,1617750000.0
10470,44,3,2021-04-08,7262,34,249253,185,2021-04-08,1617836400.0
10471,44,3,2021-04-09,14330,24,263583,209,2021-04-09,1617922800.0
10472,44,3,2021-04-10,7387,17,270970,226,2021-04-10,1618009200.0
10473,44,3,2021-04-11,494,6,271464,232,2021-04-11,1618095600.0
10474,44,3,2021-04-12,3896,17,275360,249,2021-04-12,1618185600.0
10475,44,3,2021-04-13,5979,16,281339,265,2021-04-13,1618272000.0
10476,44,3,2021-04-14,5238,33,286577,298,2021-04-14,1618358400.0
10477,44,3,2021-04-15,6805,33,293382,331,2021-04-15,1618444800.0
10478,44,3,2021-04-16,9237,55,302619,386,2021-04-16,1618531200.0
10479,44,3,2021-04-17,5219,30,307838,416,2021-04-17,1618617600.0
10480,44,3,2021-04-18,1374,5,309212,421,2021-04-18,1618704000.0
10481,44,3,2021-04-19,1792,27,311004,448,2021-04-19,1618790400.0
10482,44,3,2021-04-20,3296,38,314300,486,2021-04-20,1618876800.0
10483,44,3,2021-04-21,2951,66,317251,552,2021-04-21,1618963200.0
10484,44,3,2021-04-22,4694,59,321945,611,2021-04-22,1619049600.0
10485,44,3,2021-04-23,6640,96,328585,707,2021-04-23,1619136000.0
10486,44,3,2021-04-24,3403,124,331988,831,2021-04-24,1619222400.0
10487,44,3,2021-04-25,482,1,332470,832,2021-04-25,1619308800.0
10488,44,3,2021-04-26,1604,60,334074,892,2021-04-26,1619395200.0
10489,44,3,2021-04-27,1999,99,336073,991,2021-04-27,1619481600.0
10490,44,3,2021-04-28,2239,223,338312,1214,2021-04-28,1619568000.0
10491,44,3,2021-04-29,3519,736,341831,1950,2021-04-29,1619654400.0
10492,44,3,2021-04-30,4839,869,346670,2819,2021-04-30,1619740800.0
10493,44,3,2021-05-01,599,263,347269,3082,2021-05-01,1619827200.0
10494,44,3,2021-05-02,151,28,347420,3110,2021-05-02,1619913600.0
10495,44,3,2021-05-03,943,348,348363,3458,2021-05-03,1620000000.0
10496,44,3,2021-05-04,1543,667,349906,4125,2021-05-04,1620086400.0
10497,44,3,2021-05-05,1479,1036,351385,5161,2021-05-05,1620172800.0
10498,44,3,2021-05-06,2747,2033,354132,7194,2021-05-06,1620259200.0
10499,44,3,2021-05-07,3533,3254,357665,10448,2021-05-07,1620345600.0
10500,44,3,2021-05-08,808,1035,358473,11483,2021-05-08,1620432000.0
10501,44,3,2021-05-09,182,223,358655,11706,2021-05-09,1620518400.0
10502,44,3,2021-05-10,1102,1053,359757,12759,2021-05-10,1620604800.0
10503,44,3,2021-05-11,1846,2057,361603,14816,2021-05-11,1620691200.0
10504,44,3,2021-05-12,1489,3006,363092,17822,2021-05-12,1620777600.0
10505,44,3,2021-05-13,197,472,363289,18294,2021-05-13,1620864000.0
10506,44,3,2021-05-14,1471,3570,364760,21864,2021-05-14,1620950400.0
10507,44,3,2021-05-15,813,2936,365573,24800,2021-05-15,1621036800.0
10508,44,3,2021-05-16,62,390,365635,25190,2021-05-16,1621123200.0
10509,44,3,2021-05-17,636,1511,366271,26701,2021-05-17,1621206000.0
10510,44,3,2021-05-18,920,2260,367191,28961,2021-05-18,1621292400.0
10511,44,3,2021-05-19,700,2718,367891,31679,2021-05-19,1621378800.0
10512,44,3,2021-05-20,804,4486,368695,36165,2021-05-20,1621465200.0
10513,44,3,2021-05-21,1131,6607,369826,42772,2021-05-21,1621551600.0
10514,44,3,2021-05-22,532,4152,370358,46924,2021-05-22,1621638000.0
10515,44,3,2021-05-23,57,190,370415,47114,2021-05-23,1621724400.0
10516,44,3,2021-05-24,19,393,370434,47507,2021-05-24,1621810800.0
10517,44,3,2021-05-25,347,2806,370781,50313,2021-05-25,1621897200.0
10518,44,3,2021-05-26,382,4594,371163,54907,2021-05-26,1621983600.0
10519,44,3,2021-05-27,420,6400,371583,61307,2021-05-27,1622070000.0
10520,44,3,2021-05-28,666,8680,372249,69987,2021-05-28,1622156400.0
10521,44,3,2021-05-29,327,7442,372576,77429,2021-05-29,1622242800.0
10522,44,3,2021-05-30,37,1793,372613,79222,2021-05-30,1622329200.0
10523,44,3,2021-05-31,188,2888,372801,82110,2021-05-31,1622415600.0
10524,44,3,2021-06-01,214,5064,373015,87174,2021-06-01,1622502000.0
10525,44,3,2021-06-02,157,5608,373172,92782,2021-06-02,1622588400.0
10526,44,3,2021-06-03,230,7462,373402,100244,2021-06-03,1622674800.0
10527,44,3,2021-06-04,360,9345,373762,109589,2021-06-04,1622761200.0
10528,44,3,2021-06-05,211,6127,373973,115716,2021-06-05,1622847600.0
10529,44,3,2021-06-06,17,458,373990,116174,2021-06-06,1622934000.0
10530,44,3,2021-06-07,86,2109,374076,118283,2021-06-07,1623020400.0
10531,44,3,2021-06-08,97,3491,374173,121774,2021-06-08,1623106800.0
10532,44,3,2021-06-09,89,3188,374262,124962,2021-06-09,1623193200.0
10533,44,3,2021-06-10,149,5473,374411,130435,2021-06-10,1623279600.0
10534,44,3,2021-06-11,197,8184,374608,138619,2021-06-11,1623366000.0
10535,44,3,2021-06-12,127,4815,374735,143434,2021-06-12,1623452400.0
10536,44,3,2021-06-13,5,224,374740,143658,2021-06-13,1623538800.0
10537,44,3,2021-06-14,58,3145,374798,146803,2021-06-14,1623625200.0
10538,44,3,2021-06-15,78,6036,374876,152839,2021-06-15,1623711600.0
10539,44,3,2021-06-16,71,5849,374947,158688,2021-06-16,1623798000.0
10540,44,3,2021-06-17,98,8541,375045,167229,2021-06-17,1623884400.0
10541,44,3,2021-06-18,148,9921,375193,177150,2021-06-18,1623970800.0
10542,44,3,2021-06-19,36,4439,375229,181589,2021-06-19,1624057200.0
10543,44,3,2021-06-20,1,266,375230,181855,2021-06-20,1624143600.0
10544,44,3,2021-06-21,34,3169,375264,185024,2021-06-21,1624230000.0
10545,44,3,2021-06-22,50,5078,375314,190102,2021-06-22,1624316400.0
10546,44,3,2021-06-23,50,4325,375364,194427,2021-06-23,1624402800.0
10547,44,3,2021-06-24,86,6064,375450,200491,2021-06-24,1624489200.0
10548,44,3,2021-06-25,87,7030,375537,207521,2021-06-25,1624575600.0
10549,44,3,2021-06-26,66,3229,375603,210750,2021-06-26,1624662000.0
10550,44,3,2021-06-27,2,258,375605,211008,2021-06-27,1624748400.0
10551,44,3,2021-06-28,41,2148,375646,213156,2021-06-28,1624834800.0
10552,44,3,2021-06-29,42,4083,375688,217239,2021-06-29,1624921200.0
10553,44,3,2021-06-30,67,3442,375755,220681,2021-06-30,1625007600.0
10554,44,3,2021-07-01,75,5038,375830,225719,2021-07-01,1625094000.0
10555,44,3,2021-07-02,108,7486,375938,233205,2021-07-02,1625180400.0
10556,44,3,2021-07-03,49,3146,375987,236351,2021-07-03,1625266800.0
10557,44,3,2021-07-04,15,529,376002,236880,2021-07-04,1625353200.0
10558,44,3,2021-07-05,37,2822,376039,239702,2021-07-05,1625439600.0
10559,44,3,2021-07-06,46,3747,376085,243449,2021-07-06,1625526000.0
10560,44,4,2020-12-27,0,0,0,0,2020-12-27,1609023600.0
10561,44,4,2020-12-28,0,0,0,0,2020-12-28,1609110000.0
10562,44,4,2020-12-29,0,0,0,0,2020-12-29,1609196400.0
10563,44,4,2020-12-30,0,0,0,0,2020-12-30,1609282800.0
10564,44,4,2020-12-31,0,0,0,0,2020-12-31,1609369200.0
10565,44,4,2021-01-01,0,0,0,0,2021-01-01,1609455600.0
10566,44,4,2021-01-02,0,0,0,0,2021-01-02,1609542000.0
10567,44,4,2021-01-03,0,0,0,0,2021-01-03,1609628400.0
10568,44,4,2021-01-04,0,0,0,0,2021-01-04,1609714800.0
10569,44,4,2021-01-05,0,0,0,0,2021-01-05,1609801200.0
10570,44,4,2021-01-06,0,0,0,0,2021-01-06,1609887600.0
10571,44,4,2021-01-07,0,0,0,0,2021-01-07,1609974000.0
10572,44,4,2021-01-08,0,0,0,0,2021-01-08,1610060400.0
10573,44,4,2021-01-09,0,0,0,0,2021-01-09,1610146800.0
10574,44,4,2021-01-10,0,0,0,0,2021-01-10,1610233200.0
10575,44,4,2021-01-11,0,0,0,0,2021-01-11,1610319600.0
10576,44,4,2021-01-12,0,0,0,0,2021-01-12,1610406000.0
10577,44,4,2021-01-13,0,0,0,0,2021-01-13,1610492400.0
10578,44,4,2021-01-14,0,0,0,0,2021-01-14,1610578800.0
10579,44,4,2021-01-15,0,0,0,0,2021-01-15,1610665200.0
10580,44,4,2021-01-16,0,0,0,0,2021-01-16,1610751600.0
10581,44,4,2021-01-17,0,0,0,0,2021-01-17,1610838000.0
10582,44,4,2021-01-18,0,0,0,0,2021-01-18,1610924400.0
10583,44,4,2021-01-19,0,0,0,0,2021-01-19,1611010800.0
10584,44,4,2021-01-20,0,0,0,0,2021-01-20,1611097200.0
10585,44,4,2021-01-21,0,0,0,0,2021-01-21,1611183600.0
10586,44,4,2021-01-22,0,0,0,0,2021-01-22,1611270000.0
10587,44,4,2021-01-23,0,0,0,0,2021-01-23,1611356400.0
10588,44,4,2021-01-24,0,0,0,0,2021-01-24,1611442800.0
10589,44,4,2021-01-25,0,0,0,0,2021-01-25,1611529200.0
10590,44,4,2021-01-26,0,0,0,0,2021-01-26,1611615600.0
10591,44,4,2021-01-27,0,0,0,0,2021-01-27,1611702000.0
10592,44,4,2021-01-28,0,0,0,0,2021-01-28,1611788400.0
10593,44,4,2021-01-29,0,0,0,0,2021-01-29,1611874800.0
10594,44,4,2021-01-30,0,0,0,0,2021-01-30,1611961200.0
10595,44,4,2021-01-31,0,0,0,0,2021-01-31,1612047600.0
10596,44,4,2021-02-01,0,0,0,0,2021-02-01,1612134000.0
10597,44,4,2021-02-02,0,0,0,0,2021-02-02,1612220400.0
10598,44,4,2021-02-03,0,0,0,0,2021-02-03,1612306800.0
10599,44,4,2021-02-04,0,0,0,0,2021-02-04,1612393200.0
10600,44,4,2021-02-05,0,0,0,0,2021-02-05,1612479600.0
10601,44,4,2021-02-06,0,0,0,0,2021-02-06,1612566000.0
10602,44,4,2021-02-07,0,0,0,0,2021-02-07,1612652400.0
10603,44,4,2021-02-08,0,0,0,0,2021-02-08,1612738800.0
10604,44,4,2021-02-09,0,0,0,0,2021-02-09,1612825200.0
10605,44,4,2021-02-10,0,0,0,0,2021-02-10,1612911600.0
10606,44,4,2021-02-11,0,0,0,0,2021-02-11,1612998000.0
10607,44,4,2021-02-12,0,0,0,0,2021-02-12,1613084400.0
10608,44,4,2021-02-13,0,0,0,0,2021-02-13,1613170800.0
10609,44,4,2021-02-14,0,0,0,0,2021-02-14,1613257200.0
10610,44,4,2021-02-15,0,0,0,0,2021-02-15,1613343600.0
10611,44,4,2021-02-16,0,0,0,0,2021-02-16,1613430000.0
10612,44,4,2021-02-17,0,0,0,0,2021-02-17,1613516400.0
10613,44,4,2021-02-18,0,0,0,0,2021-02-18,1613602800.0
10614,44,4,2021-02-19,0,0,0,0,2021-02-19,1613689200.0
10615,44,4,2021-02-20,0,0,0,0,2021-02-20,1613775600.0
10616,44,4,2021-02-21,0,0,0,0,2021-02-21,1613862000.0
10617,44,4,2021-02-22,0,0,0,0,2021-02-22,1613948400.0
10618,44,4,2021-02-23,0,0,0,0,2021-02-23,1614034800.0
10619,44,4,2021-02-24,0,0,0,0,2021-02-24,1614121200.0
10620,44,4,2021-02-25,0,0,0,0,2021-02-25,1614207600.0
10621,44,4,2021-02-26,0,0,0,0,2021-02-26,1614294000.0
10622,44,4,2021-02-27,0,0,0,0,2021-02-27,1614380400.0
10623,44,4,2021-02-28,0,0,0,0,2021-02-28,1614466800.0
10624,44,4,2021-03-01,0,0,0,0,2021-03-01,1614553200.0
10625,44,4,2021-03-02,0,0,0,0,2021-03-02,1614639600.0
10626,44,4,2021-03-03,0,0,0,0,2021-03-03,1614726000.0
10627,44,4,2021-03-04,0,0,0,0,2021-03-04,1614812400.0
10628,44,4,2021-03-05,0,0,0,0,2021-03-05,1614898800.0
10629,44,4,2021-03-06,0,0,0,0,2021-03-06,1614985200.0
10630,44,4,2021-03-07,0,0,0,0,2021-03-07,1615071600.0
10631,44,4,2021-03-08,0,0,0,0,2021-03-08,1615158000.0
10632,44,4,2021-03-09,0,0,0,0,2021-03-09,1615244400.0
10633,44,4,2021-03-10,0,0,0,0,2021-03-10,1615330800.0
10634,44,4,2021-03-11,0,0,0,0,2021-03-11,1615417200.0
10635,44,4,2021-03-12,0,0,0,0,2021-03-12,1615503600.0
10636,44,4,2021-03-13,0,0,0,0,2021-03-13,1615590000.0
10637,44,4,2021-03-14,0,0,0,0,2021-03-14,1615676400.0
10638,44,4,2021-03-15,0,0,0,0,2021-03-15,1615762800.0
10639,44,4,2021-03-16,0,0,0,0,2021-03-16,1615849200.0
10640,44,4,2021-03-17,0,0,0,0,2021-03-17,1615935600.0
10641,44,4,2021-03-18,0,0,0,0,2021-03-18,1616022000.0
10642,44,4,2021-03-19,0,0,0,0,2021-03-19,1616108400.0
10643,44,4,2021-03-20,0,0,0,0,2021-03-20,1616194800.0
10644,44,4,2021-03-21,0,0,0,0,2021-03-21,1616281200.0
10645,44,4,2021-03-22,0,0,0,0,2021-03-22,1616367600.0
10646,44,4,2021-03-23,0,0,0,0,2021-03-23,1616454000.0
10647,44,4,2021-03-24,0,0,0,0,2021-03-24,1616540400.0
10648,44,4,2021-03-25,0,0,0,0,2021-03-25,1616626800.0
10649,44,4,2021-03-26,0,0,0,0,2021-03-26,1616713200.0
10650,44,4,2021-03-27,0,0,0,0,2021-03-27,1616799600.0
10651,44,4,2021-03-28,0,0,0,0,2021-03-28,1616886000.0
10652,44,4,2021-03-29,0,0,0,0,2021-03-29,1616972400.0
10653,44,4,2021-03-30,0,0,0,0,2021-03-30,1617058800.0
10654,44,4,2021-03-31,0,0,0,0,2021-03-31,1617145200.0
10655,44,4,2021-04-01,0,0,0,0,2021-04-01,1617231600.0
10656,44,4,2021-04-02,0,0,0,0,2021-04-02,1617318000.0
10657,44,4,2021-04-03,0,0,0,0,2021-04-03,1617404400.0
10658,44,4,2021-04-04,0,0,0,0,2021-04-04,1617490800.0
10659,44,4,2021-04-05,0,0,0,0,2021-04-05,1617577200.0
10660,44,4,2021-04-06,0,0,0,0,2021-04-06,1617663600.0
10661,44,4,2021-04-07,0,0,0,0,2021-04-07,1617750000.0
10662,44,4,2021-04-08,0,0,0,0,2021-04-08,1617836400.0
10663,44,4,2021-04-09,0,1,0,1,2021-04-09,1617922800.0
10664,44,4,2021-04-10,0,0,0,1,2021-04-10,1618009200.0
10665,44,4,2021-04-11,0,0,0,1,2021-04-11,1618095600.0
10666,44,4,2021-04-12,0,0,0,1,2021-04-12,1618185600.0
10667,44,4,2021-04-13,0,0,0,1,2021-04-13,1618272000.0
10668,44,4,2021-04-14,0,0,0,1,2021-04-14,1618358400.0
10669,44,4,2021-04-15,0,0,0,1,2021-04-15,1618444800.0
10670,44,4,2021-04-16,0,0,0,1,2021-04-16,1618531200.0
10671,44,4,2021-04-17,0,0,0,1,2021-04-17,1618617600.0
10672,44,4,2021-04-18,0,0,0,1,2021-04-18,1618704000.0
10673,44,4,2021-04-19,0,0,0,1,2021-04-19,1618790400.0
10674,44,4,2021-04-20,0,0,0,1,2021-04-20,1618876800.0
10675,44,4,2021-04-21,0,0,0,1,2021-04-21,1618963200.0
10676,44,4,2021-04-22,0,0,0,1,2021-04-22,1619049600.0
10677,44,4,2021-04-23,34,0,34,1,2021-04-23,1619136000.0
10678,44,4,2021-04-24,5,0,39,1,2021-04-24,1619222400.0
10679,44,4,2021-04-25,0,0,39,1,2021-04-25,1619308800.0
10680,44,4,2021-04-26,49,0,88,1,2021-04-26,1619395200.0
10681,44,4,2021-04-27,577,1,665,2,2021-04-27,1619481600.0
10682,44,4,2021-04-28,804,0,1469,2,2021-04-28,1619568000.0
10683,44,4,2021-04-29,1401,0,2870,2,2021-04-29,1619654400.0
10684,44,4,2021-04-30,1954,1,4824,3,2021-04-30,1619740800.0
10685,44,4,2021-05-01,228,1,5052,4,2021-05-01,1619827200.0
10686,44,4,2021-05-02,64,0,5116,4,2021-05-02,1619913600.0
10687,44,4,2021-05-03,549,0,5665,4,2021-05-03,1620000000.0
10688,44,4,2021-05-04,724,1,6389,5,2021-05-04,1620086400.0
10689,44,4,2021-05-05,563,1,6952,6,2021-05-05,1620172800.0
10690,44,4,2021-05-06,1125,1,8077,7,2021-05-06,1620259200.0
10691,44,4,2021-05-07,1880,1,9957,8,2021-05-07,1620345600.0
10692,44,4,2021-05-08,272,1,10229,9,2021-05-08,1620432000.0
10693,44,4,2021-05-09,38,0,10267,9,2021-05-09,1620518400.0
10694,44,4,2021-05-10,651,0,10918,9,2021-05-10,1620604800.0
10695,44,4,2021-05-11,943,0,11861,9,2021-05-11,1620691200.0
10696,44,4,2021-05-12,963,2,12824,11,2021-05-12,1620777600.0
10697,44,4,2021-05-13,165,0,12989,11,2021-05-13,1620864000.0
10698,44,4,2021-05-14,754,0,13743,11,2021-05-14,1620950400.0
10699,44,4,2021-05-15,488,2,14231,13,2021-05-15,1621036800.0
10700,44,4,2021-05-16,41,0,14272,13,2021-05-16,1621123200.0
10701,44,4,2021-05-17,366,0,14638,13,2021-05-17,1621206000.0
10702,44,4,2021-05-18,631,2,15269,15,2021-05-18,1621292400.0
10703,44,4,2021-05-19,507,0,15776,15,2021-05-19,1621378800.0
10704,44,4,2021-05-20,889,0,16665,15,2021-05-20,1621465200.0
10705,44,4,2021-05-21,1211,4,17876,19,2021-05-21,1621551600.0
10706,44,4,2021-05-22,560,2,18436,21,2021-05-22,1621638000.0
10707,44,4,2021-05-23,60,0,18496,21,2021-05-23,1621724400.0
10708,44,4,2021-05-24,44,0,18540,21,2021-05-24,1621810800.0
10709,44,4,2021-05-25,641,4,19181,25,2021-05-25,1621897200.0
10710,44,4,2021-05-26,629,2,19810,27,2021-05-26,1621983600.0
10711,44,4,2021-05-27,1436,3,21246,30,2021-05-27,1622070000.0
10712,44,4,2021-05-28,2552,5,23798,35,2021-05-28,1622156400.0
10713,44,4,2021-05-29,1471,1,25269,36,2021-05-29,1622242800.0
10714,44,4,2021-05-30,105,0,25374,36,2021-05-30,1622329200.0
10715,44,4,2021-05-31,1094,1,26468,37,2021-05-31,1622415600.0
10716,44,4,2021-06-01,1600,4,28068,41,2021-06-01,1622502000.0
10717,44,4,2021-06-02,1266,2,29334,43,2021-06-02,1622588400.0
10718,44,4,2021-06-03,1577,2,30911,45,2021-06-03,1622674800.0
10719,44,4,2021-06-04,1824,1,32735,46,2021-06-04,1622761200.0
10720,44,4,2021-06-05,1075,8,33810,54,2021-06-05,1622847600.0
10721,44,4,2021-06-06,95,0,33905,54,2021-06-06,1622934000.0
10722,44,4,2021-06-07,589,0,34494,54,2021-06-07,1623020400.0
10723,44,4,2021-06-08,1091,2,35585,56,2021-06-08,1623106800.0
10724,44,4,2021-06-09,956,0,36541,56,2021-06-09,1623193200.0
10725,44,4,2021-06-10,1135,1,37676,57,2021-06-10,1623279600.0
10726,44,4,2021-06-11,1342,1,39018,58,2021-06-11,1623366000.0
10727,44,4,2021-06-12,855,8,39873,66,2021-06-12,1623452400.0
10728,44,4,2021-06-13,50,1,39923,67,2021-06-13,1623538800.0
10729,44,4,2021-06-14,570,0,40493,67,2021-06-14,1623625200.0
10730,44,4,2021-06-15,795,2,41288,69,2021-06-15,1623711600.0
10731,44,4,2021-06-16,647,2,41935,71,2021-06-16,1623798000.0
10732,44,4,2021-06-17,765,2,42700,73,2021-06-17,1623884400.0
10733,44,4,2021-06-18,1026,2,43726,75,2021-06-18,1623970800.0
10734,44,4,2021-06-19,603,2,44329,77,2021-06-19,1624057200.0
10735,44,4,2021-06-20,101,0,44430,77,2021-06-20,1624143600.0
10736,44,4,2021-06-21,418,1,44848,78,2021-06-21,1624230000.0
10737,44,4,2021-06-22,587,0,45435,78,2021-06-22,1624316400.0
10738,44,4,2021-06-23,589,1,46024,79,2021-06-23,1624402800.0
10739,44,4,2021-06-24,518,2,46542,81,2021-06-24,1624489200.0
10740,44,4,2021-06-25,813,6,47355,87,2021-06-25,1624575600.0
10741,44,4,2021-06-26,557,2,47912,89,2021-06-26,1624662000.0
10742,44,4,2021-06-27,29,0,47941,89,2021-06-27,1624748400.0
10743,44,4,2021-06-28,338,2,48279,91,2021-06-28,1624834800.0
10744,44,4,2021-06-29,384,0,48663,91,2021-06-29,1624921200.0
10745,44,4,2021-06-30,388,0,49051,91,2021-06-30,1625007600.0
10746,44,4,2021-07-01,552,3,49603,94,2021-07-01,1625094000.0
10747,44,4,2021-07-02,755,1,50358,95,2021-07-02,1625180400.0
10748,44,4,2021-07-03,502,0,50860,95,2021-07-03,1625266800.0
10749,44,4,2021-07-04,69,0,50929,95,2021-07-04,1625353200.0
10750,44,4,2021-07-05,352,0,51281,95,2021-07-05,1625439600.0
10751,44,4,2021-07-06,563,0,51844,95,2021-07-06,1625526000.0
10752,52,1,2020-12-27,0,0,0,0,2020-12-27,1609023600.0
10753,52,1,2020-12-28,2,0,2,0,2020-12-28,1609110000.0
10754,52,1,2020-12-29,0,0,2,0,2020-12-29,1609196400.0
10755,52,1,2020-12-30,0,0,2,0,2020-12-30,1609282800.0
10756,52,1,2020-12-31,0,0,2,0,2020-12-31,1609369200.0
10757,52,1,2021-01-01,5,0,7,0,2021-01-01,1609455600.0
10758,52,1,2021-01-02,1,0,8,0,2021-01-02,1609542000.0
10759,52,1,2021-01-03,1,0,9,0,2021-01-03,1609628400.0
10760,52,1,2021-01-04,34,0,43,0,2021-01-04,1609714800.0
10761,52,1,2021-01-05,168,0,211,0,2021-01-05,1609801200.0
10762,52,1,2021-01-06,384,0,595,0,2021-01-06,1609887600.0
10763,52,1,2021-01-07,964,0,1559,0,2021-01-07,1609974000.0
10764,52,1,2021-01-08,1664,0,3223,0,2021-01-08,1610060400.0
10765,52,1,2021-01-09,1049,0,4272,0,2021-01-09,1610146800.0
10766,52,1,2021-01-10,643,0,4915,0,2021-01-10,1610233200.0
10767,52,1,2021-01-11,2197,0,7112,0,2021-01-11,1610319600.0
10768,52,1,2021-01-12,3170,0,10282,0,2021-01-12,1610406000.0
10769,52,1,2021-01-13,2983,0,13265,0,2021-01-13,1610492400.0
10770,52,1,2021-01-14,3304,0,16569,0,2021-01-14,1610578800.0
10771,52,1,2021-01-15,3016,0,19585,0,2021-01-15,1610665200.0
10772,52,1,2021-01-16,896,3,20481,3,2021-01-16,1610751600.0
10773,52,1,2021-01-17,499,3,20980,6,2021-01-17,1610838000.0
10774,52,1,2021-01-18,3197,5,24177,11,2021-01-18,1610924400.0
10775,52,1,2021-01-19,6555,4,30732,15,2021-01-19,1611010800.0
10776,52,1,2021-01-20,8339,6,39071,21,2021-01-20,1611097200.0
10777,52,1,2021-01-21,12171,3,51242,24,2021-01-21,1611183600.0
10778,52,1,2021-01-22,7273,21,58515,45,2021-01-22,1611270000.0
10779,52,1,2021-01-23,1678,3,60193,48,2021-01-23,1611356400.0
10780,52,1,2021-01-24,174,0,60367,48,2021-01-24,1611442800.0
10781,52,1,2021-01-25,3006,9,63373,57,2021-01-25,1611529200.0
10782,52,1,2021-01-26,6738,148,70111,205,2021-01-26,1611615600.0
10783,52,1,2021-01-27,7283,143,77394,348,2021-01-27,1611702000.0
10784,52,1,2021-01-28,9728,456,87122,804,2021-01-28,1611788400.0
10785,52,1,2021-01-29,5956,903,93078,1707,2021-01-29,1611874800.0
10786,52,1,2021-01-30,1259,271,94337,1978,2021-01-30,1611961200.0
10787,52,1,2021-01-31,79,314,94416,2292,2021-01-31,1612047600.0
10788,52,1,2021-02-01,2521,1189,96937,3481,2021-02-01,1612134000.0
10789,52,1,2021-02-02,2967,1857,99904,5338,2021-02-02,1612220400.0
10790,52,1,2021-02-03,2679,2159,102583,7497,2021-02-03,1612306800.0
10791,52,1,2021-02-04,2963,2110,105546,9607,2021-02-04,1612393200.0
10792,52,1,2021-02-05,2964,2203,108510,11810,2021-02-05,1612479600.0
10793,52,1,2021-02-06,1071,661,109581,12471,2021-02-06,1612566000.0
10794,52,1,2021-02-07,10,294,109591,12765,2021-02-07,1612652400.0
10795,52,1,2021-02-08,1756,2106,111347,14871,2021-02-08,1612738800.0
10796,52,1,2021-02-09,2788,3698,114135,18569,2021-02-09,1612825200.0
10797,52,1,2021-02-10,2903,4746,117038,23315,2021-02-10,1612911600.0
10798,52,1,2021-02-11,5059,9257,122097,32572,2021-02-11,1612998000.0
10799,52,1,2021-02-12,4050,5121,126147,37693,2021-02-12,1613084400.0
10800,52,1,2021-02-13,763,1238,126910,38931,2021-02-13,1613170800.0
10801,52,1,2021-02-14,22,541,126932,39472,2021-02-14,1613257200.0
10802,52,1,2021-02-15,1356,3514,128288,42986,2021-02-15,1613343600.0
10803,52,1,2021-02-16,2108,6703,130396,49689,2021-02-16,1613430000.0
10804,52,1,2021-02-17,2547,6916,132943,56605,2021-02-17,1613516400.0
10805,52,1,2021-02-18,4277,9228,137220,65833,2021-02-18,1613602800.0
10806,52,1,2021-02-19,3230,5767,140450,71600,2021-02-19,1613689200.0
10807,52,1,2021-02-20,592,1468,141042,73068,2021-02-20,1613775600.0
10808,52,1,2021-02-21,7,274,141049,73342,2021-02-21,1613862000.0
10809,52,1,2021-02-22,1758,3463,142807,76805,2021-02-22,1613948400.0
10810,52,1,2021-02-23,2016,3679,144823,80484,2021-02-23,1614034800.0
10811,52,1,2021-02-24,1708,3018,146531,83502,2021-02-24,1614121200.0
10812,52,1,2021-02-25,1729,3162,148260,86664,2021-02-25,1614207600.0
10813,52,1,2021-02-26,1664,2873,149924,89537,2021-02-26,1614294000.0
10814,52,1,2021-02-27,504,1037,150428,90574,2021-02-27,1614380400.0
10815,52,1,2021-02-28,39,87,150467,90661,2021-02-28,1614466800.0
10816,52,1,2021-03-01,1927,2307,152394,92968,2021-03-01,1614553200.0
10817,52,1,2021-03-02,2546,3401,154940,96369,2021-03-02,1614639600.0
10818,52,1,2021-03-03,2373,3368,157313,99737,2021-03-03,1614726000.0
10819,52,1,2021-03-04,3028,4687,160341,104424,2021-03-04,1614812400.0
10820,52,1,2021-03-05,2981,3820,163322,108244,2021-03-05,1614898800.0
10821,52,1,2021-03-06,981,1094,164303,109338,2021-03-06,1614985200.0
10822,52,1,2021-03-07,3,104,164306,109442,2021-03-07,1615071600.0
10823,52,1,2021-03-08,2811,2366,167117,111808,2021-03-08,1615158000.0
10824,52,1,2021-03-09,3880,3226,170997,115034,2021-03-09,1615244400.0
10825,52,1,2021-03-10,3678,3251,174675,118285,2021-03-10,1615330800.0
10826,52,1,2021-03-11,5049,4838,179724,123123,2021-03-11,1615417200.0
10827,52,1,2021-03-12,4517,3496,184241,126619,2021-03-12,1615503600.0
10828,52,1,2021-03-13,2011,691,186252,127310,2021-03-13,1615590000.0
10829,52,1,2021-03-14,422,72,186674,127382,2021-03-14,1615676400.0
10830,52,1,2021-03-15,5540,1775,192214,129157,2021-03-15,1615762800.0
10831,52,1,2021-03-16,6614,1729,198828,130886,2021-03-16,1615849200.0
10832,52,1,2021-03-17,5780,1810,204608,132696,2021-03-17,1615935600.0
10833,52,1,2021-03-18,6895,1881,211503,134577,2021-03-18,1616022000.0
10834,52,1,2021-03-19,6388,1610,217891,136187,2021-03-19,1616108400.0
10835,52,1,2021-03-20,2397,527,220288,136714,2021-03-20,1616194800.0
10836,52,1,2021-03-21,911,26,221199,136740,2021-03-21,1616281200.0
10837,52,1,2021-03-22,6188,1786,227387,138526,2021-03-22,1616367600.0
10838,52,1,2021-03-23,7567,2017,234954,140543,2021-03-23,1616454000.0
10839,52,1,2021-03-24,6526,1717,241480,142260,2021-03-24,1616540400.0
10840,52,1,2021-03-25,7548,1803,249028,144063,2021-03-25,1616626800.0
10841,52,1,2021-03-26,7107,1819,256135,145882,2021-03-26,1616713200.0
10842,52,1,2021-03-27,3413,547,259548,146429,2021-03-27,1616799600.0
10843,52,1,2021-03-28,1887,36,261435,146465,2021-03-28,1616886000.0
10844,52,1,2021-03-29,6747,2505,268182,148970,2021-03-29,1616972400.0
10845,52,1,2021-03-30,8973,3149,277155,152119,2021-03-30,1617058800.0
10846,52,1,2021-03-31,9280,2741,286435,154860,2021-03-31,1617145200.0
10847,52,1,2021-04-01,11821,3001,298256,157861,2021-04-01,1617231600.0
10848,52,1,2021-04-02,10019,2892,308275,160753,2021-04-02,1617318000.0
10849,52,1,2021-04-03,3131,1155,311406,161908,2021-04-03,1617404400.0
10850,52,1,2021-04-04,1279,31,312685,161939,2021-04-04,1617490800.0
10851,52,1,2021-04-05,1745,507,314430,162446,2021-04-05,1617577200.0
10852,52,1,2021-04-06,9208,4559,323638,167005,2021-04-06,1617663600.0
10853,52,1,2021-04-07,11942,4666,335580,171671,2021-04-07,1617750000.0
10854,52,1,2021-04-08,13355,4879,348935,176550,2021-04-08,1617836400.0
10855,52,1,2021-04-09,14090,4304,363025,180854,2021-04-09,1617922800.0
10856,52,1,2021-04-10,5354,2130,368379,182984,2021-04-10,1618009200.0
10857,52,1,2021-04-11,2251,386,370630,183370,2021-04-11,1618095600.0
10858,52,1,2021-04-12,11442,6090,382072,189460,2021-04-12,1618185600.0
10859,52,1,2021-04-13,12599,6778,394671,196238,2021-04-13,1618272000.0
10860,52,1,2021-04-14,11478,5741,406149,201979,2021-04-14,1618358400.0
10861,52,1,2021-04-15,11974,6393,418123,208372,2021-04-15,1618444800.0
10862,52,1,2021-04-16,12637,5929,430760,214301,2021-04-16,1618531200.0
10863,52,1,2021-04-17,5453,2090,436213,216391,2021-04-17,1618617600.0
10864,52,1,2021-04-18,1587,866,437800,217257,2021-04-18,1618704000.0
10865,52,1,2021-04-19,11579,6584,449379,223841,2021-04-19,1618790400.0
10866,52,1,2021-04-20,13156,7976,462535,231817,2021-04-20,1618876800.0
10867,52,1,2021-04-21,12112,7505,474647,239322,2021-04-21,1618963200.0
10868,52,1,2021-04-22,13641,8503,488288,247825,2021-04-22,1619049600.0
10869,52,1,2021-04-23,13111,7942,501399,255767,2021-04-23,1619136000.0
10870,52,1,2021-04-24,6817,3935,508216,259702,2021-04-24,1619222400.0
10871,52,1,2021-04-25,3430,1633,511646,261335,2021-04-25,1619308800.0
10872,52,1,2021-04-26,13486,8202,525132,269537,2021-04-26,1619395200.0
10873,52,1,2021-04-27,15943,10289,541075,279826,2021-04-27,1619481600.0
10874,52,1,2021-04-28,18378,8281,559453,288107,2021-04-28,1619568000.0
10875,52,1,2021-04-29,18190,9283,577643,297390,2021-04-29,1619654400.0
10876,52,1,2021-04-30,17436,8920,595079,306310,2021-04-30,1619740800.0
10877,52,1,2021-05-01,7307,1495,602386,307805,2021-05-01,1619827200.0
10878,52,1,2021-05-02,3933,1062,606319,308867,2021-05-02,1619913600.0
10879,52,1,2021-05-03,16408,9140,622727,318007,2021-05-03,1620000000.0
10880,52,1,2021-05-04,16344,12035,639071,330042,2021-05-04,1620086400.0
10881,52,1,2021-05-05,17885,10251,656956,340293,2021-05-05,1620172800.0
10882,52,1,2021-05-06,16838,10194,673794,350487,2021-05-06,1620259200.0
10883,52,1,2021-05-07,13535,13290,687329,363777,2021-05-07,1620345600.0
10884,52,1,2021-05-08,8599,1303,695928,365080,2021-05-08,1620432000.0
10885,52,1,2021-05-09,4686,1742,700614,366822,2021-05-09,1620518400.0
10886,52,1,2021-05-10,15369,13613,715983,380435,2021-05-10,1620604800.0
10887,52,1,2021-05-11,17607,14343,733590,394778,2021-05-11,1620691200.0
10888,52,1,2021-05-12,18542,12064,752132,406842,2021-05-12,1620777600.0
10889,52,1,2021-05-13,15110,1633,767242,408475,2021-05-13,1620864000.0
10890,52,1,2021-05-14,17507,9578,784749,418053,2021-05-14,1620950400.0
10891,52,1,2021-05-15,11243,3644,795992,421697,2021-05-15,1621036800.0
10892,52,1,2021-05-16,4734,767,800726,422464,2021-05-16,1621123200.0
10893,52,1,2021-05-17,18772,11035,819498,433499,2021-05-17,1621206000.0
10894,52,1,2021-05-18,22011,10340,841509,443839,2021-05-18,1621292400.0
10895,52,1,2021-05-19,24377,7588,865886,451427,2021-05-19,1621378800.0
10896,52,1,2021-05-20,26490,6321,892376,457748,2021-05-20,1621465200.0
10897,52,1,2021-05-21,24100,7281,916476,465029,2021-05-21,1621551600.0
10898,52,1,2021-05-22,14276,2423,930752,467452,2021-05-22,1621638000.0
10899,52,1,2021-05-23,4108,872,934860,468324,2021-05-23,1621724400.0
10900,52,1,2021-05-24,15927,1866,950787,470190,2021-05-24,1621810800.0
10901,52,1,2021-05-25,22758,10108,973545,480298,2021-05-25,1621897200.0
10902,52,1,2021-05-26,23722,7394,997267,487692,2021-05-26,1621983600.0
10903,52,1,2021-05-27,26963,6767,1024230,494459,2021-05-27,1622070000.0
10904,52,1,2021-05-28,23855,8358,1048085,502817,2021-05-28,1622156400.0
10905,52,1,2021-05-29,16155,3729,1064240,506546,2021-05-29,1622242800.0
10906,52,1,2021-05-30,4097,1461,1068337,508007,2021-05-30,1622329200.0
10907,52,1,2021-05-31,21485,10715,1089822,518722,2021-05-31,1622415600.0
10908,52,1,2021-06-01,24312,10066,1114134,528788,2021-06-01,1622502000.0
10909,52,1,2021-06-02,24235,8772,1138369,537560,2021-06-02,1622588400.0
10910,52,1,2021-06-03,27998,7315,1166367,544875,2021-06-03,1622674800.0
10911,52,1,2021-06-04,24008,10196,1190375,555071,2021-06-04,1622761200.0
10912,52,1,2021-06-05,12523,6884,1202898,561955,2021-06-05,1622847600.0
10913,52,1,2021-06-06,4692,2411,1207590,564366,2021-06-06,1622934000.0
10914,52,1,2021-06-07,19250,15537,1226840,579903,2021-06-07,1623020400.0
10915,52,1,2021-06-08,22369,15240,1249209,595143,2021-06-08,1623106800.0
10916,52,1,2021-06-09,22965,12573,1272174,607716,2021-06-09,1623193200.0
10917,52,1,2021-06-10,25505,9885,1297679,617601,2021-06-10,1623279600.0
10918,52,1,2021-06-11,21954,13707,1319633,631308,2021-06-11,1623366000.0
10919,52,1,2021-06-12,11916,7876,1331549,639184,2021-06-12,1623452400.0
10920,52,1,2021-06-13,4340,3026,1335889,642210,2021-06-13,1623538800.0
10921,52,1,2021-06-14,15491,19394,1351380,661604,2021-06-14,1623625200.0
10922,52,1,2021-06-15,20346,16060,1371726,677664,2021-06-15,1623711600.0
10923,52,1,2021-06-16,20561,14822,1392287,692486,2021-06-16,1623798000.0
10924,52,1,2021-06-17,22993,12428,1415280,704914,2021-06-17,1623884400.0
10925,52,1,2021-06-18,19510,16300,1434790,721214,2021-06-18,1623970800.0
10926,52,1,2021-06-19,10606,8876,1445396,730090,2021-06-19,1624057200.0
10927,52,1,2021-06-20,2930,2930,1448326,733020,2021-06-20,1624143600.0
10928,52,1,2021-06-21,13397,21418,1461723,754438,2021-06-21,1624230000.0
10929,52,1,2021-06-22,15150,21021,1476873,775459,2021-06-22,1624316400.0
10930,52,1,2021-06-23,16704,18086,1493577,793545,2021-06-23,1624402800.0
10931,52,1,2021-06-24,18883,13049,1512460,806594,2021-06-24,1624489200.0
10932,52,1,2021-06-25,13843,19907,1526303,826501,2021-06-25,1624575600.0
10933,52,1,2021-06-26,7385,11776,1533688,838277,2021-06-26,1624662000.0
10934,52,1,2021-06-27,1258,3702,1534946,841979,2021-06-27,1624748400.0
10935,52,1,2021-06-28,9537,25998,1544483,867977,2021-06-28,1624834800.0
10936,52,1,2021-06-29,11436,26723,1555919,894700,2021-06-29,1624921200.0
10937,52,1,2021-06-30,12360,22912,1568279,917612,2021-06-30,1625007600.0
10938,52,1,2021-07-01,14436,20669,1582715,938281,2021-07-01,1625094000.0
10939,52,1,2021-07-02,12548,23225,1595263,961506,2021-07-02,1625180400.0
10940,52,1,2021-07-03,6472,15514,1601735,977020,2021-07-03,1625266800.0
10941,52,1,2021-07-04,1626,4906,1603361,981926,2021-07-04,1625353200.0
10942,52,1,2021-07-05,8742,26336,1612103,1008262,2021-07-05,1625439600.0
10943,52,1,2021-07-06,10394,27001,1622497,1035263,2021-07-06,1625526000.0
10944,52,2,2020-12-27,0,0,0,0,2020-12-27,1609023600.0
10945,52,2,2020-12-28,0,0,0,0,2020-12-28,1609110000.0
10946,52,2,2020-12-29,0,0,0,0,2020-12-29,1609196400.0
10947,52,2,2020-12-30,0,0,0,0,2020-12-30,1609282800.0
10948,52,2,2020-12-31,0,0,0,0,2020-12-31,1609369200.0
10949,52,2,2021-01-01,0,0,0,0,2021-01-01,1609455600.0
10950,52,2,2021-01-02,0,0,0,0,2021-01-02,1609542000.0
10951,52,2,2021-01-03,0,0,0,0,2021-01-03,1609628400.0
10952,52,2,2021-01-04,0,0,0,0,2021-01-04,1609714800.0
10953,52,2,2021-01-05,0,0,0,0,2021-01-05,1609801200.0
10954,52,2,2021-01-06,0,0,0,0,2021-01-06,1609887600.0
10955,52,2,2021-01-07,0,0,0,0,2021-01-07,1609974000.0
10956,52,2,2021-01-08,0,0,0,0,2021-01-08,1610060400.0
10957,52,2,2021-01-09,0,0,0,0,2021-01-09,1610146800.0
10958,52,2,2021-01-10,0,0,0,0,2021-01-10,1610233200.0
10959,52,2,2021-01-11,0,0,0,0,2021-01-11,1610319600.0
10960,52,2,2021-01-12,0,0,0,0,2021-01-12,1610406000.0
10961,52,2,2021-01-13,0,0,0,0,2021-01-13,1610492400.0
10962,52,2,2021-01-14,0,0,0,0,2021-01-14,1610578800.0
10963,52,2,2021-01-15,0,0,0,0,2021-01-15,1610665200.0
10964,52,2,2021-01-16,0,0,0,0,2021-01-16,1610751600.0
10965,52,2,2021-01-17,0,0,0,0,2021-01-17,1610838000.0
10966,52,2,2021-01-18,2,0,2,0,2021-01-18,1610924400.0
10967,52,2,2021-01-19,1,0,3,0,2021-01-19,1611010800.0
10968,52,2,2021-01-20,1,0,4,0,2021-01-20,1611097200.0
10969,52,2,2021-01-21,1,0,5,0,2021-01-21,1611183600.0
10970,52,2,2021-01-22,0,0,5,0,2021-01-22,1611270000.0
10971,52,2,2021-01-23,0,0,5,0,2021-01-23,1611356400.0
10972,52,2,2021-01-24,0,0,5,0,2021-01-24,1611442800.0
10973,52,2,2021-01-25,0,0,5,0,2021-01-25,1611529200.0
10974,52,2,2021-01-26,0,0,5,0,2021-01-26,1611615600.0
10975,52,2,2021-01-27,2,0,7,0,2021-01-27,1611702000.0
10976,52,2,2021-01-28,0,0,7,0,2021-01-28,1611788400.0
10977,52,2,2021-01-29,0,0,7,0,2021-01-29,1611874800.0
10978,52,2,2021-01-30,0,0,7,0,2021-01-30,1611961200.0
10979,52,2,2021-01-31,0,0,7,0,2021-01-31,1612047600.0
10980,52,2,2021-02-01,0,0,7,0,2021-02-01,1612134000.0
10981,52,2,2021-02-02,3,0,10,0,2021-02-02,1612220400.0
10982,52,2,2021-02-03,7,0,17,0,2021-02-03,1612306800.0
10983,52,2,2021-02-04,0,0,17,0,2021-02-04,1612393200.0
10984,52,2,2021-02-05,0,0,17,0,2021-02-05,1612479600.0
10985,52,2,2021-02-06,0,0,17,0,2021-02-06,1612566000.0
10986,52,2,2021-02-07,0,0,17,0,2021-02-07,1612652400.0
10987,52,2,2021-02-08,0,2,17,2,2021-02-08,1612738800.0
10988,52,2,2021-02-09,1,0,18,2,2021-02-09,1612825200.0
10989,52,2,2021-02-10,71,0,89,2,2021-02-10,1612911600.0
10990,52,2,2021-02-11,136,1,225,3,2021-02-11,1612998000.0
10991,52,2,2021-02-12,169,0,394,3,2021-02-12,1613084400.0
10992,52,2,2021-02-13,24,0,418,3,2021-02-13,1613170800.0
10993,52,2,2021-02-14,0,0,418,3,2021-02-14,1613257200.0
10994,52,2,2021-02-15,53,0,471,3,2021-02-15,1613343600.0
10995,52,2,2021-02-16,748,0,1219,3,2021-02-16,1613430000.0
10996,52,2,2021-02-17,580,2,1799,5,2021-02-17,1613516400.0
10997,52,2,2021-02-18,625,1,2424,6,2021-02-18,1613602800.0
10998,52,2,2021-02-19,686,0,3110,6,2021-02-19,1613689200.0
10999,52,2,2021-02-20,152,0,3262,6,2021-02-20,1613775600.0
11000,52,2,2021-02-21,0,0,3262,6,2021-02-21,1613862000.0
11001,52,2,2021-02-22,259,1,3521,7,2021-02-22,1613948400.0
11002,52,2,2021-02-23,517,0,4038,7,2021-02-23,1614034800.0
11003,52,2,2021-02-24,425,0,4463,7,2021-02-24,1614121200.0
11004,52,2,2021-02-25,815,0,5278,7,2021-02-25,1614207600.0
11005,52,2,2021-02-26,318,1,5596,8,2021-02-26,1614294000.0
11006,52,2,2021-02-27,2,0,5598,8,2021-02-27,1614380400.0
11007,52,2,2021-02-28,0,0,5598,8,2021-02-28,1614466800.0
11008,52,2,2021-03-01,130,0,5728,8,2021-03-01,1614553200.0
11009,52,2,2021-03-02,135,1,5863,9,2021-03-02,1614639600.0
11010,52,2,2021-03-03,244,0,6107,9,2021-03-03,1614726000.0
11011,52,2,2021-03-04,395,0,6502,9,2021-03-04,1614812400.0
11012,52,2,2021-03-05,270,0,6772,9,2021-03-05,1614898800.0
11013,52,2,2021-03-06,1,0,6773,9,2021-03-06,1614985200.0
11014,52,2,2021-03-07,0,0,6773,9,2021-03-07,1615071600.0
11015,52,2,2021-03-08,255,0,7028,9,2021-03-08,1615158000.0
11016,52,2,2021-03-09,944,0,7972,9,2021-03-09,1615244400.0
11017,52,2,2021-03-10,556,61,8528,70,2021-03-10,1615330800.0
11018,52,2,2021-03-11,1045,64,9573,134,2021-03-11,1615417200.0
11019,52,2,2021-03-12,396,110,9969,244,2021-03-12,1615503600.0
11020,52,2,2021-03-13,13,8,9982,252,2021-03-13,1615590000.0
11021,52,2,2021-03-14,0,0,9982,252,2021-03-14,1615676400.0
11022,52,2,2021-03-15,334,52,10316,304,2021-03-15,1615762800.0
11023,52,2,2021-03-16,925,814,11241,1118,2021-03-16,1615849200.0
11024,52,2,2021-03-17,658,526,11899,1644,2021-03-17,1615935600.0
11025,52,2,2021-03-18,1353,521,13252,2165,2021-03-18,1616022000.0
11026,52,2,2021-03-19,1391,395,14643,2560,2021-03-19,1616108400.0
11027,52,2,2021-03-20,849,169,15492,2729,2021-03-20,1616194800.0
11028,52,2,2021-03-21,538,0,16030,2729,2021-03-21,1616281200.0
11029,52,2,2021-03-22,877,145,16907,2874,2021-03-22,1616367600.0
11030,52,2,2021-03-23,1147,409,18054,3283,2021-03-23,1616454000.0
11031,52,2,2021-03-24,1299,200,19353,3483,2021-03-24,1616540400.0
11032,52,2,2021-03-25,1643,805,20996,4288,2021-03-25,1616626800.0
11033,52,2,2021-03-26,1694,342,22690,4630,2021-03-26,1616713200.0
11034,52,2,2021-03-27,633,31,23323,4661,2021-03-27,1616799600.0
11035,52,2,2021-03-28,152,17,23475,4678,2021-03-28,1616886000.0
11036,52,2,2021-03-29,1122,115,24597,4793,2021-03-29,1616972400.0
11037,52,2,2021-03-30,1128,246,25725,5039,2021-03-30,1617058800.0
11038,52,2,2021-03-31,1190,289,26915,5328,2021-03-31,1617145200.0
11039,52,2,2021-04-01,1516,365,28431,5693,2021-04-01,1617231600.0
11040,52,2,2021-04-02,1402,330,29833,6023,2021-04-02,1617318000.0
11041,52,2,2021-04-03,515,1,30348,6024,2021-04-03,1617404400.0
11042,52,2,2021-04-04,1,12,30349,6036,2021-04-04,1617490800.0
11043,52,2,2021-04-05,2,1,30351,6037,2021-04-05,1617577200.0
11044,52,2,2021-04-06,991,511,31342,6548,2021-04-06,1617663600.0
11045,52,2,2021-04-07,1059,736,32401,7284,2021-04-07,1617750000.0
11046,52,2,2021-04-08,1507,1109,33908,8393,2021-04-08,1617836400.0
11047,52,2,2021-04-09,1327,506,35235,8899,2021-04-09,1617922800.0
11048,52,2,2021-04-10,406,86,35641,8985,2021-04-10,1618009200.0
11049,52,2,2021-04-11,183,20,35824,9005,2021-04-11,1618095600.0
11050,52,2,2021-04-12,1216,201,37040,9206,2021-04-12,1618185600.0
11051,52,2,2021-04-13,1815,1010,38855,10216,2021-04-13,1618272000.0
11052,52,2,2021-04-14,1510,791,40365,11007,2021-04-14,1618358400.0
11053,52,2,2021-04-15,1856,1214,42221,12221,2021-04-15,1618444800.0
11054,52,2,2021-04-16,1649,1072,43870,13293,2021-04-16,1618531200.0
11055,52,2,2021-04-17,729,785,44599,14078,2021-04-17,1618617600.0
11056,52,2,2021-04-18,19,381,44618,14459,2021-04-18,1618704000.0
11057,52,2,2021-04-19,885,972,45503,15431,2021-04-19,1618790400.0
11058,52,2,2021-04-20,1238,1072,46741,16503,2021-04-20,1618876800.0
11059,52,2,2021-04-21,996,1240,47737,17743,2021-04-21,1618963200.0
11060,52,2,2021-04-22,1199,1205,48936,18948,2021-04-22,1619049600.0
11061,52,2,2021-04-23,1697,1502,50633,20450,2021-04-23,1619136000.0
11062,52,2,2021-04-24,568,703,51201,21153,2021-04-24,1619222400.0
11063,52,2,2021-04-25,264,206,51465,21359,2021-04-25,1619308800.0
11064,52,2,2021-04-26,1687,1037,53152,22396,2021-04-26,1619395200.0
11065,52,2,2021-04-27,1613,972,54765,23368,2021-04-27,1619481600.0
11066,52,2,2021-04-28,1391,1158,56156,24526,2021-04-28,1619568000.0
11067,52,2,2021-04-29,1904,1282,58060,25808,2021-04-29,1619654400.0
11068,52,2,2021-04-30,2607,1349,60667,27157,2021-04-30,1619740800.0
11069,52,2,2021-05-01,778,611,61445,27768,2021-05-01,1619827200.0
11070,52,2,2021-05-02,338,64,61783,27832,2021-05-02,1619913600.0
11071,52,2,2021-05-03,1187,631,62970,28463,2021-05-03,1620000000.0
11072,52,2,2021-05-04,1105,1026,64075,29489,2021-05-04,1620086400.0
11073,52,2,2021-05-05,1171,1013,65246,30502,2021-05-05,1620172800.0
11074,52,2,2021-05-06,1751,1241,66997,31743,2021-05-06,1620259200.0
11075,52,2,2021-05-07,2451,1497,69448,33240,2021-05-07,1620345600.0
11076,52,2,2021-05-08,2197,293,71645,33533,2021-05-08,1620432000.0
11077,52,2,2021-05-09,670,310,72315,33843,2021-05-09,1620518400.0
11078,52,2,2021-05-10,3619,2148,75934,35991,2021-05-10,1620604800.0
11079,52,2,2021-05-11,3899,2171,79833,38162,2021-05-11,1620691200.0
11080,52,2,2021-05-12,4281,2266,84114,40428,2021-05-12,1620777600.0
11081,52,2,2021-05-13,3336,344,87450,40772,2021-05-13,1620864000.0
11082,52,2,2021-05-14,3914,788,91364,41560,2021-05-14,1620950400.0
11083,52,2,2021-05-15,3906,272,95270,41832,2021-05-15,1621036800.0
11084,52,2,2021-05-16,5511,51,100781,41883,2021-05-16,1621123200.0
11085,52,2,2021-05-17,1419,1070,102200,42953,2021-05-17,1621206000.0
11086,52,2,2021-05-18,982,1029,103182,43982,2021-05-18,1621292400.0
11087,52,2,2021-05-19,1243,527,104425,44509,2021-05-19,1621378800.0
11088,52,2,2021-05-20,1262,638,105687,45147,2021-05-20,1621465200.0
11089,52,2,2021-05-21,1433,1203,107120,46350,2021-05-21,1621551600.0
11090,52,2,2021-05-22,690,125,107810,46475,2021-05-22,1621638000.0
11091,52,2,2021-05-23,328,20,108138,46495,2021-05-23,1621724400.0
11092,52,2,2021-05-24,60,107,108198,46602,2021-05-24,1621810800.0
11093,52,2,2021-05-25,829,843,109027,47445,2021-05-25,1621897200.0
11094,52,2,2021-05-26,762,756,109789,48201,2021-05-26,1621983600.0
11095,52,2,2021-05-27,749,1414,110538,49615,2021-05-27,1622070000.0
11096,52,2,2021-05-28,1651,1457,112189,51072,2021-05-28,1622156400.0
11097,52,2,2021-05-29,1384,353,113573,51425,2021-05-29,1622242800.0
11098,52,2,2021-05-30,113,14,113686,51439,2021-05-30,1622329200.0
11099,52,2,2021-05-31,1990,1091,115676,52530,2021-05-31,1622415600.0
11100,52,2,2021-06-01,3161,1539,118837,54069,2021-06-01,1622502000.0
11101,52,2,2021-06-02,2209,1245,121046,55314,2021-06-02,1622588400.0
11102,52,2,2021-06-03,2305,1218,123351,56532,2021-06-03,1622674800.0
11103,52,2,2021-06-04,3545,1594,126896,58126,2021-06-04,1622761200.0
11104,52,2,2021-06-05,1557,1015,128453,59141,2021-06-05,1622847600.0
11105,52,2,2021-06-06,60,523,128513,59664,2021-06-06,1622934000.0
11106,52,2,2021-06-07,1842,1674,130355,61338,2021-06-07,1623020400.0
11107,52,2,2021-06-08,3030,1688,133385,63026,2021-06-08,1623106800.0
11108,52,2,2021-06-09,1732,1281,135117,64307,2021-06-09,1623193200.0
11109,52,2,2021-06-10,2192,1243,137309,65550,2021-06-10,1623279600.0
11110,52,2,2021-06-11,3764,2233,141073,67783,2021-06-11,1623366000.0
11111,52,2,2021-06-12,2223,910,143296,68693,2021-06-12,1623452400.0
11112,52,2,2021-06-13,42,1163,143338,69856,2021-06-13,1623538800.0
11113,52,2,2021-06-14,1657,1802,144995,71658,2021-06-14,1623625200.0
11114,52,2,2021-06-15,2594,1622,147589,73280,2021-06-15,1623711600.0
11115,52,2,2021-06-16,2025,1444,149614,74724,2021-06-16,1623798000.0
11116,52,2,2021-06-17,2124,1551,151738,76275,2021-06-17,1623884400.0
11117,52,2,2021-06-18,2932,2537,154670,78812,2021-06-18,1623970800.0
11118,52,2,2021-06-19,1516,2526,156186,81338,2021-06-19,1624057200.0
11119,52,2,2021-06-20,72,1268,156258,82606,2021-06-20,1624143600.0
11120,52,2,2021-06-21,1110,3418,157368,86024,2021-06-21,1624230000.0
11121,52,2,2021-06-22,1737,3892,159105,89916,2021-06-22,1624316400.0
11122,52,2,2021-06-23,1274,3801,160379,93717,2021-06-23,1624402800.0
11123,52,2,2021-06-24,1566,3231,161945,96948,2021-06-24,1624489200.0
11124,52,2,2021-06-25,2249,2863,164194,99811,2021-06-25,1624575600.0
11125,52,2,2021-06-26,793,3697,164987,103508,2021-06-26,1624662000.0
11126,52,2,2021-06-27,56,3519,165043,107027,2021-06-27,1624748400.0
11127,52,2,2021-06-28,797,1803,165840,108830,2021-06-28,1624834800.0
11128,52,2,2021-06-29,1522,1899,167362,110729,2021-06-29,1624921200.0
11129,52,2,2021-06-30,854,1319,168216,112048,2021-06-30,1625007600.0
11130,52,2,2021-07-01,1063,1464,169279,113512,2021-07-01,1625094000.0
11131,52,2,2021-07-02,1536,1818,170815,115330,2021-07-02,1625180400.0
11132,52,2,2021-07-03,578,911,171393,116241,2021-07-03,1625266800.0
11133,52,2,2021-07-04,57,112,171450,116353,2021-07-04,1625353200.0
11134,52,2,2021-07-05,510,1039,171960,117392,2021-07-05,1625439600.0
11135,52,2,2021-07-06,660,1526,172620,118918,2021-07-06,1625526000.0
11136,52,3,2020-12-27,0,0,0,0,2020-12-27,1609023600.0
11137,52,3,2020-12-28,0,0,0,0,2020-12-28,1609110000.0
11138,52,3,2020-12-29,0,0,0,0,2020-12-29,1609196400.0
11139,52,3,2020-12-30,0,0,0,0,2020-12-30,1609282800.0
11140,52,3,2020-12-31,0,0,0,0,2020-12-31,1609369200.0
11141,52,3,2021-01-01,0,0,0,0,2021-01-01,1609455600.0
11142,52,3,2021-01-02,0,0,0,0,2021-01-02,1609542000.0
11143,52,3,2021-01-03,0,0,0,0,2021-01-03,1609628400.0
11144,52,3,2021-01-04,0,0,0,0,2021-01-04,1609714800.0
11145,52,3,2021-01-05,0,0,0,0,2021-01-05,1609801200.0
11146,52,3,2021-01-06,0,0,0,0,2021-01-06,1609887600.0
11147,52,3,2021-01-07,0,0,0,0,2021-01-07,1609974000.0
11148,52,3,2021-01-08,0,0,0,0,2021-01-08,1610060400.0
11149,52,3,2021-01-09,0,0,0,0,2021-01-09,1610146800.0
11150,52,3,2021-01-10,0,0,0,0,2021-01-10,1610233200.0
11151,52,3,2021-01-11,0,0,0,0,2021-01-11,1610319600.0
11152,52,3,2021-01-12,0,0,0,0,2021-01-12,1610406000.0
11153,52,3,2021-01-13,0,0,0,0,2021-01-13,1610492400.0
11154,52,3,2021-01-14,0,0,0,0,2021-01-14,1610578800.0
11155,52,3,2021-01-15,0,0,0,0,2021-01-15,1610665200.0
11156,52,3,2021-01-16,0,0,0,0,2021-01-16,1610751600.0
11157,52,3,2021-01-17,0,0,0,0,2021-01-17,1610838000.0
11158,52,3,2021-01-18,0,0,0,0,2021-01-18,1610924400.0
11159,52,3,2021-01-19,0,0,0,0,2021-01-19,1611010800.0
11160,52,3,2021-01-20,0,0,0,0,2021-01-20,1611097200.0
11161,52,3,2021-01-21,0,0,0,0,2021-01-21,1611183600.0
11162,52,3,2021-01-22,0,0,0,0,2021-01-22,1611270000.0
11163,52,3,2021-01-23,0,0,0,0,2021-01-23,1611356400.0
11164,52,3,2021-01-24,0,0,0,0,2021-01-24,1611442800.0
11165,52,3,2021-01-25,0,0,0,0,2021-01-25,1611529200.0
11166,52,3,2021-01-26,0,0,0,0,2021-01-26,1611615600.0
11167,52,3,2021-01-27,0,0,0,0,2021-01-27,1611702000.0
11168,52,3,2021-01-28,0,0,0,0,2021-01-28,1611788400.0
11169,52,3,2021-01-29,0,0,0,0,2021-01-29,1611874800.0
11170,52,3,2021-01-30,0,0,0,0,2021-01-30,1611961200.0
11171,52,3,2021-01-31,0,0,0,0,2021-01-31,1612047600.0
11172,52,3,2021-02-01,0,0,0,0,2021-02-01,1612134000.0
11173,52,3,2021-02-02,0,0,0,0,2021-02-02,1612220400.0
11174,52,3,2021-02-03,0,0,0,0,2021-02-03,1612306800.0
11175,52,3,2021-02-04,0,0,0,0,2021-02-04,1612393200.0
11176,52,3,2021-02-05,0,0,0,0,2021-02-05,1612479600.0
11177,52,3,2021-02-06,5,0,5,0,2021-02-06,1612566000.0
11178,52,3,2021-02-07,141,0,146,0,2021-02-07,1612652400.0
11179,52,3,2021-02-08,173,0,319,0,2021-02-08,1612738800.0
11180,52,3,2021-02-09,385,0,704,0,2021-02-09,1612825200.0
11181,52,3,2021-02-10,348,0,1052,0,2021-02-10,1612911600.0
11182,52,3,2021-02-11,905,0,1957,0,2021-02-11,1612998000.0
11183,52,3,2021-02-12,485,0,2442,0,2021-02-12,1613084400.0
11184,52,3,2021-02-13,363,0,2805,0,2021-02-13,1613170800.0
11185,52,3,2021-02-14,0,0,2805,0,2021-02-14,1613257200.0
11186,52,3,2021-02-15,619,0,3424,0,2021-02-15,1613343600.0
11187,52,3,2021-02-16,1265,0,4689,0,2021-02-16,1613430000.0
11188,52,3,2021-02-17,749,0,5438,0,2021-02-17,1613516400.0
11189,52,3,2021-02-18,1238,0,6676,0,2021-02-18,1613602800.0
11190,52,3,2021-02-19,1416,0,8092,0,2021-02-19,1613689200.0
11191,52,3,2021-02-20,284,0,8376,0,2021-02-20,1613775600.0
11192,52,3,2021-02-21,0,0,8376,0,2021-02-21,1613862000.0
11193,52,3,2021-02-22,630,0,9006,0,2021-02-22,1613948400.0
11194,52,3,2021-02-23,892,0,9898,0,2021-02-23,1614034800.0
11195,52,3,2021-02-24,1171,0,11069,0,2021-02-24,1614121200.0
11196,52,3,2021-02-25,3800,0,14869,0,2021-02-25,1614207600.0
11197,52,3,2021-02-26,4232,0,19101,0,2021-02-26,1614294000.0
11198,52,3,2021-02-27,1710,0,20811,0,2021-02-27,1614380400.0
11199,52,3,2021-02-28,37,0,20848,0,2021-02-28,1614466800.0
11200,52,3,2021-03-01,1057,0,21905,0,2021-03-01,1614553200.0
11201,52,3,2021-03-02,2042,2,23947,2,2021-03-02,1614639600.0
11202,52,3,2021-03-03,2665,1,26612,3,2021-03-03,1614726000.0
11203,52,3,2021-03-04,4372,3,30984,6,2021-03-04,1614812400.0
11204,52,3,2021-03-05,5757,1,36741,7,2021-03-05,1614898800.0
11205,52,3,2021-03-06,4655,1,41396,8,2021-03-06,1614985200.0
11206,52,3,2021-03-07,2658,1,44054,9,2021-03-07,1615071600.0
11207,52,3,2021-03-08,2779,0,46833,9,2021-03-08,1615158000.0
11208,52,3,2021-03-09,4722,1,51555,10,2021-03-09,1615244400.0
11209,52,3,2021-03-10,5153,1,56708,11,2021-03-10,1615330800.0
11210,52,3,2021-03-11,7480,3,64188,14,2021-03-11,1615417200.0
11211,52,3,2021-03-12,10418,6,74606,20,2021-03-12,1615503600.0
11212,52,3,2021-03-13,6263,1,80869,21,2021-03-13,1615590000.0
11213,52,3,2021-03-14,202,0,81071,21,2021-03-14,1615676400.0
11214,52,3,2021-03-15,2958,0,84029,21,2021-03-15,1615762800.0
11215,52,3,2021-03-16,35,1,84064,22,2021-03-16,1615849200.0
11216,52,3,2021-03-17,19,1,84083,23,2021-03-17,1615935600.0
11217,52,3,2021-03-18,56,1,84139,24,2021-03-18,1616022000.0
11218,52,3,2021-03-19,4112,2,88251,26,2021-03-19,1616108400.0
11219,52,3,2021-03-20,3841,0,92092,26,2021-03-20,1616194800.0
11220,52,3,2021-03-21,240,0,92332,26,2021-03-21,1616281200.0
11221,52,3,2021-03-22,1948,2,94280,28,2021-03-22,1616367600.0
11222,52,3,2021-03-23,4466,0,98746,28,2021-03-23,1616454000.0
11223,52,3,2021-03-24,5432,1,104178,29,2021-03-24,1616540400.0
11224,52,3,2021-03-25,9007,4,113185,33,2021-03-25,1616626800.0
11225,52,3,2021-03-26,10133,2,123318,35,2021-03-26,1616713200.0
11226,52,3,2021-03-27,3506,5,126824,40,2021-03-27,1616799600.0
11227,52,3,2021-03-28,155,0,126979,40,2021-03-28,1616886000.0
11228,52,3,2021-03-29,3102,0,130081,40,2021-03-29,1616972400.0
11229,52,3,2021-03-30,5579,1,135660,41,2021-03-30,1617058800.0
11230,52,3,2021-03-31,3223,1,138883,42,2021-03-31,1617145200.0
11231,52,3,2021-04-01,5533,5,144416,47,2021-04-01,1617231600.0
11232,52,3,2021-04-02,5665,5,150081,52,2021-04-02,1617318000.0
11233,52,3,2021-04-03,1870,5,151951,57,2021-04-03,1617404400.0
11234,52,3,2021-04-04,44,0,151995,57,2021-04-04,1617490800.0
11235,52,3,2021-04-05,40,0,152035,57,2021-04-05,1617577200.0
11236,52,3,2021-04-06,1588,3,153623,60,2021-04-06,1617663600.0
11237,52,3,2021-04-07,2187,1,155810,61,2021-04-07,1617750000.0
11238,52,3,2021-04-08,6372,6,162182,67,2021-04-08,1617836400.0
11239,52,3,2021-04-09,11247,19,173429,86,2021-04-09,1617922800.0
11240,52,3,2021-04-10,4365,5,177794,91,2021-04-10,1618009200.0
11241,52,3,2021-04-11,135,0,177929,91,2021-04-11,1618095600.0
11242,52,3,2021-04-12,3681,10,181610,101,2021-04-12,1618185600.0
11243,52,3,2021-04-13,6325,6,187935,107,2021-04-13,1618272000.0
11244,52,3,2021-04-14,4668,7,192603,114,2021-04-14,1618358400.0
11245,52,3,2021-04-15,7325,5,199928,119,2021-04-15,1618444800.0
11246,52,3,2021-04-16,8302,21,208230,140,2021-04-16,1618531200.0
11247,52,3,2021-04-17,3799,9,212029,149,2021-04-17,1618617600.0
11248,52,3,2021-04-18,1431,0,213460,149,2021-04-18,1618704000.0
11249,52,3,2021-04-19,1710,4,215170,153,2021-04-19,1618790400.0
11250,52,3,2021-04-20,3871,9,219041,162,2021-04-20,1618876800.0
11251,52,3,2021-04-21,2874,11,221915,173,2021-04-21,1618963200.0
11252,52,3,2021-04-22,4581,20,226496,193,2021-04-22,1619049600.0
11253,52,3,2021-04-23,5666,38,232162,231,2021-04-23,1619136000.0
11254,52,3,2021-04-24,2508,20,234670,251,2021-04-24,1619222400.0
11255,52,3,2021-04-25,275,2,234945,253,2021-04-25,1619308800.0
11256,52,3,2021-04-26,1391,31,236336,284,2021-04-26,1619395200.0
11257,52,3,2021-04-27,2763,89,239099,373,2021-04-27,1619481600.0
11258,52,3,2021-04-28,2387,69,241486,442,2021-04-28,1619568000.0
11259,52,3,2021-04-29,3840,347,245326,789,2021-04-29,1619654400.0
11260,52,3,2021-04-30,4554,465,249880,1254,2021-04-30,1619740800.0
11261,52,3,2021-05-01,422,49,250302,1303,2021-05-01,1619827200.0
11262,52,3,2021-05-02,27,8,250329,1311,2021-05-02,1619913600.0
11263,52,3,2021-05-03,1213,123,251542,1434,2021-05-03,1620000000.0
11264,52,3,2021-05-04,2112,305,253654,1739,2021-05-04,1620086400.0
11265,52,3,2021-05-05,1370,458,255024,2197,2021-05-05,1620172800.0
11266,52,3,2021-05-06,3075,1007,258099,3204,2021-05-06,1620259200.0
11267,52,3,2021-05-07,3550,1466,261649,4670,2021-05-07,1620345600.0
11268,52,3,2021-05-08,374,116,262023,4786,2021-05-08,1620432000.0
11269,52,3,2021-05-09,44,15,262067,4801,2021-05-09,1620518400.0
11270,52,3,2021-05-10,1351,494,263418,5295,2021-05-10,1620604800.0
11271,52,3,2021-05-11,2470,1373,265888,6668,2021-05-11,1620691200.0
11272,52,3,2021-05-12,1419,1390,267307,8058,2021-05-12,1620777600.0
11273,52,3,2021-05-13,109,167,267416,8225,2021-05-13,1620864000.0
11274,52,3,2021-05-14,1069,1066,268485,9291,2021-05-14,1620950400.0
11275,52,3,2021-05-15,337,631,268822,9922,2021-05-15,1621036800.0
11276,52,3,2021-05-16,33,13,268855,9935,2021-05-16,1621123200.0
11277,52,3,2021-05-17,675,1503,269530,11438,2021-05-17,1621206000.0
11278,52,3,2021-05-18,1244,2173,270774,13611,2021-05-18,1621292400.0
11279,52,3,2021-05-19,777,1923,271551,15534,2021-05-19,1621378800.0
11280,52,3,2021-05-20,1017,3344,272568,18878,2021-05-20,1621465200.0
11281,52,3,2021-05-21,978,3464,273546,22342,2021-05-21,1621551600.0
11282,52,3,2021-05-22,228,1407,273774,23749,2021-05-22,1621638000.0
11283,52,3,2021-05-23,19,84,273793,23833,2021-05-23,1621724400.0
11284,52,3,2021-05-24,2,133,273795,23966,2021-05-24,1621810800.0
11285,52,3,2021-05-25,370,2082,274165,26048,2021-05-25,1621897200.0
11286,52,3,2021-05-26,349,3114,274514,29162,2021-05-26,1621983600.0
11287,52,3,2021-05-27,412,4436,274926,33598,2021-05-27,1622070000.0
11288,52,3,2021-05-28,538,5043,275464,38641,2021-05-28,1622156400.0
11289,52,3,2021-05-29,142,2388,275606,41029,2021-05-29,1622242800.0
11290,52,3,2021-05-30,5,61,275611,41090,2021-05-30,1622329200.0
11291,52,3,2021-05-31,78,2164,275689,43254,2021-05-31,1622415600.0
11292,52,3,2021-06-01,137,3732,275826,46986,2021-06-01,1622502000.0
11293,52,3,2021-06-02,135,3118,275961,50104,2021-06-02,1622588400.0
11294,52,3,2021-06-03,203,5174,276164,55278,2021-06-03,1622674800.0
11295,52,3,2021-06-04,191,6150,276355,61428,2021-06-04,1622761200.0
11296,52,3,2021-06-05,63,2896,276418,64324,2021-06-05,1622847600.0
11297,52,3,2021-06-06,9,346,276427,64670,2021-06-06,1622934000.0
11298,52,3,2021-06-07,71,2065,276498,66735,2021-06-07,1623020400.0
11299,52,3,2021-06-08,112,2961,276610,69696,2021-06-08,1623106800.0
11300,52,3,2021-06-09,91,2688,276701,72384,2021-06-09,1623193200.0
11301,52,3,2021-06-10,98,4091,276799,76475,2021-06-10,1623279600.0
11302,52,3,2021-06-11,134,5937,276933,82412,2021-06-11,1623366000.0
11303,52,3,2021-06-12,40,1942,276973,84354,2021-06-12,1623452400.0
11304,52,3,2021-06-13,0,111,276973,84465,2021-06-13,1623538800.0
11305,52,3,2021-06-14,37,2742,277010,87207,2021-06-14,1623625200.0
11306,52,3,2021-06-15,57,5574,277067,92781,2021-06-15,1623711600.0
11307,52,3,2021-06-16,50,4285,277117,97066,2021-06-16,1623798000.0
11308,52,3,2021-06-17,94,7001,277211,104067,2021-06-17,1623884400.0
11309,52,3,2021-06-18,111,7806,277322,111873,2021-06-18,1623970800.0
11310,52,3,2021-06-19,38,1898,277360,113771,2021-06-19,1624057200.0
11311,52,3,2021-06-20,0,64,277360,113835,2021-06-20,1624143600.0
11312,52,3,2021-06-21,20,2778,277380,116613,2021-06-21,1624230000.0
11313,52,3,2021-06-22,48,5310,277428,121923,2021-06-22,1624316400.0
11314,52,3,2021-06-23,41,3410,277469,125333,2021-06-23,1624402800.0
11315,52,3,2021-06-24,61,5771,277530,131104,2021-06-24,1624489200.0
11316,52,3,2021-06-25,45,6720,277575,137824,2021-06-25,1624575600.0
11317,52,3,2021-06-26,29,1752,277604,139576,2021-06-26,1624662000.0
11318,52,3,2021-06-27,1,58,277605,139634,2021-06-27,1624748400.0
11319,52,3,2021-06-28,24,2197,277629,141831,2021-06-28,1624834800.0
11320,52,3,2021-06-29,38,4306,277667,146137,2021-06-29,1624921200.0
11321,52,3,2021-06-30,31,3263,277698,149400,2021-06-30,1625007600.0
11322,52,3,2021-07-01,50,5641,277748,155041,2021-07-01,1625094000.0
11323,52,3,2021-07-02,72,7180,277820,162221,2021-07-02,1625180400.0
11324,52,3,2021-07-03,21,1981,277841,164202,2021-07-03,1625266800.0
11325,52,3,2021-07-04,0,134,277841,164336,2021-07-04,1625353200.0
11326,52,3,2021-07-05,22,3045,277863,167381,2021-07-05,1625439600.0
11327,52,3,2021-07-06,43,5159,277906,172540,2021-07-06,1625526000.0
11328,52,4,2020-12-27,0,0,0,0,2020-12-27,1609023600.0
11329,52,4,2020-12-28,0,0,0,0,2020-12-28,1609110000.0
11330,52,4,2020-12-29,0,0,0,0,2020-12-29,1609196400.0
11331,52,4,2020-12-30,0,0,0,0,2020-12-30,1609282800.0
11332,52,4,2020-12-31,0,0,0,0,2020-12-31,1609369200.0
11333,52,4,2021-01-01,0,0,0,0,2021-01-01,1609455600.0
11334,52,4,2021-01-02,0,0,0,0,2021-01-02,1609542000.0
11335,52,4,2021-01-03,0,0,0,0,2021-01-03,1609628400.0
11336,52,4,2021-01-04,0,0,0,0,2021-01-04,1609714800.0
11337,52,4,2021-01-05,0,0,0,0,2021-01-05,1609801200.0
11338,52,4,2021-01-06,0,0,0,0,2021-01-06,1609887600.0
11339,52,4,2021-01-07,0,0,0,0,2021-01-07,1609974000.0
11340,52,4,2021-01-08,0,0,0,0,2021-01-08,1610060400.0
11341,52,4,2021-01-09,0,0,0,0,2021-01-09,1610146800.0
11342,52,4,2021-01-10,0,0,0,0,2021-01-10,1610233200.0
11343,52,4,2021-01-11,0,0,0,0,2021-01-11,1610319600.0
11344,52,4,2021-01-12,0,0,0,0,2021-01-12,1610406000.0
11345,52,4,2021-01-13,0,0,0,0,2021-01-13,1610492400.0
11346,52,4,2021-01-14,0,0,0,0,2021-01-14,1610578800.0
11347,52,4,2021-01-15,0,0,0,0,2021-01-15,1610665200.0
11348,52,4,2021-01-16,0,0,0,0,2021-01-16,1610751600.0
11349,52,4,2021-01-17,0,0,0,0,2021-01-17,1610838000.0
11350,52,4,2021-01-18,0,0,0,0,2021-01-18,1610924400.0
11351,52,4,2021-01-19,0,0,0,0,2021-01-19,1611010800.0
11352,52,4,2021-01-20,0,0,0,0,2021-01-20,1611097200.0
11353,52,4,2021-01-21,0,0,0,0,2021-01-21,1611183600.0
11354,52,4,2021-01-22,0,0,0,0,2021-01-22,1611270000.0
11355,52,4,2021-01-23,0,0,0,0,2021-01-23,1611356400.0
11356,52,4,2021-01-24,0,0,0,0,2021-01-24,1611442800.0
11357,52,4,2021-01-25,0,0,0,0,2021-01-25,1611529200.0
11358,52,4,2021-01-26,0,0,0,0,2021-01-26,1611615600.0
11359,52,4,2021-01-27,0,0,0,0,2021-01-27,1611702000.0
11360,52,4,2021-01-28,0,0,0,0,2021-01-28,1611788400.0
11361,52,4,2021-01-29,0,0,0,0,2021-01-29,1611874800.0
11362,52,4,2021-01-30,0,0,0,0,2021-01-30,1611961200.0
11363,52,4,2021-01-31,0,0,0,0,2021-01-31,1612047600.0
11364,52,4,2021-02-01,0,0,0,0,2021-02-01,1612134000.0
11365,52,4,2021-02-02,0,0,0,0,2021-02-02,1612220400.0
11366,52,4,2021-02-03,0,0,0,0,2021-02-03,1612306800.0
11367,52,4,2021-02-04,0,0,0,0,2021-02-04,1612393200.0
11368,52,4,2021-02-05,0,0,0,0,2021-02-05,1612479600.0
11369,52,4,2021-02-06,0,0,0,0,2021-02-06,1612566000.0
11370,52,4,2021-02-07,0,0,0,0,2021-02-07,1612652400.0
11371,52,4,2021-02-08,0,0,0,0,2021-02-08,1612738800.0
11372,52,4,2021-02-09,0,0,0,0,2021-02-09,1612825200.0
11373,52,4,2021-02-10,0,0,0,0,2021-02-10,1612911600.0
11374,52,4,2021-02-11,0,0,0,0,2021-02-11,1612998000.0
11375,52,4,2021-02-12,0,0,0,0,2021-02-12,1613084400.0
11376,52,4,2021-02-13,0,0,0,0,2021-02-13,1613170800.0
11377,52,4,2021-02-14,0,0,0,0,2021-02-14,1613257200.0
11378,52,4,2021-02-15,0,0,0,0,2021-02-15,1613343600.0
11379,52,4,2021-02-16,0,0,0,0,2021-02-16,1613430000.0
11380,52,4,2021-02-17,0,0,0,0,2021-02-17,1613516400.0
11381,52,4,2021-02-18,0,0,0,0,2021-02-18,1613602800.0
11382,52,4,2021-02-19,0,0,0,0,2021-02-19,1613689200.0
11383,52,4,2021-02-20,0,0,0,0,2021-02-20,1613775600.0
11384,52,4,2021-02-21,0,0,0,0,2021-02-21,1613862000.0
11385,52,4,2021-02-22,0,0,0,0,2021-02-22,1613948400.0
11386,52,4,2021-02-23,0,0,0,0,2021-02-23,1614034800.0
11387,52,4,2021-02-24,0,0,0,0,2021-02-24,1614121200.0
11388,52,4,2021-02-25,0,0,0,0,2021-02-25,1614207600.0
11389,52,4,2021-02-26,0,0,0,0,2021-02-26,1614294000.0
11390,52,4,2021-02-27,0,0,0,0,2021-02-27,1614380400.0
11391,52,4,2021-02-28,0,0,0,0,2021-02-28,1614466800.0
11392,52,4,2021-03-01,0,0,0,0,2021-03-01,1614553200.0
11393,52,4,2021-03-02,0,0,0,0,2021-03-02,1614639600.0
11394,52,4,2021-03-03,0,0,0,0,2021-03-03,1614726000.0
11395,52,4,2021-03-04,0,0,0,0,2021-03-04,1614812400.0
11396,52,4,2021-03-05,0,0,0,0,2021-03-05,1614898800.0
11397,52,4,2021-03-06,0,0,0,0,2021-03-06,1614985200.0
11398,52,4,2021-03-07,0,0,0,0,2021-03-07,1615071600.0
11399,52,4,2021-03-08,0,0,0,0,2021-03-08,1615158000.0
11400,52,4,2021-03-09,0,0,0,0,2021-03-09,1615244400.0
11401,52,4,2021-03-10,0,0,0,0,2021-03-10,1615330800.0
11402,52,4,2021-03-11,0,0,0,0,2021-03-11,1615417200.0
11403,52,4,2021-03-12,0,0,0,0,2021-03-12,1615503600.0
11404,52,4,2021-03-13,0,0,0,0,2021-03-13,1615590000.0
11405,52,4,2021-03-14,0,0,0,0,2021-03-14,1615676400.0
11406,52,4,2021-03-15,0,0,0,0,2021-03-15,1615762800.0
11407,52,4,2021-03-16,0,0,0,0,2021-03-16,1615849200.0
11408,52,4,2021-03-17,0,0,0,0,2021-03-17,1615935600.0
11409,52,4,2021-03-18,0,0,0,0,2021-03-18,1616022000.0
11410,52,4,2021-03-19,0,0,0,0,2021-03-19,1616108400.0
11411,52,4,2021-03-20,0,0,0,0,2021-03-20,1616194800.0
11412,52,4,2021-03-21,0,0,0,0,2021-03-21,1616281200.0
11413,52,4,2021-03-22,0,0,0,0,2021-03-22,1616367600.0
11414,52,4,2021-03-23,0,0,0,0,2021-03-23,1616454000.0
11415,52,4,2021-03-24,0,0,0,0,2021-03-24,1616540400.0
11416,52,4,2021-03-25,0,0,0,0,2021-03-25,1616626800.0
11417,52,4,2021-03-26,0,0,0,0,2021-03-26,1616713200.0
11418,52,4,2021-03-27,0,0,0,0,2021-03-27,1616799600.0
11419,52,4,2021-03-28,0,0,0,0,2021-03-28,1616886000.0
11420,52,4,2021-03-29,0,0,0,0,2021-03-29,1616972400.0
11421,52,4,2021-03-30,0,0,0,0,2021-03-30,1617058800.0
11422,52,4,2021-03-31,0,0,0,0,2021-03-31,1617145200.0
11423,52,4,2021-04-01,0,0,0,0,2021-04-01,1617231600.0
11424,52,4,2021-04-02,0,0,0,0,2021-04-02,1617318000.0
11425,52,4,2021-04-03,0,0,0,0,2021-04-03,1617404400.0
11426,52,4,2021-04-04,0,0,0,0,2021-04-04,1617490800.0
11427,52,4,2021-04-05,0,0,0,0,2021-04-05,1617577200.0
11428,52,4,2021-04-06,0,0,0,0,2021-04-06,1617663600.0
11429,52,4,2021-04-07,0,0,0,0,2021-04-07,1617750000.0
11430,52,4,2021-04-08,0,0,0,0,2021-04-08,1617836400.0
11431,52,4,2021-04-09,0,0,0,0,2021-04-09,1617922800.0
11432,52,4,2021-04-10,0,0,0,0,2021-04-10,1618009200.0
11433,52,4,2021-04-11,0,0,0,0,2021-04-11,1618095600.0
11434,52,4,2021-04-12,0,0,0,0,2021-04-12,1618185600.0
11435,52,4,2021-04-13,0,0,0,0,2021-04-13,1618272000.0
11436,52,4,2021-04-14,0,0,0,0,2021-04-14,1618358400.0
11437,52,4,2021-04-15,0,0,0,0,2021-04-15,1618444800.0
11438,52,4,2021-04-16,0,0,0,0,2021-04-16,1618531200.0
11439,52,4,2021-04-17,0,0,0,0,2021-04-17,1618617600.0
11440,52,4,2021-04-18,0,0,0,0,2021-04-18,1618704000.0
11441,52,4,2021-04-19,0,0,0,0,2021-04-19,1618790400.0
11442,52,4,2021-04-20,0,0,0,0,2021-04-20,1618876800.0
11443,52,4,2021-04-21,0,0,0,0,2021-04-21,1618963200.0
11444,52,4,2021-04-22,0,0,0,0,2021-04-22,1619049600.0
11445,52,4,2021-04-23,47,0,47,0,2021-04-23,1619136000.0
11446,52,4,2021-04-24,129,0,176,0,2021-04-24,1619222400.0
11447,52,4,2021-04-25,10,0,186,0,2021-04-25,1619308800.0
11448,52,4,2021-04-26,261,0,447,0,2021-04-26,1619395200.0
11449,52,4,2021-04-27,742,0,1189,0,2021-04-27,1619481600.0
11450,52,4,2021-04-28,599,0,1788,0,2021-04-28,1619568000.0
11451,52,4,2021-04-29,1067,0,2855,0,2021-04-29,1619654400.0
11452,52,4,2021-04-30,1043,0,3898,0,2021-04-30,1619740800.0
11453,52,4,2021-05-01,112,0,4010,0,2021-05-01,1619827200.0
11454,52,4,2021-05-02,2,0,4012,0,2021-05-02,1619913600.0
11455,52,4,2021-05-03,258,0,4270,0,2021-05-03,1620000000.0
11456,52,4,2021-05-04,515,0,4785,0,2021-05-04,1620086400.0
11457,52,4,2021-05-05,426,0,5211,0,2021-05-05,1620172800.0
11458,52,4,2021-05-06,801,2,6012,2,2021-05-06,1620259200.0
11459,52,4,2021-05-07,1152,0,7164,2,2021-05-07,1620345600.0
11460,52,4,2021-05-08,57,1,7221,3,2021-05-08,1620432000.0
11461,52,4,2021-05-09,5,0,7226,3,2021-05-09,1620518400.0
11462,52,4,2021-05-10,442,0,7668,3,2021-05-10,1620604800.0
11463,52,4,2021-05-11,903,0,8571,3,2021-05-11,1620691200.0
11464,52,4,2021-05-12,573,0,9144,3,2021-05-12,1620777600.0
11465,52,4,2021-05-13,24,0,9168,3,2021-05-13,1620864000.0
11466,52,4,2021-05-14,258,1,9426,4,2021-05-14,1620950400.0
11467,52,4,2021-05-15,166,0,9592,4,2021-05-15,1621036800.0
11468,52,4,2021-05-16,12,1,9604,5,2021-05-16,1621123200.0
11469,52,4,2021-05-17,261,0,9865,5,2021-05-17,1621206000.0
11470,52,4,2021-05-18,596,1,10461,6,2021-05-18,1621292400.0
11471,52,4,2021-05-19,424,0,10885,6,2021-05-19,1621378800.0
11472,52,4,2021-05-20,579,0,11464,6,2021-05-20,1621465200.0
11473,52,4,2021-05-21,856,1,12320,7,2021-05-21,1621551600.0
11474,52,4,2021-05-22,232,0,12552,7,2021-05-22,1621638000.0
11475,52,4,2021-05-23,25,0,12577,7,2021-05-23,1621724400.0
11476,52,4,2021-05-24,38,0,12615,7,2021-05-24,1621810800.0
11477,52,4,2021-05-25,510,1,13125,8,2021-05-25,1621897200.0
11478,52,4,2021-05-26,411,0,13536,8,2021-05-26,1621983600.0
11479,52,4,2021-05-27,972,1,14508,9,2021-05-27,1622070000.0
11480,52,4,2021-05-28,1887,0,16395,9,2021-05-28,1622156400.0
11481,52,4,2021-05-29,659,0,17054,9,2021-05-29,1622242800.0
11482,52,4,2021-05-30,15,0,17069,9,2021-05-30,1622329200.0
11483,52,4,2021-05-31,863,2,17932,11,2021-05-31,1622415600.0
11484,52,4,2021-06-01,1210,1,19142,12,2021-06-01,1622502000.0
11485,52,4,2021-06-02,902,0,20044,12,2021-06-02,1622588400.0
11486,52,4,2021-06-03,1223,0,21267,12,2021-06-03,1622674800.0
11487,52,4,2021-06-04,1479,2,22746,14,2021-06-04,1622761200.0
11488,52,4,2021-06-05,398,1,23144,15,2021-06-05,1622847600.0
11489,52,4,2021-06-06,21,0,23165,15,2021-06-06,1622934000.0
11490,52,4,2021-06-07,555,0,23720,15,2021-06-07,1623020400.0
11491,52,4,2021-06-08,948,2,24668,17,2021-06-08,1623106800.0
11492,52,4,2021-06-09,872,0,25540,17,2021-06-09,1623193200.0
11493,52,4,2021-06-10,938,3,26478,20,2021-06-10,1623279600.0
11494,52,4,2021-06-11,1111,1,27589,21,2021-06-11,1623366000.0
11495,52,4,2021-06-12,417,1,28006,22,2021-06-12,1623452400.0
11496,52,4,2021-06-13,3,0,28009,22,2021-06-13,1623538800.0
11497,52,4,2021-06-14,424,3,28433,25,2021-06-14,1623625200.0
11498,52,4,2021-06-15,704,3,29137,28,2021-06-15,1623711600.0
11499,52,4,2021-06-16,640,2,29777,30,2021-06-16,1623798000.0
11500,52,4,2021-06-17,696,0,30473,30,2021-06-17,1623884400.0
11501,52,4,2021-06-18,690,0,31163,30,2021-06-18,1623970800.0
11502,52,4,2021-06-19,277,2,31440,32,2021-06-19,1624057200.0
11503,52,4,2021-06-20,12,0,31452,32,2021-06-20,1624143600.0
11504,52,4,2021-06-21,290,1,31742,33,2021-06-21,1624230000.0
11505,52,4,2021-06-22,449,1,32191,34,2021-06-22,1624316400.0
11506,52,4,2021-06-23,388,0,32579,34,2021-06-23,1624402800.0
11507,52,4,2021-06-24,473,6,33052,40,2021-06-24,1624489200.0
11508,52,4,2021-06-25,499,1,33551,41,2021-06-25,1624575600.0
11509,52,4,2021-06-26,230,0,33781,41,2021-06-26,1624662000.0
11510,52,4,2021-06-27,21,0,33802,41,2021-06-27,1624748400.0
11511,52,4,2021-06-28,259,0,34061,41,2021-06-28,1624834800.0
11512,52,4,2021-06-29,440,0,34501,41,2021-06-29,1624921200.0
11513,52,4,2021-06-30,413,2,34914,43,2021-06-30,1625007600.0
11514,52,4,2021-07-01,451,2,35365,45,2021-07-01,1625094000.0
11515,52,4,2021-07-02,605,2,35970,47,2021-07-02,1625180400.0
11516,52,4,2021-07-03,195,2,36165,49,2021-07-03,1625266800.0
11517,52,4,2021-07-04,12,0,36177,49,2021-07-04,1625353200.0
11518,52,4,2021-07-05,280,1,36457,50,2021-07-05,1625439600.0
11519,52,4,2021-07-06,408,3,36865,53,2021-07-06,1625526000.0
11520,53,1,2020-12-27,0,0,0,0,2020-12-27,1609023600.0
11521,53,1,2020-12-28,1,0,1,0,2020-12-28,1609110000.0
11522,53,1,2020-12-29,0,0,1,0,2020-12-29,1609196400.0
11523,53,1,2020-12-30,0,0,1,0,2020-12-30,1609282800.0
11524,53,1,2020-12-31,0,0,1,0,2020-12-31,1609369200.0
11525,53,1,2021-01-01,2,0,3,0,2021-01-01,1609455600.0
11526,53,1,2021-01-02,4,0,7,0,2021-01-02,1609542000.0
11527,53,1,2021-01-03,1,0,8,0,2021-01-03,1609628400.0
11528,53,1,2021-01-04,43,0,51,0,2021-01-04,1609714800.0
11529,53,1,2021-01-05,200,0,251,0,2021-01-05,1609801200.0
11530,53,1,2021-01-06,331,0,582,0,2021-01-06,1609887600.0
11531,53,1,2021-01-07,835,0,1417,0,2021-01-07,1609974000.0
11532,53,1,2021-01-08,1214,0,2631,0,2021-01-08,1610060400.0
11533,53,1,2021-01-09,34,0,2665,0,2021-01-09,1610146800.0
11534,53,1,2021-01-10,4,0,2669,0,2021-01-10,1610233200.0
11535,53,1,2021-01-11,1663,0,4332,0,2021-01-11,1610319600.0
11536,53,1,2021-01-12,3381,0,7713,0,2021-01-12,1610406000.0
11537,53,1,2021-01-13,3355,0,11068,0,2021-01-13,1610492400.0
11538,53,1,2021-01-14,3811,0,14879,0,2021-01-14,1610578800.0
11539,53,1,2021-01-15,3299,0,18178,0,2021-01-15,1610665200.0
11540,53,1,2021-01-16,684,3,18862,3,2021-01-16,1610751600.0
11541,53,1,2021-01-17,180,1,19042,4,2021-01-17,1610838000.0
11542,53,1,2021-01-18,3363,4,22405,8,2021-01-18,1610924400.0
11543,53,1,2021-01-19,8175,3,30580,11,2021-01-19,1611010800.0
11544,53,1,2021-01-20,7057,2,37637,13,2021-01-20,1611097200.0
11545,53,1,2021-01-21,11492,2,49129,15,2021-01-21,1611183600.0
11546,53,1,2021-01-22,7823,0,56952,15,2021-01-22,1611270000.0
11547,53,1,2021-01-23,1492,2,58444,17,2021-01-23,1611356400.0
11548,53,1,2021-01-24,255,1,58699,18,2021-01-24,1611442800.0
11549,53,1,2021-01-25,3056,34,61755,52,2021-01-25,1611529200.0
11550,53,1,2021-01-26,4115,231,65870,283,2021-01-26,1611615600.0
11551,53,1,2021-01-27,7238,319,73108,602,2021-01-27,1611702000.0
11552,53,1,2021-01-28,7135,634,80243,1236,2021-01-28,1611788400.0
11553,53,1,2021-01-29,4230,727,84473,1963,2021-01-29,1611874800.0
11554,53,1,2021-01-30,844,42,85317,2005,2021-01-30,1611961200.0
11555,53,1,2021-01-31,79,3,85396,2008,2021-01-31,1612047600.0
11556,53,1,2021-02-01,2211,1026,87607,3034,2021-02-01,1612134000.0
11557,53,1,2021-02-02,3436,2006,91043,5040,2021-02-02,1612220400.0
11558,53,1,2021-02-03,3175,2168,94218,7208,2021-02-03,1612306800.0
11559,53,1,2021-02-04,7098,2259,101316,9467,2021-02-04,1612393200.0
11560,53,1,2021-02-05,5588,2131,106904,11598,2021-02-05,1612479600.0
11561,53,1,2021-02-06,1196,275,108100,11873,2021-02-06,1612566000.0
11562,53,1,2021-02-07,214,132,108314,12005,2021-02-07,1612652400.0
11563,53,1,2021-02-08,1534,1527,109848,13532,2021-02-08,1612738800.0
11564,53,1,2021-02-09,3695,5238,113543,18770,2021-02-09,1612825200.0
11565,53,1,2021-02-10,3462,4625,117005,23395,2021-02-10,1612911600.0
11566,53,1,2021-02-11,5179,8764,122184,32159,2021-02-11,1612998000.0
11567,53,1,2021-02-12,5127,5228,127311,37387,2021-02-12,1613084400.0
11568,53,1,2021-02-13,1228,847,128539,38234,2021-02-13,1613170800.0
11569,53,1,2021-02-14,25,348,128564,38582,2021-02-14,1613257200.0
11570,53,1,2021-02-15,1427,3575,129991,42157,2021-02-15,1613343600.0
11571,53,1,2021-02-16,2659,3531,132650,45688,2021-02-16,1613430000.0
11572,53,1,2021-02-17,2803,5361,135453,51049,2021-02-17,1613516400.0
11573,53,1,2021-02-18,4403,5716,139856,56765,2021-02-18,1613602800.0
11574,53,1,2021-02-19,3359,4825,143215,61590,2021-02-19,1613689200.0
11575,53,1,2021-02-20,845,884,144060,62474,2021-02-20,1613775600.0
11576,53,1,2021-02-21,121,218,144181,62692,2021-02-21,1613862000.0
11577,53,1,2021-02-22,1383,2816,145564,65508,2021-02-22,1613948400.0
11578,53,1,2021-02-23,2585,3659,148149,69167,2021-02-23,1614034800.0
11579,53,1,2021-02-24,2603,3759,150752,72926,2021-02-24,1614121200.0
11580,53,1,2021-02-25,3946,7101,154698,80027,2021-02-25,1614207600.0
11581,53,1,2021-02-26,3604,4364,158302,84391,2021-02-26,1614294000.0
11582,53,1,2021-02-27,1037,1093,159339,85484,2021-02-27,1614380400.0
11583,53,1,2021-02-28,157,194,159496,85678,2021-02-28,1614466800.0
11584,53,1,2021-03-01,2275,2256,161771,87934,2021-03-01,1614553200.0
11585,53,1,2021-03-02,3520,4442,165291,92376,2021-03-02,1614639600.0
11586,53,1,2021-03-03,3810,3761,169101,96137,2021-03-03,1614726000.0
11587,53,1,2021-03-04,4468,4875,173569,101012,2021-03-04,1614812400.0
11588,53,1,2021-03-05,4750,5134,178319,106146,2021-03-05,1614898800.0
11589,53,1,2021-03-06,1356,986,179675,107132,2021-03-06,1614985200.0
11590,53,1,2021-03-07,132,138,179807,107270,2021-03-07,1615071600.0
11591,53,1,2021-03-08,2713,2176,182520,109446,2021-03-08,1615158000.0
11592,53,1,2021-03-09,4492,2870,187012,112316,2021-03-09,1615244400.0
11593,53,1,2021-03-10,4351,3258,191363,115574,2021-03-10,1615330800.0
11594,53,1,2021-03-11,5732,3899,197095,119473,2021-03-11,1615417200.0
11595,53,1,2021-03-12,5116,3006,202211,122479,2021-03-12,1615503600.0
11596,53,1,2021-03-13,1502,900,203713,123379,2021-03-13,1615590000.0
11597,53,1,2021-03-14,365,50,204078,123429,2021-03-14,1615676400.0
11598,53,1,2021-03-15,4036,1684,208114,125113,2021-03-15,1615762800.0
11599,53,1,2021-03-16,5825,2893,213939,128006,2021-03-16,1615849200.0
11600,53,1,2021-03-17,5999,2468,219938,130474,2021-03-17,1615935600.0
11601,53,1,2021-03-18,6516,4312,226454,134786,2021-03-18,1616022000.0
11602,53,1,2021-03-19,5689,3245,232143,138031,2021-03-19,1616108400.0
11603,53,1,2021-03-20,3389,769,235532,138800,2021-03-20,1616194800.0
11604,53,1,2021-03-21,273,30,235805,138830,2021-03-21,1616281200.0
11605,53,1,2021-03-22,5114,1947,240919,140777,2021-03-22,1616367600.0
11606,53,1,2021-03-23,7260,2936,248179,143713,2021-03-23,1616454000.0
11607,53,1,2021-03-24,7621,2583,255800,146296,2021-03-24,1616540400.0
11608,53,1,2021-03-25,8025,2880,263825,149176,2021-03-25,1616626800.0
11609,53,1,2021-03-26,7858,2769,271683,151945,2021-03-26,1616713200.0
11610,53,1,2021-03-27,3616,961,275299,152906,2021-03-27,1616799600.0
11611,53,1,2021-03-28,329,34,275628,152940,2021-03-28,1616886000.0
11612,53,1,2021-03-29,6190,2962,281818,155902,2021-03-29,1616972400.0
11613,53,1,2021-03-30,8853,4341,290671,160243,2021-03-30,1617058800.0
11614,53,1,2021-03-31,8990,3956,299661,164199,2021-03-31,1617145200.0
11615,53,1,2021-04-01,11287,4027,310948,168226,2021-04-01,1617231600.0
11616,53,1,2021-04-02,10351,4002,321299,172228,2021-04-02,1617318000.0
11617,53,1,2021-04-03,4566,1384,325865,173612,2021-04-03,1617404400.0
11618,53,1,2021-04-04,375,31,326240,173643,2021-04-04,1617490800.0
11619,53,1,2021-04-05,1172,325,327412,173968,2021-04-05,1617577200.0
11620,53,1,2021-04-06,9751,5322,337163,179290,2021-04-06,1617663600.0
11621,53,1,2021-04-07,11538,4956,348701,184246,2021-04-07,1617750000.0
11622,53,1,2021-04-08,12555,5671,361256,189917,2021-04-08,1617836400.0
11623,53,1,2021-04-09,12982,4840,374238,194757,2021-04-09,1617922800.0
11624,53,1,2021-04-10,5214,1588,379452,196345,2021-04-10,1618009200.0
11625,53,1,2021-04-11,292,183,379744,196528,2021-04-11,1618095600.0
11626,53,1,2021-04-12,11015,4342,390759,200870,2021-04-12,1618185600.0
11627,53,1,2021-04-13,14997,6078,405756,206948,2021-04-13,1618272000.0
11628,53,1,2021-04-14,13373,5677,419129,212625,2021-04-14,1618358400.0
11629,53,1,2021-04-15,16161,5792,435290,218417,2021-04-15,1618444800.0
11630,53,1,2021-04-16,14787,5206,450077,223623,2021-04-16,1618531200.0
11631,53,1,2021-04-17,5706,3271,455783,226894,2021-04-17,1618617600.0
11632,53,1,2021-04-18,963,139,456746,227033,2021-04-18,1618704000.0
11633,53,1,2021-04-19,12033,5896,468779,232929,2021-04-19,1618790400.0
11634,53,1,2021-04-20,12254,8349,481033,241278,2021-04-20,1618876800.0
11635,53,1,2021-04-21,12269,8289,493302,249567,2021-04-21,1618963200.0
11636,53,1,2021-04-22,14259,8638,507561,258205,2021-04-22,1619049600.0
11637,53,1,2021-04-23,12735,8161,520296,266366,2021-04-23,1619136000.0
11638,53,1,2021-04-24,5766,3833,526062,270199,2021-04-24,1619222400.0
11639,53,1,2021-04-25,886,319,526948,270518,2021-04-25,1619308800.0
11640,53,1,2021-04-26,14608,7327,541556,277845,2021-04-26,1619395200.0
11641,53,1,2021-04-27,15147,9686,556703,287531,2021-04-27,1619481600.0
11642,53,1,2021-04-28,15926,8584,572629,296115,2021-04-28,1619568000.0
11643,53,1,2021-04-29,15330,8717,587959,304832,2021-04-29,1619654400.0
11644,53,1,2021-04-30,14943,9217,602902,314049,2021-04-30,1619740800.0
11645,53,1,2021-05-01,3988,1374,606890,315423,2021-05-01,1619827200.0
11646,53,1,2021-05-02,413,349,607303,315772,2021-05-02,1619913600.0
11647,53,1,2021-05-03,12868,7979,620171,323751,2021-05-03,1620000000.0
11648,53,1,2021-05-04,12233,13516,632404,337267,2021-05-04,1620086400.0
11649,53,1,2021-05-05,12246,12421,644650,349688,2021-05-05,1620172800.0
11650,53,1,2021-05-06,14221,13393,658871,363081,2021-05-06,1620259200.0
11651,53,1,2021-05-07,11985,13128,670856,376209,2021-05-07,1620345600.0
11652,53,1,2021-05-08,3066,735,673922,376944,2021-05-08,1620432000.0
11653,53,1,2021-05-09,2053,370,675975,377314,2021-05-09,1620518400.0
11654,53,1,2021-05-10,12036,12457,688011,389771,2021-05-10,1620604800.0
11655,53,1,2021-05-11,13225,14434,701236,404205,2021-05-11,1620691200.0
11656,53,1,2021-05-12,16233,11473,717469,415678,2021-05-12,1620777600.0
11657,53,1,2021-05-13,7047,3343,724516,419021,2021-05-13,1620864000.0
11658,53,1,2021-05-14,17173,9740,741689,428761,2021-05-14,1620950400.0
11659,53,1,2021-05-15,8981,3260,750670,432021,2021-05-15,1621036800.0
11660,53,1,2021-05-16,3194,566,753864,432587,2021-05-16,1621123200.0
11661,53,1,2021-05-17,14100,8210,767964,440797,2021-05-17,1621206000.0
11662,53,1,2021-05-18,15956,8126,783920,448923,2021-05-18,1621292400.0
11663,53,1,2021-05-19,17162,6883,801082,455806,2021-05-19,1621378800.0
11664,53,1,2021-05-20,18060,7955,819142,463761,2021-05-20,1621465200.0
11665,53,1,2021-05-21,18616,7888,837758,471649,2021-05-21,1621551600.0
11666,53,1,2021-05-22,9759,2782,847517,474431,2021-05-22,1621638000.0
11667,53,1,2021-05-23,2039,229,849556,474660,2021-05-23,1621724400.0
11668,53,1,2021-05-24,13851,1932,863407,476592,2021-05-24,1621810800.0
11669,53,1,2021-05-25,18884,8410,882291,485002,2021-05-25,1621897200.0
11670,53,1,2021-05-26,18250,8857,900541,493859,2021-05-26,1621983600.0
11671,53,1,2021-05-27,19913,9509,920454,503368,2021-05-27,1622070000.0
11672,53,1,2021-05-28,17779,10466,938233,513834,2021-05-28,1622156400.0
11673,53,1,2021-05-29,8802,3706,947035,517540,2021-05-29,1622242800.0
11674,53,1,2021-05-30,2253,341,949288,517881,2021-05-30,1622329200.0
11675,53,1,2021-05-31,17920,9315,967208,527196,2021-05-31,1622415600.0
11676,53,1,2021-06-01,19123,9338,986331,536534,2021-06-01,1622502000.0
11677,53,1,2021-06-02,19310,7870,1005641,544404,2021-06-02,1622588400.0
11678,53,1,2021-06-03,21597,7454,1027238,551858,2021-06-03,1622674800.0
11679,53,1,2021-06-04,18249,10011,1045487,561869,2021-06-04,1622761200.0
11680,53,1,2021-06-05,14738,4273,1060225,566142,2021-06-05,1622847600.0
11681,53,1,2021-06-06,4869,978,1065094,567120,2021-06-06,1622934000.0
11682,53,1,2021-06-07,16531,12949,1081625,580069,2021-06-07,1623020400.0
11683,53,1,2021-06-08,20007,11973,1101632,592042,2021-06-08,1623106800.0
11684,53,1,2021-06-09,21190,10427,1122822,602469,2021-06-09,1623193200.0
11685,53,1,2021-06-10,23653,8327,1146475,610796,2021-06-10,1623279600.0
11686,53,1,2021-06-11,21494,10628,1167969,621424,2021-06-11,1623366000.0
11687,53,1,2021-06-12,16176,3878,1184145,625302,2021-06-12,1623452400.0
11688,53,1,2021-06-13,7666,569,1191811,625871,2021-06-13,1623538800.0
11689,53,1,2021-06-14,13898,14579,1205709,640450,2021-06-14,1623625200.0
11690,53,1,2021-06-15,16446,13356,1222155,653806,2021-06-15,1623711600.0
11691,53,1,2021-06-16,18702,11502,1240857,665308,2021-06-16,1623798000.0
11692,53,1,2021-06-17,19019,10553,1259876,675861,2021-06-17,1623884400.0
11693,53,1,2021-06-18,17901,13122,1277777,688983,2021-06-18,1623970800.0
11694,53,1,2021-06-19,11093,4056,1288870,693039,2021-06-19,1624057200.0
11695,53,1,2021-06-20,5375,1659,1294245,694698,2021-06-20,1624143600.0
11696,53,1,2021-06-21,12998,15483,1307243,710181,2021-06-21,1624230000.0
11697,53,1,2021-06-22,14100,16031,1321343,726212,2021-06-22,1624316400.0
11698,53,1,2021-06-23,14988,15788,1336331,742000,2021-06-23,1624402800.0
11699,53,1,2021-06-24,16748,11711,1353079,753711,2021-06-24,1624489200.0
11700,53,1,2021-06-25,12501,16790,1365580,770501,2021-06-25,1624575600.0
11701,53,1,2021-06-26,5802,8404,1371382,778905,2021-06-26,1624662000.0
11702,53,1,2021-06-27,3833,2921,1375215,781826,2021-06-27,1624748400.0
11703,53,1,2021-06-28,8592,18390,1383807,800216,2021-06-28,1624834800.0
11704,53,1,2021-06-29,9682,18744,1393489,818960,2021-06-29,1624921200.0
11705,53,1,2021-06-30,10821,18405,1404310,837365,2021-06-30,1625007600.0
11706,53,1,2021-07-01,12454,16124,1416764,853489,2021-07-01,1625094000.0
11707,53,1,2021-07-02,11023,19299,1427787,872788,2021-07-02,1625180400.0
11708,53,1,2021-07-03,5390,9798,1433177,882586,2021-07-03,1625266800.0
11709,53,1,2021-07-04,3786,3510,1436963,886096,2021-07-04,1625353200.0
11710,53,1,2021-07-05,8130,21965,1445093,908061,2021-07-05,1625439600.0
11711,53,1,2021-07-06,9235,21777,1454328,929838,2021-07-06,1625526000.0
11712,53,2,2020-12-27,0,0,0,0,2020-12-27,1609023600.0
11713,53,2,2020-12-28,0,0,0,0,2020-12-28,1609110000.0
11714,53,2,2020-12-29,0,0,0,0,2020-12-29,1609196400.0
11715,53,2,2020-12-30,0,0,0,0,2020-12-30,1609282800.0
11716,53,2,2020-12-31,0,0,0,0,2020-12-31,1609369200.0
11717,53,2,2021-01-01,0,0,0,0,2021-01-01,1609455600.0
11718,53,2,2021-01-02,0,0,0,0,2021-01-02,1609542000.0
11719,53,2,2021-01-03,0,0,0,0,2021-01-03,1609628400.0
11720,53,2,2021-01-04,0,0,0,0,2021-01-04,1609714800.0
11721,53,2,2021-01-05,0,0,0,0,2021-01-05,1609801200.0
11722,53,2,2021-01-06,0,0,0,0,2021-01-06,1609887600.0
11723,53,2,2021-01-07,0,0,0,0,2021-01-07,1609974000.0
11724,53,2,2021-01-08,0,0,0,0,2021-01-08,1610060400.0
11725,53,2,2021-01-09,0,0,0,0,2021-01-09,1610146800.0
11726,53,2,2021-01-10,0,0,0,0,2021-01-10,1610233200.0
11727,53,2,2021-01-11,0,0,0,0,2021-01-11,1610319600.0
11728,53,2,2021-01-12,0,0,0,0,2021-01-12,1610406000.0
11729,53,2,2021-01-13,0,0,0,0,2021-01-13,1610492400.0
11730,53,2,2021-01-14,1,0,1,0,2021-01-14,1610578800.0
11731,53,2,2021-01-15,0,0,1,0,2021-01-15,1610665200.0
11732,53,2,2021-01-16,0,0,1,0,2021-01-16,1610751600.0
11733,53,2,2021-01-17,0,0,1,0,2021-01-17,1610838000.0
11734,53,2,2021-01-18,0,0,1,0,2021-01-18,1610924400.0
11735,53,2,2021-01-19,2,0,3,0,2021-01-19,1611010800.0
11736,53,2,2021-01-20,3,0,6,0,2021-01-20,1611097200.0
11737,53,2,2021-01-21,1,0,7,0,2021-01-21,1611183600.0
11738,53,2,2021-01-22,1,0,8,0,2021-01-22,1611270000.0
11739,53,2,2021-01-23,0,0,8,0,2021-01-23,1611356400.0
11740,53,2,2021-01-24,0,0,8,0,2021-01-24,1611442800.0
11741,53,2,2021-01-25,0,0,8,0,2021-01-25,1611529200.0
11742,53,2,2021-01-26,0,0,8,0,2021-01-26,1611615600.0
11743,53,2,2021-01-27,0,0,8,0,2021-01-27,1611702000.0
11744,53,2,2021-01-28,0,0,8,0,2021-01-28,1611788400.0
11745,53,2,2021-01-29,1,0,9,0,2021-01-29,1611874800.0
11746,53,2,2021-01-30,0,0,9,0,2021-01-30,1611961200.0
11747,53,2,2021-01-31,0,0,9,0,2021-01-31,1612047600.0
11748,53,2,2021-02-01,0,0,9,0,2021-02-01,1612134000.0
11749,53,2,2021-02-02,0,0,9,0,2021-02-02,1612220400.0
11750,53,2,2021-02-03,0,0,9,0,2021-02-03,1612306800.0
11751,53,2,2021-02-04,0,0,9,0,2021-02-04,1612393200.0
11752,53,2,2021-02-05,0,0,9,0,2021-02-05,1612479600.0
11753,53,2,2021-02-06,0,0,9,0,2021-02-06,1612566000.0
11754,53,2,2021-02-07,0,0,9,0,2021-02-07,1612652400.0
11755,53,2,2021-02-08,0,0,9,0,2021-02-08,1612738800.0
11756,53,2,2021-02-09,0,1,9,1,2021-02-09,1612825200.0
11757,53,2,2021-02-10,0,1,9,2,2021-02-10,1612911600.0
11758,53,2,2021-02-11,107,1,116,3,2021-02-11,1612998000.0
11759,53,2,2021-02-12,94,1,210,4,2021-02-12,1613084400.0
11760,53,2,2021-02-13,0,0,210,4,2021-02-13,1613170800.0
11761,53,2,2021-02-14,0,0,210,4,2021-02-14,1613257200.0
11762,53,2,2021-02-15,407,0,617,4,2021-02-15,1613343600.0
11763,53,2,2021-02-16,564,2,1181,6,2021-02-16,1613430000.0
11764,53,2,2021-02-17,312,0,1493,6,2021-02-17,1613516400.0
11765,53,2,2021-02-18,259,2,1752,8,2021-02-18,1613602800.0
11766,53,2,2021-02-19,339,0,2091,8,2021-02-19,1613689200.0
11767,53,2,2021-02-20,1,0,2092,8,2021-02-20,1613775600.0
11768,53,2,2021-02-21,0,0,2092,8,2021-02-21,1613862000.0
11769,53,2,2021-02-22,137,0,2229,8,2021-02-22,1613948400.0
11770,53,2,2021-02-23,723,0,2952,8,2021-02-23,1614034800.0
11771,53,2,2021-02-24,637,1,3589,9,2021-02-24,1614121200.0
11772,53,2,2021-02-25,344,1,3933,10,2021-02-25,1614207600.0
11773,53,2,2021-02-26,229,0,4162,10,2021-02-26,1614294000.0
11774,53,2,2021-02-27,4,0,4166,10,2021-02-27,1614380400.0
11775,53,2,2021-02-28,0,0,4166,10,2021-02-28,1614466800.0
11776,53,2,2021-03-01,121,0,4287,10,2021-03-01,1614553200.0
11777,53,2,2021-03-02,141,0,4428,10,2021-03-02,1614639600.0
11778,53,2,2021-03-03,121,1,4549,11,2021-03-03,1614726000.0
11779,53,2,2021-03-04,68,0,4617,11,2021-03-04,1614812400.0
11780,53,2,2021-03-05,256,0,4873,11,2021-03-05,1614898800.0
11781,53,2,2021-03-06,0,0,4873,11,2021-03-06,1614985200.0
11782,53,2,2021-03-07,0,0,4873,11,2021-03-07,1615071600.0
11783,53,2,2021-03-08,159,0,5032,11,2021-03-08,1615158000.0
11784,53,2,2021-03-09,414,0,5446,11,2021-03-09,1615244400.0
11785,53,2,2021-03-10,352,51,5798,62,2021-03-10,1615330800.0
11786,53,2,2021-03-11,223,57,6021,119,2021-03-11,1615417200.0
11787,53,2,2021-03-12,497,83,6518,202,2021-03-12,1615503600.0
11788,53,2,2021-03-13,79,3,6597,205,2021-03-13,1615590000.0
11789,53,2,2021-03-14,12,0,6609,205,2021-03-14,1615676400.0
11790,53,2,2021-03-15,248,310,6857,515,2021-03-15,1615762800.0
11791,53,2,2021-03-16,1082,455,7939,970,2021-03-16,1615849200.0
11792,53,2,2021-03-17,2127,287,10066,1257,2021-03-17,1615935600.0
11793,53,2,2021-03-18,2154,263,12220,1520,2021-03-18,1616022000.0
11794,53,2,2021-03-19,2213,320,14433,1840,2021-03-19,1616108400.0
11795,53,2,2021-03-20,218,0,14651,1840,2021-03-20,1616194800.0
11796,53,2,2021-03-21,0,0,14651,1840,2021-03-21,1616281200.0
11797,53,2,2021-03-22,312,164,14963,2004,2021-03-22,1616367600.0
11798,53,2,2021-03-23,972,648,15935,2652,2021-03-23,1616454000.0
11799,53,2,2021-03-24,1078,578,17013,3230,2021-03-24,1616540400.0
11800,53,2,2021-03-25,1440,345,18453,3575,2021-03-25,1616626800.0
11801,53,2,2021-03-26,1444,273,19897,3848,2021-03-26,1616713200.0
11802,53,2,2021-03-27,102,22,19999,3870,2021-03-27,1616799600.0
11803,53,2,2021-03-28,72,50,20071,3920,2021-03-28,1616886000.0
11804,53,2,2021-03-29,544,138,20615,4058,2021-03-29,1616972400.0
11805,53,2,2021-03-30,1463,147,22078,4205,2021-03-30,1617058800.0
11806,53,2,2021-03-31,1340,184,23418,4389,2021-03-31,1617145200.0
11807,53,2,2021-04-01,1852,61,25270,4450,2021-04-01,1617231600.0
11808,53,2,2021-04-02,1421,177,26691,4627,2021-04-02,1617318000.0
11809,53,2,2021-04-03,1,0,26692,4627,2021-04-03,1617404400.0
11810,53,2,2021-04-04,0,0,26692,4627,2021-04-04,1617490800.0
11811,53,2,2021-04-05,4,0,26696,4627,2021-04-05,1617577200.0
11812,53,2,2021-04-06,1274,239,27970,4866,2021-04-06,1617663600.0
11813,53,2,2021-04-07,1269,252,29239,5118,2021-04-07,1617750000.0
11814,53,2,2021-04-08,2102,231,31341,5349,2021-04-08,1617836400.0
11815,53,2,2021-04-09,1498,441,32839,5790,2021-04-09,1617922800.0
11816,53,2,2021-04-10,648,43,33487,5833,2021-04-10,1618009200.0
11817,53,2,2021-04-11,421,23,33908,5856,2021-04-11,1618095600.0
11818,53,2,2021-04-12,1337,431,35245,6287,2021-04-12,1618185600.0
11819,53,2,2021-04-13,1629,864,36874,7151,2021-04-13,1618272000.0
11820,53,2,2021-04-14,1138,2028,38012,9179,2021-04-14,1618358400.0
11821,53,2,2021-04-15,2278,1995,40290,11174,2021-04-15,1618444800.0
11822,53,2,2021-04-16,1857,2021,42147,13195,2021-04-16,1618531200.0
11823,53,2,2021-04-17,1015,224,43162,13419,2021-04-17,1618617600.0
11824,53,2,2021-04-18,3,0,43165,13419,2021-04-18,1618704000.0
11825,53,2,2021-04-19,1342,462,44507,13881,2021-04-19,1618790400.0
11826,53,2,2021-04-20,1237,924,45744,14805,2021-04-20,1618876800.0
11827,53,2,2021-04-21,1159,921,46903,15726,2021-04-21,1618963200.0
11828,53,2,2021-04-22,3019,1197,49922,16923,2021-04-22,1619049600.0
11829,53,2,2021-04-23,2374,1498,52296,18421,2021-04-23,1619136000.0
11830,53,2,2021-04-24,907,18,53203,18439,2021-04-24,1619222400.0
11831,53,2,2021-04-25,0,0,53203,18439,2021-04-25,1619308800.0
11832,53,2,2021-04-26,1789,631,54992,19070,2021-04-26,1619395200.0
11833,53,2,2021-04-27,1354,1421,56346,20491,2021-04-27,1619481600.0
11834,53,2,2021-04-28,1347,1253,57693,21744,2021-04-28,1619568000.0
11835,53,2,2021-04-29,3494,1752,61187,23496,2021-04-29,1619654400.0
11836,53,2,2021-04-30,3060,1171,64247,24667,2021-04-30,1619740800.0
11837,53,2,2021-05-01,169,2,64416,24669,2021-05-01,1619827200.0
11838,53,2,2021-05-02,2277,83,66693,24752,2021-05-02,1619913600.0
11839,53,2,2021-05-03,1526,756,68219,25508,2021-05-03,1620000000.0
11840,53,2,2021-05-04,1205,1200,69424,26708,2021-05-04,1620086400.0
11841,53,2,2021-05-05,1004,1287,70428,27995,2021-05-05,1620172800.0
11842,53,2,2021-05-06,1457,2365,71885,30360,2021-05-06,1620259200.0
11843,53,2,2021-05-07,1245,2140,73130,32500,2021-05-07,1620345600.0
11844,53,2,2021-05-08,2103,21,75233,32521,2021-05-08,1620432000.0
11845,53,2,2021-05-09,1415,415,76648,32936,2021-05-09,1620518400.0
11846,53,2,2021-05-10,3050,1671,79698,34607,2021-05-10,1620604800.0
11847,53,2,2021-05-11,2247,1991,81945,36598,2021-05-11,1620691200.0
11848,53,2,2021-05-12,2831,1530,84776,38128,2021-05-12,1620777600.0
11849,53,2,2021-05-13,1790,225,86566,38353,2021-05-13,1620864000.0
11850,53,2,2021-05-14,2523,1423,89089,39776,2021-05-14,1620950400.0
11851,53,2,2021-05-15,3625,539,92714,40315,2021-05-15,1621036800.0
11852,53,2,2021-05-16,1,0,92715,40315,2021-05-16,1621123200.0
11853,53,2,2021-05-17,3178,1461,95893,41776,2021-05-17,1621206000.0
11854,53,2,2021-05-18,3177,1346,99070,43122,2021-05-18,1621292400.0
11855,53,2,2021-05-19,3499,956,102569,44078,2021-05-19,1621378800.0
11856,53,2,2021-05-20,4103,2256,106672,46334,2021-05-20,1621465200.0
11857,53,2,2021-05-21,2147,1399,108819,47733,2021-05-21,1621551600.0
11858,53,2,2021-05-22,2734,764,111553,48497,2021-05-22,1621638000.0
11859,53,2,2021-05-23,941,2,112494,48499,2021-05-23,1621724400.0
11860,53,2,2021-05-24,132,83,112626,48582,2021-05-24,1621810800.0
11861,53,2,2021-05-25,408,1389,113034,49971,2021-05-25,1621897200.0
11862,53,2,2021-05-26,402,1110,113436,51081,2021-05-26,1621983600.0
11863,53,2,2021-05-27,559,1657,113995,52738,2021-05-27,1622070000.0
11864,53,2,2021-05-28,1454,1578,115449,54316,2021-05-28,1622156400.0
11865,53,2,2021-05-29,2516,352,117965,54668,2021-05-29,1622242800.0
11866,53,2,2021-05-30,34,6,117999,54674,2021-05-30,1622329200.0
11867,53,2,2021-05-31,1850,1702,119849,56376,2021-05-31,1622415600.0
11868,53,2,2021-06-01,2708,2125,122557,58501,2021-06-01,1622502000.0
11869,53,2,2021-06-02,1546,1617,124103,60118,2021-06-02,1622588400.0
11870,53,2,2021-06-03,2094,2099,126197,62217,2021-06-03,1622674800.0
11871,53,2,2021-06-04,3069,2581,129266,64798,2021-06-04,1622761200.0
11872,53,2,2021-06-05,1836,861,131102,65659,2021-06-05,1622847600.0
11873,53,2,2021-06-06,108,14,131210,65673,2021-06-06,1622934000.0
11874,53,2,2021-06-07,1281,2168,132491,67841,2021-06-07,1623020400.0
11875,53,2,2021-06-08,2322,1810,134813,69651,2021-06-08,1623106800.0
11876,53,2,2021-06-09,1722,1648,136535,71299,2021-06-09,1623193200.0
11877,53,2,2021-06-10,1951,2228,138486,73527,2021-06-10,1623279600.0
11878,53,2,2021-06-11,3551,2206,142037,75733,2021-06-11,1623366000.0
11879,53,2,2021-06-12,2048,727,144085,76460,2021-06-12,1623452400.0
11880,53,2,2021-06-13,97,2158,144182,78618,2021-06-13,1623538800.0
11881,53,2,2021-06-14,1670,1702,145852,80320,2021-06-14,1623625200.0
11882,53,2,2021-06-15,2894,1485,148746,81805,2021-06-15,1623711600.0
11883,53,2,2021-06-16,1853,1222,150599,83027,2021-06-16,1623798000.0
11884,53,2,2021-06-17,2229,1593,152828,84620,2021-06-17,1623884400.0
11885,53,2,2021-06-18,3330,1574,156158,86194,2021-06-18,1623970800.0
11886,53,2,2021-06-19,1368,2481,157526,88675,2021-06-19,1624057200.0
11887,53,2,2021-06-20,55,741,157581,89416,2021-06-20,1624143600.0
11888,53,2,2021-06-21,1249,3106,158830,92522,2021-06-21,1624230000.0
11889,53,2,2021-06-22,2323,2820,161153,95342,2021-06-22,1624316400.0
11890,53,2,2021-06-23,1360,2686,162513,98028,2021-06-23,1624402800.0
11891,53,2,2021-06-24,1758,2866,164271,100894,2021-06-24,1624489200.0
11892,53,2,2021-06-25,2385,3354,166656,104248,2021-06-25,1624575600.0
11893,53,2,2021-06-26,1082,3235,167738,107483,2021-06-26,1624662000.0
11894,53,2,2021-06-27,27,32,167765,107515,2021-06-27,1624748400.0
11895,53,2,2021-06-28,812,2987,168577,110502,2021-06-28,1624834800.0
11896,53,2,2021-06-29,1248,3234,169825,113736,2021-06-29,1624921200.0
11897,53,2,2021-06-30,835,3372,170660,117108,2021-06-30,1625007600.0
11898,53,2,2021-07-01,1126,3830,171786,120938,2021-07-01,1625094000.0
11899,53,2,2021-07-02,1429,2227,173215,123165,2021-07-02,1625180400.0
11900,53,2,2021-07-03,863,3139,174078,126304,2021-07-03,1625266800.0
11901,53,2,2021-07-04,44,661,174122,126965,2021-07-04,1625353200.0
11902,53,2,2021-07-05,564,1086,174686,128051,2021-07-05,1625439600.0
11903,53,2,2021-07-06,879,1358,175565,129409,2021-07-06,1625526000.0
11904,53,3,2020-12-27,0,0,0,0,2020-12-27,1609023600.0
11905,53,3,2020-12-28,0,0,0,0,2020-12-28,1609110000.0
11906,53,3,2020-12-29,0,0,0,0,2020-12-29,1609196400.0
11907,53,3,2020-12-30,0,0,0,0,2020-12-30,1609282800.0
11908,53,3,2020-12-31,0,0,0,0,2020-12-31,1609369200.0
11909,53,3,2021-01-01,0,0,0,0,2021-01-01,1609455600.0
11910,53,3,2021-01-02,0,0,0,0,2021-01-02,1609542000.0
11911,53,3,2021-01-03,0,0,0,0,2021-01-03,1609628400.0
11912,53,3,2021-01-04,0,0,0,0,2021-01-04,1609714800.0
11913,53,3,2021-01-05,0,0,0,0,2021-01-05,1609801200.0
11914,53,3,2021-01-06,0,0,0,0,2021-01-06,1609887600.0
11915,53,3,2021-01-07,0,0,0,0,2021-01-07,1609974000.0
11916,53,3,2021-01-08,0,0,0,0,2021-01-08,1610060400.0
11917,53,3,2021-01-09,0,0,0,0,2021-01-09,1610146800.0
11918,53,3,2021-01-10,0,0,0,0,2021-01-10,1610233200.0
11919,53,3,2021-01-11,0,0,0,0,2021-01-11,1610319600.0
11920,53,3,2021-01-12,0,0,0,0,2021-01-12,1610406000.0
11921,53,3,2021-01-13,0,0,0,0,2021-01-13,1610492400.0
11922,53,3,2021-01-14,0,0,0,0,2021-01-14,1610578800.0
11923,53,3,2021-01-15,0,0,0,0,2021-01-15,1610665200.0
11924,53,3,2021-01-16,0,0,0,0,2021-01-16,1610751600.0
11925,53,3,2021-01-17,0,0,0,0,2021-01-17,1610838000.0
11926,53,3,2021-01-18,0,0,0,0,2021-01-18,1610924400.0
11927,53,3,2021-01-19,0,0,0,0,2021-01-19,1611010800.0
11928,53,3,2021-01-20,0,0,0,0,2021-01-20,1611097200.0
11929,53,3,2021-01-21,0,0,0,0,2021-01-21,1611183600.0
11930,53,3,2021-01-22,0,0,0,0,2021-01-22,1611270000.0
11931,53,3,2021-01-23,0,0,0,0,2021-01-23,1611356400.0
11932,53,3,2021-01-24,0,0,0,0,2021-01-24,1611442800.0
11933,53,3,2021-01-25,0,0,0,0,2021-01-25,1611529200.0
11934,53,3,2021-01-26,0,0,0,0,2021-01-26,1611615600.0
11935,53,3,2021-01-27,0,0,0,0,2021-01-27,1611702000.0
11936,53,3,2021-01-28,0,0,0,0,2021-01-28,1611788400.0
11937,53,3,2021-01-29,0,0,0,0,2021-01-29,1611874800.0
11938,53,3,2021-01-30,0,0,0,0,2021-01-30,1611961200.0
11939,53,3,2021-01-31,0,0,0,0,2021-01-31,1612047600.0
11940,53,3,2021-02-01,0,0,0,0,2021-02-01,1612134000.0
11941,53,3,2021-02-02,0,0,0,0,2021-02-02,1612220400.0
11942,53,3,2021-02-03,0,0,0,0,2021-02-03,1612306800.0
11943,53,3,2021-02-04,0,0,0,0,2021-02-04,1612393200.0
11944,53,3,2021-02-05,0,0,0,0,2021-02-05,1612479600.0
11945,53,3,2021-02-06,6,0,6,0,2021-02-06,1612566000.0
11946,53,3,2021-02-07,0,0,6,0,2021-02-07,1612652400.0
11947,53,3,2021-02-08,117,0,123,0,2021-02-08,1612738800.0
11948,53,3,2021-02-09,282,0,405,0,2021-02-09,1612825200.0
11949,53,3,2021-02-10,330,0,735,0,2021-02-10,1612911600.0
11950,53,3,2021-02-11,452,0,1187,0,2021-02-11,1612998000.0
11951,53,3,2021-02-12,441,0,1628,0,2021-02-12,1613084400.0
11952,53,3,2021-02-13,4,0,1632,0,2021-02-13,1613170800.0
11953,53,3,2021-02-14,0,0,1632,0,2021-02-14,1613257200.0
11954,53,3,2021-02-15,491,0,2123,0,2021-02-15,1613343600.0
11955,53,3,2021-02-16,829,0,2952,0,2021-02-16,1613430000.0
11956,53,3,2021-02-17,961,0,3913,0,2021-02-17,1613516400.0
11957,53,3,2021-02-18,1291,0,5204,0,2021-02-18,1613602800.0
11958,53,3,2021-02-19,1657,0,6861,0,2021-02-19,1613689200.0
11959,53,3,2021-02-20,343,0,7204,0,2021-02-20,1613775600.0
11960,53,3,2021-02-21,45,0,7249,0,2021-02-21,1613862000.0
11961,53,3,2021-02-22,799,0,8048,0,2021-02-22,1613948400.0
11962,53,3,2021-02-23,639,0,8687,0,2021-02-23,1614034800.0
11963,53,3,2021-02-24,1233,0,9920,0,2021-02-24,1614121200.0
11964,53,3,2021-02-25,3660,0,13580,0,2021-02-25,1614207600.0
11965,53,3,2021-02-26,4842,0,18422,0,2021-02-26,1614294000.0
11966,53,3,2021-02-27,2407,0,20829,0,2021-02-27,1614380400.0
11967,53,3,2021-02-28,71,0,20900,0,2021-02-28,1614466800.0
11968,53,3,2021-03-01,1084,0,21984,0,2021-03-01,1614553200.0
11969,53,3,2021-03-02,1956,0,23940,0,2021-03-02,1614639600.0
11970,53,3,2021-03-03,2515,1,26455,1,2021-03-03,1614726000.0
11971,53,3,2021-03-04,4754,0,31209,1,2021-03-04,1614812400.0
11972,53,3,2021-03-05,6907,1,38116,2,2021-03-05,1614898800.0
11973,53,3,2021-03-06,4282,2,42398,4,2021-03-06,1614985200.0
11974,53,3,2021-03-07,781,0,43179,4,2021-03-07,1615071600.0
11975,53,3,2021-03-08,2294,1,45473,5,2021-03-08,1615158000.0
11976,53,3,2021-03-09,4757,1,50230,6,2021-03-09,1615244400.0
11977,53,3,2021-03-10,4574,2,54804,8,2021-03-10,1615330800.0
11978,53,3,2021-03-11,8348,2,63152,10,2021-03-11,1615417200.0
11979,53,3,2021-03-12,12988,3,76140,13,2021-03-12,1615503600.0
11980,53,3,2021-03-13,7232,3,83372,16,2021-03-13,1615590000.0
11981,53,3,2021-03-14,435,0,83807,16,2021-03-14,1615676400.0
11982,53,3,2021-03-15,2608,1,86415,17,2021-03-15,1615762800.0
11983,53,3,2021-03-16,78,0,86493,17,2021-03-16,1615849200.0
11984,53,3,2021-03-17,100,0,86593,17,2021-03-17,1615935600.0
11985,53,3,2021-03-18,46,0,86639,17,2021-03-18,1616022000.0
11986,53,3,2021-03-19,5090,0,91729,17,2021-03-19,1616108400.0
11987,53,3,2021-03-20,3521,1,95250,18,2021-03-20,1616194800.0
11988,53,3,2021-03-21,110,0,95360,18,2021-03-21,1616281200.0
11989,53,3,2021-03-22,1920,1,97280,19,2021-03-22,1616367600.0
11990,53,3,2021-03-23,4759,2,102039,21,2021-03-23,1616454000.0
11991,53,3,2021-03-24,5704,8,107743,29,2021-03-24,1616540400.0
11992,53,3,2021-03-25,8824,3,116567,32,2021-03-25,1616626800.0
11993,53,3,2021-03-26,11023,5,127590,37,2021-03-26,1616713200.0
11994,53,3,2021-03-27,3691,0,131281,37,2021-03-27,1616799600.0
11995,53,3,2021-03-28,127,0,131408,37,2021-03-28,1616886000.0
11996,53,3,2021-03-29,3066,0,134474,37,2021-03-29,1616972400.0
11997,53,3,2021-03-30,4997,5,139471,42,2021-03-30,1617058800.0
11998,53,3,2021-03-31,3820,2,143291,44,2021-03-31,1617145200.0
11999,53,3,2021-04-01,5066,5,148357,49,2021-04-01,1617231600.0
12000,53,3,2021-04-02,6129,8,154486,57,2021-04-02,1617318000.0
12001,53,3,2021-04-03,1872,4,156358,61,2021-04-03,1617404400.0
12002,53,3,2021-04-04,39,0,156397,61,2021-04-04,1617490800.0
12003,53,3,2021-04-05,58,0,156455,61,2021-04-05,1617577200.0
12004,53,3,2021-04-06,1503,0,157958,61,2021-04-06,1617663600.0
12005,53,3,2021-04-07,2214,3,160172,64,2021-04-07,1617750000.0
12006,53,3,2021-04-08,6055,1,166227,65,2021-04-08,1617836400.0
12007,53,3,2021-04-09,12196,31,178423,96,2021-04-09,1617922800.0
12008,53,3,2021-04-10,4489,10,182912,106,2021-04-10,1618009200.0
12009,53,3,2021-04-11,104,0,183016,106,2021-04-11,1618095600.0
12010,53,3,2021-04-12,3489,2,186505,108,2021-04-12,1618185600.0
12011,53,3,2021-04-13,6079,9,192584,117,2021-04-13,1618272000.0
12012,53,3,2021-04-14,4843,4,197427,121,2021-04-14,1618358400.0
12013,53,3,2021-04-15,6928,4,204355,125,2021-04-15,1618444800.0
12014,53,3,2021-04-16,9544,29,213899,154,2021-04-16,1618531200.0
12015,53,3,2021-04-17,3679,3,217578,157,2021-04-17,1618617600.0
12016,53,3,2021-04-18,68,0,217646,157,2021-04-18,1618704000.0
12017,53,3,2021-04-19,2031,3,219677,160,2021-04-19,1618790400.0
12018,53,3,2021-04-20,3434,12,223111,172,2021-04-20,1618876800.0
12019,53,3,2021-04-21,3318,12,226429,184,2021-04-21,1618963200.0
12020,53,3,2021-04-22,4480,33,230909,217,2021-04-22,1619049600.0
12021,53,3,2021-04-23,6489,53,237398,270,2021-04-23,1619136000.0
12022,53,3,2021-04-24,3117,36,240515,306,2021-04-24,1619222400.0
12023,53,3,2021-04-25,26,0,240541,306,2021-04-25,1619308800.0
12024,53,3,2021-04-26,1510,4,242051,310,2021-04-26,1619395200.0
12025,53,3,2021-04-27,2727,34,244778,344,2021-04-27,1619481600.0
12026,53,3,2021-04-28,2038,66,246816,410,2021-04-28,1619568000.0
12027,53,3,2021-04-29,3731,449,250547,859,2021-04-29,1619654400.0
12028,53,3,2021-04-30,4695,513,255242,1372,2021-04-30,1619740800.0
12029,53,3,2021-05-01,890,84,256132,1456,2021-05-01,1619827200.0
12030,53,3,2021-05-02,71,16,256203,1472,2021-05-02,1619913600.0
12031,53,3,2021-05-03,981,84,257184,1556,2021-05-03,1620000000.0
12032,53,3,2021-05-04,1829,314,259013,1870,2021-05-04,1620086400.0
12033,53,3,2021-05-05,1443,465,260456,2335,2021-05-05,1620172800.0
12034,53,3,2021-05-06,2952,1078,263408,3413,2021-05-06,1620259200.0
12035,53,3,2021-05-07,4101,1273,267509,4686,2021-05-07,1620345600.0
12036,53,3,2021-05-08,246,197,267755,4883,2021-05-08,1620432000.0
12037,53,3,2021-05-09,30,24,267785,4907,2021-05-09,1620518400.0
12038,53,3,2021-05-10,1192,419,268977,5326,2021-05-10,1620604800.0
12039,53,3,2021-05-11,2241,1029,271218,6355,2021-05-11,1620691200.0
12040,53,3,2021-05-12,1280,1391,272498,7746,2021-05-12,1620777600.0
12041,53,3,2021-05-13,161,181,272659,7927,2021-05-13,1620864000.0
12042,53,3,2021-05-14,1237,1382,273896,9309,2021-05-14,1620950400.0
12043,53,3,2021-05-15,518,999,274414,10308,2021-05-15,1621036800.0
12044,53,3,2021-05-16,14,234,274428,10542,2021-05-16,1621123200.0
12045,53,3,2021-05-17,575,766,275003,11308,2021-05-17,1621206000.0
12046,53,3,2021-05-18,1102,1672,276105,12980,2021-05-18,1621292400.0
12047,53,3,2021-05-19,609,1872,276714,14852,2021-05-19,1621378800.0
12048,53,3,2021-05-20,877,3014,277591,17866,2021-05-20,1621465200.0
12049,53,3,2021-05-21,1012,4225,278603,22091,2021-05-21,1621551600.0
12050,53,3,2021-05-22,318,1677,278921,23768,2021-05-22,1621638000.0
12051,53,3,2021-05-23,12,26,278933,23794,2021-05-23,1621724400.0
12052,53,3,2021-05-24,9,118,278942,23912,2021-05-24,1621810800.0
12053,53,3,2021-05-25,280,2027,279222,25939,2021-05-25,1621897200.0
12054,53,3,2021-05-26,214,2844,279436,28783,2021-05-26,1621983600.0
12055,53,3,2021-05-27,351,4398,279787,33181,2021-05-27,1622070000.0
12056,53,3,2021-05-28,461,5720,280248,38901,2021-05-28,1622156400.0
12057,53,3,2021-05-29,147,2320,280395,41221,2021-05-29,1622242800.0
12058,53,3,2021-05-30,6,40,280401,41261,2021-05-30,1622329200.0
12059,53,3,2021-05-31,169,1740,280570,43001,2021-05-31,1622415600.0
12060,53,3,2021-06-01,138,3382,280708,46383,2021-06-01,1622502000.0
12061,53,3,2021-06-02,142,3338,280850,49721,2021-06-02,1622588400.0
12062,53,3,2021-06-03,184,5373,281034,55094,2021-06-03,1622674800.0
12063,53,3,2021-06-04,227,7713,281261,62807,2021-06-04,1622761200.0
12064,53,3,2021-06-05,96,2784,281357,65591,2021-06-05,1622847600.0
12065,53,3,2021-06-06,4,141,281361,65732,2021-06-06,1622934000.0
12066,53,3,2021-06-07,31,1549,281392,67281,2021-06-07,1623020400.0
12067,53,3,2021-06-08,85,2570,281477,69851,2021-06-08,1623106800.0
12068,53,3,2021-06-09,64,2336,281541,72187,2021-06-09,1623193200.0
12069,53,3,2021-06-10,120,4356,281661,76543,2021-06-10,1623279600.0
12070,53,3,2021-06-11,131,6591,281792,83134,2021-06-11,1623366000.0
12071,53,3,2021-06-12,38,2012,281830,85146,2021-06-12,1623452400.0
12072,53,3,2021-06-13,1,105,281831,85251,2021-06-13,1623538800.0
12073,53,3,2021-06-14,28,2470,281859,87721,2021-06-14,1623625200.0
12074,53,3,2021-06-15,64,4764,281923,92485,2021-06-15,1623711600.0
12075,53,3,2021-06-16,44,4452,281967,96937,2021-06-16,1623798000.0
12076,53,3,2021-06-17,72,6540,282039,103477,2021-06-17,1623884400.0
12077,53,3,2021-06-18,122,9250,282161,112727,2021-06-18,1623970800.0
12078,53,3,2021-06-19,23,2275,282184,115002,2021-06-19,1624057200.0
12079,53,3,2021-06-20,0,60,282184,115062,2021-06-20,1624143600.0
12080,53,3,2021-06-21,35,2786,282219,117848,2021-06-21,1624230000.0
12081,53,3,2021-06-22,28,4682,282247,122530,2021-06-22,1624316400.0
12082,53,3,2021-06-23,38,3891,282285,126421,2021-06-23,1624402800.0
12083,53,3,2021-06-24,54,5759,282339,132180,2021-06-24,1624489200.0
12084,53,3,2021-06-25,82,7515,282421,139695,2021-06-25,1624575600.0
12085,53,3,2021-06-26,15,1771,282436,141466,2021-06-26,1624662000.0
12086,53,3,2021-06-27,4,182,282440,141648,2021-06-27,1624748400.0
12087,53,3,2021-06-28,18,2081,282458,143729,2021-06-28,1624834800.0
12088,53,3,2021-06-29,33,4118,282491,147847,2021-06-29,1624921200.0
12089,53,3,2021-06-30,35,3647,282526,151494,2021-06-30,1625007600.0
12090,53,3,2021-07-01,51,5458,282577,156952,2021-07-01,1625094000.0
12091,53,3,2021-07-02,62,8735,282639,165687,2021-07-02,1625180400.0
12092,53,3,2021-07-03,20,1866,282659,167553,2021-07-03,1625266800.0
12093,53,3,2021-07-04,1,69,282660,167622,2021-07-04,1625353200.0
12094,53,3,2021-07-05,20,2617,282680,170239,2021-07-05,1625439600.0
12095,53,3,2021-07-06,41,4961,282721,175200,2021-07-06,1625526000.0
12096,53,4,2020-12-27,0,0,0,0,2020-12-27,1609023600.0
12097,53,4,2020-12-28,0,0,0,0,2020-12-28,1609110000.0
12098,53,4,2020-12-29,0,0,0,0,2020-12-29,1609196400.0
12099,53,4,2020-12-30,0,0,0,0,2020-12-30,1609282800.0
12100,53,4,2020-12-31,0,0,0,0,2020-12-31,1609369200.0
12101,53,4,2021-01-01,0,0,0,0,2021-01-01,1609455600.0
12102,53,4,2021-01-02,0,0,0,0,2021-01-02,1609542000.0
12103,53,4,2021-01-03,0,0,0,0,2021-01-03,1609628400.0
12104,53,4,2021-01-04,0,0,0,0,2021-01-04,1609714800.0
12105,53,4,2021-01-05,0,0,0,0,2021-01-05,1609801200.0
12106,53,4,2021-01-06,0,0,0,0,2021-01-06,1609887600.0
12107,53,4,2021-01-07,0,0,0,0,2021-01-07,1609974000.0
12108,53,4,2021-01-08,0,0,0,0,2021-01-08,1610060400.0
12109,53,4,2021-01-09,0,0,0,0,2021-01-09,1610146800.0
12110,53,4,2021-01-10,0,0,0,0,2021-01-10,1610233200.0
12111,53,4,2021-01-11,0,0,0,0,2021-01-11,1610319600.0
12112,53,4,2021-01-12,0,0,0,0,2021-01-12,1610406000.0
12113,53,4,2021-01-13,0,0,0,0,2021-01-13,1610492400.0
12114,53,4,2021-01-14,0,0,0,0,2021-01-14,1610578800.0
12115,53,4,2021-01-15,0,0,0,0,2021-01-15,1610665200.0
12116,53,4,2021-01-16,0,0,0,0,2021-01-16,1610751600.0
12117,53,4,2021-01-17,0,0,0,0,2021-01-17,1610838000.0
12118,53,4,2021-01-18,0,0,0,0,2021-01-18,1610924400.0
12119,53,4,2021-01-19,0,0,0,0,2021-01-19,1611010800.0
12120,53,4,2021-01-20,0,0,0,0,2021-01-20,1611097200.0
12121,53,4,2021-01-21,0,0,0,0,2021-01-21,1611183600.0
12122,53,4,2021-01-22,0,0,0,0,2021-01-22,1611270000.0
12123,53,4,2021-01-23,0,0,0,0,2021-01-23,1611356400.0
12124,53,4,2021-01-24,0,0,0,0,2021-01-24,1611442800.0
12125,53,4,2021-01-25,0,0,0,0,2021-01-25,1611529200.0
12126,53,4,2021-01-26,0,0,0,0,2021-01-26,1611615600.0
12127,53,4,2021-01-27,0,0,0,0,2021-01-27,1611702000.0
12128,53,4,2021-01-28,0,0,0,0,2021-01-28,1611788400.0
12129,53,4,2021-01-29,0,0,0,0,2021-01-29,1611874800.0
12130,53,4,2021-01-30,0,0,0,0,2021-01-30,1611961200.0
12131,53,4,2021-01-31,0,0,0,0,2021-01-31,1612047600.0
12132,53,4,2021-02-01,0,0,0,0,2021-02-01,1612134000.0
12133,53,4,2021-02-02,0,0,0,0,2021-02-02,1612220400.0
12134,53,4,2021-02-03,0,0,0,0,2021-02-03,1612306800.0
12135,53,4,2021-02-04,0,0,0,0,2021-02-04,1612393200.0
12136,53,4,2021-02-05,0,0,0,0,2021-02-05,1612479600.0
12137,53,4,2021-02-06,0,0,0,0,2021-02-06,1612566000.0
12138,53,4,2021-02-07,0,0,0,0,2021-02-07,1612652400.0
12139,53,4,2021-02-08,0,0,0,0,2021-02-08,1612738800.0
12140,53,4,2021-02-09,0,0,0,0,2021-02-09,1612825200.0
12141,53,4,2021-02-10,0,0,0,0,2021-02-10,1612911600.0
12142,53,4,2021-02-11,0,0,0,0,2021-02-11,1612998000.0
12143,53,4,2021-02-12,0,0,0,0,2021-02-12,1613084400.0
12144,53,4,2021-02-13,0,0,0,0,2021-02-13,1613170800.0
12145,53,4,2021-02-14,0,0,0,0,2021-02-14,1613257200.0
12146,53,4,2021-02-15,0,0,0,0,2021-02-15,1613343600.0
12147,53,4,2021-02-16,0,0,0,0,2021-02-16,1613430000.0
12148,53,4,2021-02-17,0,0,0,0,2021-02-17,1613516400.0
12149,53,4,2021-02-18,0,0,0,0,2021-02-18,1613602800.0
12150,53,4,2021-02-19,0,0,0,0,2021-02-19,1613689200.0
12151,53,4,2021-02-20,0,0,0,0,2021-02-20,1613775600.0
12152,53,4,2021-02-21,0,0,0,0,2021-02-21,1613862000.0
12153,53,4,2021-02-22,0,0,0,0,2021-02-22,1613948400.0
12154,53,4,2021-02-23,0,0,0,0,2021-02-23,1614034800.0
12155,53,4,2021-02-24,0,0,0,0,2021-02-24,1614121200.0
12156,53,4,2021-02-25,0,0,0,0,2021-02-25,1614207600.0
12157,53,4,2021-02-26,0,0,0,0,2021-02-26,1614294000.0
12158,53,4,2021-02-27,0,0,0,0,2021-02-27,1614380400.0
12159,53,4,2021-02-28,0,0,0,0,2021-02-28,1614466800.0
12160,53,4,2021-03-01,0,0,0,0,2021-03-01,1614553200.0
12161,53,4,2021-03-02,0,0,0,0,2021-03-02,1614639600.0
12162,53,4,2021-03-03,0,0,0,0,2021-03-03,1614726000.0
12163,53,4,2021-03-04,0,0,0,0,2021-03-04,1614812400.0
12164,53,4,2021-03-05,0,0,0,0,2021-03-05,1614898800.0
12165,53,4,2021-03-06,0,0,0,0,2021-03-06,1614985200.0
12166,53,4,2021-03-07,0,0,0,0,2021-03-07,1615071600.0
12167,53,4,2021-03-08,0,0,0,0,2021-03-08,1615158000.0
12168,53,4,2021-03-09,0,0,0,0,2021-03-09,1615244400.0
12169,53,4,2021-03-10,0,0,0,0,2021-03-10,1615330800.0
12170,53,4,2021-03-11,0,0,0,0,2021-03-11,1615417200.0
12171,53,4,2021-03-12,0,0,0,0,2021-03-12,1615503600.0
12172,53,4,2021-03-13,0,0,0,0,2021-03-13,1615590000.0
12173,53,4,2021-03-14,0,0,0,0,2021-03-14,1615676400.0
12174,53,4,2021-03-15,0,0,0,0,2021-03-15,1615762800.0
12175,53,4,2021-03-16,0,0,0,0,2021-03-16,1615849200.0
12176,53,4,2021-03-17,0,0,0,0,2021-03-17,1615935600.0
12177,53,4,2021-03-18,0,0,0,0,2021-03-18,1616022000.0
12178,53,4,2021-03-19,0,0,0,0,2021-03-19,1616108400.0
12179,53,4,2021-03-20,0,0,0,0,2021-03-20,1616194800.0
12180,53,4,2021-03-21,0,0,0,0,2021-03-21,1616281200.0
12181,53,4,2021-03-22,0,0,0,0,2021-03-22,1616367600.0
12182,53,4,2021-03-23,0,0,0,0,2021-03-23,1616454000.0
12183,53,4,2021-03-24,0,0,0,0,2021-03-24,1616540400.0
12184,53,4,2021-03-25,0,0,0,0,2021-03-25,1616626800.0
12185,53,4,2021-03-26,0,0,0,0,2021-03-26,1616713200.0
12186,53,4,2021-03-27,0,0,0,0,2021-03-27,1616799600.0
12187,53,4,2021-03-28,0,0,0,0,2021-03-28,1616886000.0
12188,53,4,2021-03-29,0,0,0,0,2021-03-29,1616972400.0
12189,53,4,2021-03-30,0,0,0,0,2021-03-30,1617058800.0
12190,53,4,2021-03-31,0,0,0,0,2021-03-31,1617145200.0
12191,53,4,2021-04-01,0,0,0,0,2021-04-01,1617231600.0
12192,53,4,2021-04-02,0,0,0,0,2021-04-02,1617318000.0
12193,53,4,2021-04-03,0,0,0,0,2021-04-03,1617404400.0
12194,53,4,2021-04-04,0,0,0,0,2021-04-04,1617490800.0
12195,53,4,2021-04-05,0,0,0,0,2021-04-05,1617577200.0
12196,53,4,2021-04-06,0,0,0,0,2021-04-06,1617663600.0
12197,53,4,2021-04-07,0,0,0,0,2021-04-07,1617750000.0
12198,53,4,2021-04-08,0,0,0,0,2021-04-08,1617836400.0
12199,53,4,2021-04-09,0,0,0,0,2021-04-09,1617922800.0
12200,53,4,2021-04-10,0,0,0,0,2021-04-10,1618009200.0
12201,53,4,2021-04-11,0,0,0,0,2021-04-11,1618095600.0
12202,53,4,2021-04-12,0,0,0,0,2021-04-12,1618185600.0
12203,53,4,2021-04-13,0,0,0,0,2021-04-13,1618272000.0
12204,53,4,2021-04-14,0,0,0,0,2021-04-14,1618358400.0
12205,53,4,2021-04-15,0,0,0,0,2021-04-15,1618444800.0
12206,53,4,2021-04-16,0,0,0,0,2021-04-16,1618531200.0
12207,53,4,2021-04-17,0,0,0,0,2021-04-17,1618617600.0
12208,53,4,2021-04-18,0,0,0,0,2021-04-18,1618704000.0
12209,53,4,2021-04-19,0,0,0,0,2021-04-19,1618790400.0
12210,53,4,2021-04-20,0,0,0,0,2021-04-20,1618876800.0
12211,53,4,2021-04-21,0,0,0,0,2021-04-21,1618963200.0
12212,53,4,2021-04-22,0,0,0,0,2021-04-22,1619049600.0
12213,53,4,2021-04-23,63,0,63,0,2021-04-23,1619136000.0
12214,53,4,2021-04-24,198,0,261,0,2021-04-24,1619222400.0
12215,53,4,2021-04-25,0,0,261,0,2021-04-25,1619308800.0
12216,53,4,2021-04-26,326,0,587,0,2021-04-26,1619395200.0
12217,53,4,2021-04-27,628,1,1215,1,2021-04-27,1619481600.0
12218,53,4,2021-04-28,636,1,1851,2,2021-04-28,1619568000.0
12219,53,4,2021-04-29,1004,0,2855,2,2021-04-29,1619654400.0
12220,53,4,2021-04-30,1205,2,4060,4,2021-04-30,1619740800.0
12221,53,4,2021-05-01,78,0,4138,4,2021-05-01,1619827200.0
12222,53,4,2021-05-02,37,0,4175,4,2021-05-02,1619913600.0
12223,53,4,2021-05-03,338,0,4513,4,2021-05-03,1620000000.0
12224,53,4,2021-05-04,432,0,4945,4,2021-05-04,1620086400.0
12225,53,4,2021-05-05,250,0,5195,4,2021-05-05,1620172800.0
12226,53,4,2021-05-06,629,0,5824,4,2021-05-06,1620259200.0
12227,53,4,2021-05-07,1311,0,7135,4,2021-05-07,1620345600.0
12228,53,4,2021-05-08,71,0,7206,4,2021-05-08,1620432000.0
12229,53,4,2021-05-09,14,0,7220,4,2021-05-09,1620518400.0
12230,53,4,2021-05-10,401,2,7621,6,2021-05-10,1620604800.0
12231,53,4,2021-05-11,959,2,8580,8,2021-05-11,1620691200.0
12232,53,4,2021-05-12,850,1,9430,9,2021-05-12,1620777600.0
12233,53,4,2021-05-13,28,0,9458,9,2021-05-13,1620864000.0
12234,53,4,2021-05-14,781,0,10239,9,2021-05-14,1620950400.0
12235,53,4,2021-05-15,306,0,10545,9,2021-05-15,1621036800.0
12236,53,4,2021-05-16,16,0,10561,9,2021-05-16,1621123200.0
12237,53,4,2021-05-17,336,0,10897,9,2021-05-17,1621206000.0
12238,53,4,2021-05-18,817,1,11714,10,2021-05-18,1621292400.0
12239,53,4,2021-05-19,406,0,12120,10,2021-05-19,1621378800.0
12240,53,4,2021-05-20,905,1,13025,11,2021-05-20,1621465200.0
12241,53,4,2021-05-21,1156,1,14181,12,2021-05-21,1621551600.0
12242,53,4,2021-05-22,389,0,14570,12,2021-05-22,1621638000.0
12243,53,4,2021-05-23,6,0,14576,12,2021-05-23,1621724400.0
12244,53,4,2021-05-24,41,0,14617,12,2021-05-24,1621810800.0
12245,53,4,2021-05-25,518,1,15135,13,2021-05-25,1621897200.0
12246,53,4,2021-05-26,492,1,15627,14,2021-05-26,1621983600.0
12247,53,4,2021-05-27,1265,2,16892,16,2021-05-27,1622070000.0
12248,53,4,2021-05-28,2079,3,18971,19,2021-05-28,1622156400.0
12249,53,4,2021-05-29,679,3,19650,22,2021-05-29,1622242800.0
12250,53,4,2021-05-30,18,1,19668,23,2021-05-30,1622329200.0
12251,53,4,2021-05-31,757,0,20425,23,2021-05-31,1622415600.0
12252,53,4,2021-06-01,997,1,21422,24,2021-06-01,1622502000.0
12253,53,4,2021-06-02,799,2,22221,26,2021-06-02,1622588400.0
12254,53,4,2021-06-03,1180,2,23401,28,2021-06-03,1622674800.0
12255,53,4,2021-06-04,1564,2,24965,30,2021-06-04,1622761200.0
12256,53,4,2021-06-05,646,1,25611,31,2021-06-05,1622847600.0
12257,53,4,2021-06-06,26,0,25637,31,2021-06-06,1622934000.0
12258,53,4,2021-06-07,549,0,26186,31,2021-06-07,1623020400.0
12259,53,4,2021-06-08,970,1,27156,32,2021-06-08,1623106800.0
12260,53,4,2021-06-09,654,1,27810,33,2021-06-09,1623193200.0
12261,53,4,2021-06-10,1089,1,28899,34,2021-06-10,1623279600.0
12262,53,4,2021-06-11,1031,2,29930,36,2021-06-11,1623366000.0
12263,53,4,2021-06-12,344,4,30274,40,2021-06-12,1623452400.0
12264,53,4,2021-06-13,31,0,30305,40,2021-06-13,1623538800.0
12265,53,4,2021-06-14,434,0,30739,40,2021-06-14,1623625200.0
12266,53,4,2021-06-15,653,0,31392,40,2021-06-15,1623711600.0
12267,53,4,2021-06-16,567,0,31959,40,2021-06-16,1623798000.0
12268,53,4,2021-06-17,568,1,32527,41,2021-06-17,1623884400.0
12269,53,4,2021-06-18,874,0,33401,41,2021-06-18,1623970800.0
12270,53,4,2021-06-19,348,0,33749,41,2021-06-19,1624057200.0
12271,53,4,2021-06-20,23,0,33772,41,2021-06-20,1624143600.0
12272,53,4,2021-06-21,301,0,34073,41,2021-06-21,1624230000.0
12273,53,4,2021-06-22,534,2,34607,43,2021-06-22,1624316400.0
12274,53,4,2021-06-23,352,1,34959,44,2021-06-23,1624402800.0
12275,53,4,2021-06-24,467,3,35426,47,2021-06-24,1624489200.0
12276,53,4,2021-06-25,544,1,35970,48,2021-06-25,1624575600.0
12277,53,4,2021-06-26,237,1,36207,49,2021-06-26,1624662000.0
12278,53,4,2021-06-27,17,0,36224,49,2021-06-27,1624748400.0
12279,53,4,2021-06-28,215,1,36439,50,2021-06-28,1624834800.0
12280,53,4,2021-06-29,512,1,36951,51,2021-06-29,1624921200.0
12281,53,4,2021-06-30,389,5,37340,56,2021-06-30,1625007600.0
12282,53,4,2021-07-01,459,0,37799,56,2021-07-01,1625094000.0
12283,53,4,2021-07-02,606,0,38405,56,2021-07-02,1625180400.0
12284,53,4,2021-07-03,241,0,38646,56,2021-07-03,1625266800.0
12285,53,4,2021-07-04,19,1,38665,57,2021-07-04,1625353200.0
12286,53,4,2021-07-05,231,1,38896,58,2021-07-05,1625439600.0
12287,53,4,2021-07-06,442,0,39338,58,2021-07-06,1625526000.0
12288,75,1,2020-12-27,1,0,1,0,2020-12-27,1609023600.0
12289,75,1,2020-12-28,2,0,3,0,2020-12-28,1609110000.0
12290,75,1,2020-12-29,3,0,6,0,2020-12-29,1609196400.0
12291,75,1,2020-12-30,2,0,8,0,2020-12-30,1609282800.0
12292,75,1,2020-12-31,0,0,8,0,2020-12-31,1609369200.0
12293,75,1,2021-01-01,4,0,12,0,2021-01-01,1609455600.0
12294,75,1,2021-01-02,2,0,14,0,2021-01-02,1609542000.0
12295,75,1,2021-01-03,0,0,14,0,2021-01-03,1609628400.0
12296,75,1,2021-01-04,90,0,104,0,2021-01-04,1609714800.0
12297,75,1,2021-01-05,124,0,228,0,2021-01-05,1609801200.0
12298,75,1,2021-01-06,736,0,964,0,2021-01-06,1609887600.0
12299,75,1,2021-01-07,4923,0,5887,0,2021-01-07,1609974000.0
12300,75,1,2021-01-08,5470,0,11357,0,2021-01-08,1610060400.0
12301,75,1,2021-01-09,845,0,12202,0,2021-01-09,1610146800.0
12302,75,1,2021-01-10,478,0,12680,0,2021-01-10,1610233200.0
12303,75,1,2021-01-11,3585,0,16265,0,2021-01-11,1610319600.0
12304,75,1,2021-01-12,5947,0,22212,0,2021-01-12,1610406000.0
12305,75,1,2021-01-13,6552,0,28764,0,2021-01-13,1610492400.0
12306,75,1,2021-01-14,8125,0,36889,0,2021-01-14,1610578800.0
12307,75,1,2021-01-15,7630,0,44519,0,2021-01-15,1610665200.0
12308,75,1,2021-01-16,1609,12,46128,12,2021-01-16,1610751600.0
12309,75,1,2021-01-17,426,3,46554,15,2021-01-17,1610838000.0
12310,75,1,2021-01-18,6888,24,53442,39,2021-01-18,1610924400.0
12311,75,1,2021-01-19,14048,8,67490,47,2021-01-19,1611010800.0
12312,75,1,2021-01-20,15537,5,83027,52,2021-01-20,1611097200.0
12313,75,1,2021-01-21,16967,16,99994,68,2021-01-21,1611183600.0
12314,75,1,2021-01-22,12972,14,112966,82,2021-01-22,1611270000.0
12315,75,1,2021-01-23,4421,2,117387,84,2021-01-23,1611356400.0
12316,75,1,2021-01-24,700,1,118087,85,2021-01-24,1611442800.0
12317,75,1,2021-01-25,8870,212,126957,297,2021-01-25,1611529200.0
12318,75,1,2021-01-26,11724,446,138681,743,2021-01-26,1611615600.0
12319,75,1,2021-01-27,12297,759,150978,1502,2021-01-27,1611702000.0
12320,75,1,2021-01-28,12924,2636,163902,4138,2021-01-28,1611788400.0
12321,75,1,2021-01-29,10003,2978,173905,7116,2021-01-29,1611874800.0
12322,75,1,2021-01-30,3379,515,177284,7631,2021-01-30,1611961200.0
12323,75,1,2021-01-31,646,418,177930,8049,2021-01-31,1612047600.0
12324,75,1,2021-02-01,5715,2638,183645,10687,2021-02-01,1612134000.0
12325,75,1,2021-02-02,9615,4342,193260,15029,2021-02-02,1612220400.0
12326,75,1,2021-02-03,9597,4356,202857,19385,2021-02-03,1612306800.0
12327,75,1,2021-02-04,10765,5667,213622,25052,2021-02-04,1612393200.0
12328,75,1,2021-02-05,7489,5629,221111,30681,2021-02-05,1612479600.0
12329,75,1,2021-02-06,2349,1104,223460,31785,2021-02-06,1612566000.0
12330,75,1,2021-02-07,316,245,223776,32030,2021-02-07,1612652400.0
12331,75,1,2021-02-08,4815,3646,228591,35676,2021-02-08,1612738800.0
12332,75,1,2021-02-09,6862,8043,235453,43719,2021-02-09,1612825200.0
12333,75,1,2021-02-10,6798,8734,242251,52453,2021-02-10,1612911600.0
12334,75,1,2021-02-11,7815,10246,250066,62699,2021-02-11,1612998000.0
12335,75,1,2021-02-12,6537,8748,256603,71447,2021-02-12,1613084400.0
12336,75,1,2021-02-13,1842,1753,258445,73200,2021-02-13,1613170800.0
12337,75,1,2021-02-14,254,363,258699,73563,2021-02-14,1613257200.0
12338,75,1,2021-02-15,2486,7829,261185,81392,2021-02-15,1613343600.0
12339,75,1,2021-02-16,3545,10492,264730,91884,2021-02-16,1613430000.0
12340,75,1,2021-02-17,3730,11270,268460,103154,2021-02-17,1613516400.0
12341,75,1,2021-02-18,4154,12771,272614,115925,2021-02-18,1613602800.0
12342,75,1,2021-02-19,4228,9580,276842,125505,2021-02-19,1613689200.0
12343,75,1,2021-02-20,748,2627,277590,128132,2021-02-20,1613775600.0
12344,75,1,2021-02-21,138,665,277728,128797,2021-02-21,1613862000.0
12345,75,1,2021-02-22,2392,8485,280120,137282,2021-02-22,1613948400.0
12346,75,1,2021-02-23,3677,10885,283797,148167,2021-02-23,1614034800.0
12347,75,1,2021-02-24,4367,10247,288164,158414,2021-02-24,1614121200.0
12348,75,1,2021-02-25,5137,11602,293301,170016,2021-02-25,1614207600.0
12349,75,1,2021-02-26,4698,8748,297999,178764,2021-02-26,1614294000.0
12350,75,1,2021-02-27,1525,2461,299524,181225,2021-02-27,1614380400.0
12351,75,1,2021-02-28,131,691,299655,181916,2021-02-28,1614466800.0
12352,75,1,2021-03-01,2465,6964,302120,188880,2021-03-01,1614553200.0
12353,75,1,2021-03-02,3613,8074,305733,196954,2021-03-02,1614639600.0
12354,75,1,2021-03-03,4111,7706,309844,204660,2021-03-03,1614726000.0
12355,75,1,2021-03-04,4921,8021,314765,212681,2021-03-04,1614812400.0
12356,75,1,2021-03-05,4921,7240,319686,219921,2021-03-05,1614898800.0
12357,75,1,2021-03-06,1848,2135,321534,222056,2021-03-06,1614985200.0
12358,75,1,2021-03-07,515,427,322049,222483,2021-03-07,1615071600.0
12359,75,1,2021-03-08,4304,5312,326353,227795,2021-03-08,1615158000.0
12360,75,1,2021-03-09,6633,6371,332986,234166,2021-03-09,1615244400.0
12361,75,1,2021-03-10,8123,6184,341109,240350,2021-03-10,1615330800.0
12362,75,1,2021-03-11,9436,6479,350545,246829,2021-03-11,1615417200.0
12363,75,1,2021-03-12,8946,5013,359491,251842,2021-03-12,1615503600.0
12364,75,1,2021-03-13,3842,1105,363333,252947,2021-03-13,1615590000.0
12365,75,1,2021-03-14,815,234,364148,253181,2021-03-14,1615676400.0
12366,75,1,2021-03-15,8966,3277,373114,256458,2021-03-15,1615762800.0
12367,75,1,2021-03-16,12302,3389,385416,259847,2021-03-16,1615849200.0
12368,75,1,2021-03-17,13470,3467,398886,263314,2021-03-17,1615935600.0
12369,75,1,2021-03-18,14744,4082,413630,267396,2021-03-18,1616022000.0
12370,75,1,2021-03-19,13799,3853,427429,271249,2021-03-19,1616108400.0
12371,75,1,2021-03-20,6398,678,433827,271927,2021-03-20,1616194800.0
12372,75,1,2021-03-21,1885,86,435712,272013,2021-03-21,1616281200.0
12373,75,1,2021-03-22,11920,3041,447632,275054,2021-03-22,1616367600.0
12374,75,1,2021-03-23,14432,3205,462064,278259,2021-03-23,1616454000.0
12375,75,1,2021-03-24,15563,3572,477627,281831,2021-03-24,1616540400.0
12376,75,1,2021-03-25,17030,3745,494657,285576,2021-03-25,1616626800.0
12377,75,1,2021-03-26,17895,3319,512552,288895,2021-03-26,1616713200.0
12378,75,1,2021-03-27,7308,1047,519860,289942,2021-03-27,1616799600.0
12379,75,1,2021-03-28,1536,366,521396,290308,2021-03-28,1616886000.0
12380,75,1,2021-03-29,14788,3443,536184,293751,2021-03-29,1616972400.0
12381,75,1,2021-03-30,18821,4457,555005,298208,2021-03-30,1617058800.0
12382,75,1,2021-03-31,19554,4726,574559,302934,2021-03-31,1617145200.0
12383,75,1,2021-04-01,21408,4797,595967,307731,2021-04-01,1617231600.0
12384,75,1,2021-04-02,19004,5190,614971,312921,2021-04-02,1617318000.0
12385,75,1,2021-04-03,7566,2285,622537,315206,2021-04-03,1617404400.0
12386,75,1,2021-04-04,973,318,623510,315524,2021-04-04,1617490800.0
12387,75,1,2021-04-05,4624,312,628134,315836,2021-04-05,1617577200.0
12388,75,1,2021-04-06,19854,8952,647988,324788,2021-04-06,1617663600.0
12389,75,1,2021-04-07,25141,9412,673129,334200,2021-04-07,1617750000.0
12390,75,1,2021-04-08,25807,10370,698936,344570,2021-04-08,1617836400.0
12391,75,1,2021-04-09,24979,8818,723915,353388,2021-04-09,1617922800.0
12392,75,1,2021-04-10,13322,4006,737237,357394,2021-04-10,1618009200.0
12393,75,1,2021-04-11,3639,616,740876,358010,2021-04-11,1618095600.0
12394,75,1,2021-04-12,18810,10422,759686,368432,2021-04-12,1618185600.0
12395,75,1,2021-04-13,21965,12491,781651,380923,2021-04-13,1618272000.0
12396,75,1,2021-04-14,23874,12768,805525,393691,2021-04-14,1618358400.0
12397,75,1,2021-04-15,23645,12790,829170,406481,2021-04-15,1618444800.0
12398,75,1,2021-04-16,21261,12766,850431,419247,2021-04-16,1618531200.0
12399,75,1,2021-04-17,11885,5932,862316,425179,2021-04-17,1618617600.0
12400,75,1,2021-04-18,1724,1929,864040,427108,2021-04-18,1618704000.0
12401,75,1,2021-04-19,15999,13320,880039,440428,2021-04-19,1618790400.0
12402,75,1,2021-04-20,20221,16232,900260,456660,2021-04-20,1618876800.0
12403,75,1,2021-04-21,20574,15757,920834,472417,2021-04-21,1618963200.0
12404,75,1,2021-04-22,20715,16369,941549,488786,2021-04-22,1619049600.0
12405,75,1,2021-04-23,18676,16818,960225,505604,2021-04-23,1619136000.0
12406,75,1,2021-04-24,11449,6402,971674,512006,2021-04-24,1619222400.0
12407,75,1,2021-04-25,3032,936,974706,512942,2021-04-25,1619308800.0
12408,75,1,2021-04-26,18295,16026,993001,528968,2021-04-26,1619395200.0
12409,75,1,2021-04-27,21876,19422,1014877,548390,2021-04-27,1619481600.0
12410,75,1,2021-04-28,23108,19232,1037985,567622,2021-04-28,1619568000.0
12411,75,1,2021-04-29,27623,19467,1065608,587089,2021-04-29,1619654400.0
12412,75,1,2021-04-30,27023,17146,1092631,604235,2021-04-30,1619740800.0
12413,75,1,2021-05-01,11681,3299,1104312,607534,2021-05-01,1619827200.0
12414,75,1,2021-05-02,6243,1204,1110555,608738,2021-05-02,1619913600.0
12415,75,1,2021-05-03,22976,17782,1133531,626520,2021-05-03,1620000000.0
12416,75,1,2021-05-04,23874,22913,1157405,649433,2021-05-04,1620086400.0
12417,75,1,2021-05-05,25730,24452,1183135,673885,2021-05-05,1620172800.0
12418,75,1,2021-05-06,25688,22485,1208823,696370,2021-05-06,1620259200.0
12419,75,1,2021-05-07,25334,23193,1234157,719563,2021-05-07,1620345600.0
12420,75,1,2021-05-08,14428,5426,1248585,724989,2021-05-08,1620432000.0
12421,75,1,2021-05-09,6258,2811,1254843,727800,2021-05-09,1620518400.0
12422,75,1,2021-05-10,20693,22466,1275536,750266,2021-05-10,1620604800.0
12423,75,1,2021-05-11,26288,23211,1301824,773477,2021-05-11,1620691200.0
12424,75,1,2021-05-12,29042,21423,1330866,794900,2021-05-12,1620777600.0
12425,75,1,2021-05-13,19806,4842,1350672,799742,2021-05-13,1620864000.0
12426,75,1,2021-05-14,28288,13250,1378960,812992,2021-05-14,1620950400.0
12427,75,1,2021-05-15,18652,6261,1397612,819253,2021-05-15,1621036800.0
12428,75,1,2021-05-16,5773,1529,1403385,820782,2021-05-16,1621123200.0
12429,75,1,2021-05-17,28163,12911,1431548,833693,2021-05-17,1621206000.0
12430,75,1,2021-05-18,34094,12349,1465642,846042,2021-05-18,1621292400.0
12431,75,1,2021-05-19,34959,10552,1500601,856594,2021-05-19,1621378800.0
12432,75,1,2021-05-20,35511,9455,1536112,866049,2021-05-20,1621465200.0
12433,75,1,2021-05-21,33707,9012,1569819,875061,2021-05-21,1621551600.0
12434,75,1,2021-05-22,17394,4114,1587213,879175,2021-05-22,1621638000.0
12435,75,1,2021-05-23,5044,759,1592257,879934,2021-05-23,1621724400.0
12436,75,1,2021-05-24,17658,2274,1609915,882208,2021-05-24,1621810800.0
12437,75,1,2021-05-25,32403,12320,1642318,894528,2021-05-25,1621897200.0
12438,75,1,2021-05-26,34050,11620,1676368,906148,2021-05-26,1621983600.0
12439,75,1,2021-05-27,36944,12573,1713312,918721,2021-05-27,1622070000.0
12440,75,1,2021-05-28,31952,14069,1745264,932790,2021-05-28,1622156400.0
12441,75,1,2021-05-29,16546,8522,1761810,941312,2021-05-29,1622242800.0
12442,75,1,2021-05-30,5669,845,1767479,942157,2021-05-30,1622329200.0
12443,75,1,2021-05-31,28520,15026,1795999,957183,2021-05-31,1622415600.0
12444,75,1,2021-06-01,35033,17063,1831032,974246,2021-06-01,1622502000.0
12445,75,1,2021-06-02,35331,16028,1866363,990274,2021-06-02,1622588400.0
12446,75,1,2021-06-03,38518,14730,1904881,1005004,2021-06-03,1622674800.0
12447,75,1,2021-06-04,34057,18025,1938938,1023029,2021-06-04,1622761200.0
12448,75,1,2021-06-05,19781,9754,1958719,1032783,2021-06-05,1622847600.0
12449,75,1,2021-06-06,8250,2612,1966969,1035395,2021-06-06,1622934000.0
12450,75,1,2021-06-07,27495,23823,1994464,1059218,2021-06-07,1623020400.0
12451,75,1,2021-06-08,31227,25222,2025691,1084440,2021-06-08,1623106800.0
12452,75,1,2021-06-09,34084,22198,2059775,1106638,2021-06-09,1623193200.0
12453,75,1,2021-06-10,36171,19133,2095946,1125771,2021-06-10,1623279600.0
12454,75,1,2021-06-11,31135,23254,2127081,1149025,2021-06-11,1623366000.0
12455,75,1,2021-06-12,19362,12837,2146443,1161862,2021-06-12,1623452400.0
12456,75,1,2021-06-13,7784,4577,2154227,1166439,2021-06-13,1623538800.0
12457,75,1,2021-06-14,20538,28327,2174765,1194766,2021-06-14,1623625200.0
12458,75,1,2021-06-15,27197,27035,2201962,1221801,2021-06-15,1623711600.0
12459,75,1,2021-06-16,29802,24062,2231764,1245863,2021-06-16,1623798000.0
12460,75,1,2021-06-17,29482,18983,2261246,1264846,2021-06-17,1623884400.0
12461,75,1,2021-06-18,27077,24558,2288323,1289404,2021-06-18,1623970800.0
12462,75,1,2021-06-19,17013,15259,2305336,1304663,2021-06-19,1624057200.0
12463,75,1,2021-06-20,6045,4562,2311381,1309225,2021-06-20,1624143600.0
12464,75,1,2021-06-21,18796,28569,2330177,1337794,2021-06-21,1624230000.0
12465,75,1,2021-06-22,20626,29225,2350803,1367019,2021-06-22,1624316400.0
12466,75,1,2021-06-23,22782,28305,2373585,1395324,2021-06-23,1624402800.0
12467,75,1,2021-06-24,22859,21220,2396444,1416544,2021-06-24,1624489200.0
12468,75,1,2021-06-25,18612,31292,2415056,1447836,2021-06-25,1624575600.0
12469,75,1,2021-06-26,11509,18409,2426565,1466245,2021-06-26,1624662000.0
12470,75,1,2021-06-27,4408,6271,2430973,1472516,2021-06-27,1624748400.0
12471,75,1,2021-06-28,12707,34670,2443680,1507186,2021-06-28,1624834800.0
12472,75,1,2021-06-29,15036,36061,2458716,1543247,2021-06-29,1624921200.0
12473,75,1,2021-06-30,17111,33321,2475827,1576568,2021-06-30,1625007600.0
12474,75,1,2021-07-01,18914,28985,2494741,1605553,2021-07-01,1625094000.0
12475,75,1,2021-07-02,16899,32574,2511640,1638127,2021-07-02,1625180400.0
12476,75,1,2021-07-03,8372,19615,2520012,1657742,2021-07-03,1625266800.0
12477,75,1,2021-07-04,3291,5967,2523303,1663709,2021-07-04,1625353200.0
12478,75,1,2021-07-05,12595,33559,2535898,1697268,2021-07-05,1625439600.0
12479,75,1,2021-07-06,15105,37258,2551003,1734526,2021-07-06,1625526000.0
12480,75,2,2020-12-27,0,0,0,0,2020-12-27,1609023600.0
12481,75,2,2020-12-28,0,0,0,0,2020-12-28,1609110000.0
12482,75,2,2020-12-29,0,0,0,0,2020-12-29,1609196400.0
12483,75,2,2020-12-30,0,0,0,0,2020-12-30,1609282800.0
12484,75,2,2020-12-31,0,0,0,0,2020-12-31,1609369200.0
12485,75,2,2021-01-01,0,0,0,0,2021-01-01,1609455600.0
12486,75,2,2021-01-02,0,0,0,0,2021-01-02,1609542000.0
12487,75,2,2021-01-03,0,0,0,0,2021-01-03,1609628400.0
12488,75,2,2021-01-04,0,0,0,0,2021-01-04,1609714800.0
12489,75,2,2021-01-05,0,0,0,0,2021-01-05,1609801200.0
12490,75,2,2021-01-06,0,0,0,0,2021-01-06,1609887600.0
12491,75,2,2021-01-07,0,0,0,0,2021-01-07,1609974000.0
12492,75,2,2021-01-08,0,0,0,0,2021-01-08,1610060400.0
12493,75,2,2021-01-09,0,0,0,0,2021-01-09,1610146800.0
12494,75,2,2021-01-10,0,0,0,0,2021-01-10,1610233200.0
12495,75,2,2021-01-11,0,0,0,0,2021-01-11,1610319600.0
12496,75,2,2021-01-12,0,0,0,0,2021-01-12,1610406000.0
12497,75,2,2021-01-13,0,0,0,0,2021-01-13,1610492400.0
12498,75,2,2021-01-14,1,0,1,0,2021-01-14,1610578800.0
12499,75,2,2021-01-15,0,0,1,0,2021-01-15,1610665200.0
12500,75,2,2021-01-16,0,0,1,0,2021-01-16,1610751600.0
12501,75,2,2021-01-17,0,0,1,0,2021-01-17,1610838000.0
12502,75,2,2021-01-18,3,0,4,0,2021-01-18,1610924400.0
12503,75,2,2021-01-19,7,0,11,0,2021-01-19,1611010800.0
12504,75,2,2021-01-20,0,0,11,0,2021-01-20,1611097200.0
12505,75,2,2021-01-21,1,0,12,0,2021-01-21,1611183600.0
12506,75,2,2021-01-22,1,0,13,0,2021-01-22,1611270000.0
12507,75,2,2021-01-23,0,0,13,0,2021-01-23,1611356400.0
12508,75,2,2021-01-24,0,0,13,0,2021-01-24,1611442800.0
12509,75,2,2021-01-25,3,0,16,0,2021-01-25,1611529200.0
12510,75,2,2021-01-26,1,0,17,0,2021-01-26,1611615600.0
12511,75,2,2021-01-27,2,0,19,0,2021-01-27,1611702000.0
12512,75,2,2021-01-28,18,0,37,0,2021-01-28,1611788400.0
12513,75,2,2021-01-29,0,0,37,0,2021-01-29,1611874800.0
12514,75,2,2021-01-30,0,0,37,0,2021-01-30,1611961200.0
12515,75,2,2021-01-31,0,0,37,0,2021-01-31,1612047600.0
12516,75,2,2021-02-01,0,0,37,0,2021-02-01,1612134000.0
12517,75,2,2021-02-02,1,0,38,0,2021-02-02,1612220400.0
12518,75,2,2021-02-03,0,0,38,0,2021-02-03,1612306800.0
12519,75,2,2021-02-04,1,0,39,0,2021-02-04,1612393200.0
12520,75,2,2021-02-05,1,0,40,0,2021-02-05,1612479600.0
12521,75,2,2021-02-06,0,0,40,0,2021-02-06,1612566000.0
12522,75,2,2021-02-07,0,0,40,0,2021-02-07,1612652400.0
12523,75,2,2021-02-08,0,1,40,1,2021-02-08,1612738800.0
12524,75,2,2021-02-09,1,5,41,6,2021-02-09,1612825200.0
12525,75,2,2021-02-10,1,1,42,7,2021-02-10,1612911600.0
12526,75,2,2021-02-11,0,0,42,7,2021-02-11,1612998000.0
12527,75,2,2021-02-12,1,1,43,8,2021-02-12,1613084400.0
12528,75,2,2021-02-13,0,0,43,8,2021-02-13,1613170800.0
12529,75,2,2021-02-14,0,0,43,8,2021-02-14,1613257200.0
12530,75,2,2021-02-15,61,0,104,8,2021-02-15,1613343600.0
12531,75,2,2021-02-16,274,0,378,8,2021-02-16,1613430000.0
12532,75,2,2021-02-17,282,0,660,8,2021-02-17,1613516400.0
12533,75,2,2021-02-18,395,1,1055,9,2021-02-18,1613602800.0
12534,75,2,2021-02-19,232,1,1287,10,2021-02-19,1613689200.0
12535,75,2,2021-02-20,45,0,1332,10,2021-02-20,1613775600.0
12536,75,2,2021-02-21,0,0,1332,10,2021-02-21,1613862000.0
12537,75,2,2021-02-22,279,1,1611,11,2021-02-22,1613948400.0
12538,75,2,2021-02-23,491,0,2102,11,2021-02-23,1614034800.0
12539,75,2,2021-02-24,486,2,2588,13,2021-02-24,1614121200.0
12540,75,2,2021-02-25,569,15,3157,28,2021-02-25,1614207600.0
12541,75,2,2021-02-26,556,1,3713,29,2021-02-26,1614294000.0
12542,75,2,2021-02-27,56,0,3769,29,2021-02-27,1614380400.0
12543,75,2,2021-02-28,2,0,3771,29,2021-02-28,1614466800.0
12544,75,2,2021-03-01,371,0,4142,29,2021-03-01,1614553200.0
12545,75,2,2021-03-02,1125,2,5267,31,2021-03-02,1614639600.0
12546,75,2,2021-03-03,923,0,6190,31,2021-03-03,1614726000.0
12547,75,2,2021-03-04,1791,2,7981,33,2021-03-04,1614812400.0
12548,75,2,2021-03-05,1454,1,9435,34,2021-03-05,1614898800.0
12549,75,2,2021-03-06,119,1,9554,35,2021-03-06,1614985200.0
12550,75,2,2021-03-07,0,0,9554,35,2021-03-07,1615071600.0
12551,75,2,2021-03-08,788,0,10342,35,2021-03-08,1615158000.0
12552,75,2,2021-03-09,1651,2,11993,37,2021-03-09,1615244400.0
12553,75,2,2021-03-10,1112,2,13105,39,2021-03-10,1615330800.0
12554,75,2,2021-03-11,1414,1,14519,40,2021-03-11,1615417200.0
12555,75,2,2021-03-12,1429,0,15948,40,2021-03-12,1615503600.0
12556,75,2,2021-03-13,519,2,16467,42,2021-03-13,1615590000.0
12557,75,2,2021-03-14,50,0,16517,42,2021-03-14,1615676400.0
12558,75,2,2021-03-15,1085,59,17602,101,2021-03-15,1615762800.0
12559,75,2,2021-03-16,1282,234,18884,335,2021-03-16,1615849200.0
12560,75,2,2021-03-17,1223,287,20107,622,2021-03-17,1615935600.0
12561,75,2,2021-03-18,1523,395,21630,1017,2021-03-18,1616022000.0
12562,75,2,2021-03-19,1736,230,23366,1247,2021-03-19,1616108400.0
12563,75,2,2021-03-20,1111,46,24477,1293,2021-03-20,1616194800.0
12564,75,2,2021-03-21,298,0,24775,1293,2021-03-21,1616281200.0
12565,75,2,2021-03-22,1495,302,26270,1595,2021-03-22,1616367600.0
12566,75,2,2021-03-23,2449,467,28719,2062,2021-03-23,1616454000.0
12567,75,2,2021-03-24,2044,515,30763,2577,2021-03-24,1616540400.0
12568,75,2,2021-03-25,2617,595,33380,3172,2021-03-25,1616626800.0
12569,75,2,2021-03-26,2801,496,36181,3668,2021-03-26,1616713200.0
12570,75,2,2021-03-27,1787,56,37968,3724,2021-03-27,1616799600.0
12571,75,2,2021-03-28,915,0,38883,3724,2021-03-28,1616886000.0
12572,75,2,2021-03-29,2571,437,41454,4161,2021-03-29,1616972400.0
12573,75,2,2021-03-30,3092,1138,44546,5299,2021-03-30,1617058800.0
12574,75,2,2021-03-31,3134,890,47680,6189,2021-03-31,1617145200.0
12575,75,2,2021-04-01,3913,1635,51593,7824,2021-04-01,1617231600.0
12576,75,2,2021-04-02,4130,1262,55723,9086,2021-04-02,1617318000.0
12577,75,2,2021-04-03,1925,217,57648,9303,2021-04-03,1617404400.0
12578,75,2,2021-04-04,1044,1,58692,9304,2021-04-04,1617490800.0
12579,75,2,2021-04-05,1526,211,60218,9515,2021-04-05,1617577200.0
12580,75,2,2021-04-06,3561,1570,63779,11085,2021-04-06,1617663600.0
12581,75,2,2021-04-07,4015,1155,67794,12240,2021-04-07,1617750000.0
12582,75,2,2021-04-08,5169,1355,72963,13595,2021-04-08,1617836400.0
12583,75,2,2021-04-09,4929,1421,77892,15016,2021-04-09,1617922800.0
12584,75,2,2021-04-10,2661,621,80553,15637,2021-04-10,1618009200.0
12585,75,2,2021-04-11,799,51,81352,15688,2021-04-11,1618095600.0
12586,75,2,2021-04-12,2983,1024,84335,16712,2021-04-12,1618185600.0
12587,75,2,2021-04-13,3728,1289,88063,18001,2021-04-13,1618272000.0
12588,75,2,2021-04-14,3336,1139,91399,19140,2021-04-14,1618358400.0
12589,75,2,2021-04-15,3452,1571,94851,20711,2021-04-15,1618444800.0
12590,75,2,2021-04-16,3327,1774,98178,22485,2021-04-16,1618531200.0
12591,75,2,2021-04-17,2601,1176,100779,23661,2021-04-17,1618617600.0
12592,75,2,2021-04-18,1632,60,102411,23721,2021-04-18,1618704000.0
12593,75,2,2021-04-19,2550,1269,104961,24990,2021-04-19,1618790400.0
12594,75,2,2021-04-20,2920,2358,107881,27348,2021-04-20,1618876800.0
12595,75,2,2021-04-21,2574,1805,110455,29153,2021-04-21,1618963200.0
12596,75,2,2021-04-22,2755,2670,113210,31823,2021-04-22,1619049600.0
12597,75,2,2021-04-23,2799,2724,116009,34547,2021-04-23,1619136000.0
12598,75,2,2021-04-24,1570,2131,117579,36678,2021-04-24,1619222400.0
12599,75,2,2021-04-25,841,467,118420,37145,2021-04-25,1619308800.0
12600,75,2,2021-04-26,1657,2441,120077,39586,2021-04-26,1619395200.0
12601,75,2,2021-04-27,2283,3148,122360,42734,2021-04-27,1619481600.0
12602,75,2,2021-04-28,3384,2906,125744,45640,2021-04-28,1619568000.0
12603,75,2,2021-04-29,1814,3872,127558,49512,2021-04-29,1619654400.0
12604,75,2,2021-04-30,2124,4526,129682,54038,2021-04-30,1619740800.0
12605,75,2,2021-05-01,2789,1703,132471,55741,2021-05-01,1619827200.0
12606,75,2,2021-05-02,493,1169,132964,56910,2021-05-02,1619913600.0
12607,75,2,2021-05-03,2436,1705,135400,58615,2021-05-03,1620000000.0
12608,75,2,2021-05-04,2905,3832,138305,62447,2021-05-04,1620086400.0
12609,75,2,2021-05-05,2840,3686,141145,66133,2021-05-05,1620172800.0
12610,75,2,2021-05-06,4217,4757,145362,70890,2021-05-06,1620259200.0
12611,75,2,2021-05-07,3807,4604,149169,75494,2021-05-07,1620345600.0
12612,75,2,2021-05-08,2208,1359,151377,76853,2021-05-08,1620432000.0
12613,75,2,2021-05-09,829,962,152206,77815,2021-05-09,1620518400.0
12614,75,2,2021-05-10,2294,3522,154500,81337,2021-05-10,1620604800.0
12615,75,2,2021-05-11,4284,4038,158784,85375,2021-05-11,1620691200.0
12616,75,2,2021-05-12,3512,3332,162296,88707,2021-05-12,1620777600.0
12617,75,2,2021-05-13,2372,1225,164668,89932,2021-05-13,1620864000.0
12618,75,2,2021-05-14,3159,2949,167827,92881,2021-05-14,1620950400.0
12619,75,2,2021-05-15,3069,1635,170896,94516,2021-05-15,1621036800.0
12620,75,2,2021-05-16,1521,75,172417,94591,2021-05-16,1621123200.0
12621,75,2,2021-05-17,4363,2385,176780,96976,2021-05-17,1621206000.0
12622,75,2,2021-05-18,6199,2182,182979,99158,2021-05-18,1621292400.0
12623,75,2,2021-05-19,6283,2071,189262,101229,2021-05-19,1621378800.0
12624,75,2,2021-05-20,8024,1808,197286,103037,2021-05-20,1621465200.0
12625,75,2,2021-05-21,6414,2195,203700,105232,2021-05-21,1621551600.0
12626,75,2,2021-05-22,4961,933,208661,106165,2021-05-22,1621638000.0
12627,75,2,2021-05-23,2733,57,211394,106222,2021-05-23,1621724400.0
12628,75,2,2021-05-24,1091,498,212485,106720,2021-05-24,1621810800.0
12629,75,2,2021-05-25,3249,2093,215734,108813,2021-05-25,1621897200.0
12630,75,2,2021-05-26,3156,1594,218890,110407,2021-05-26,1621983600.0
12631,75,2,2021-05-27,3886,1664,222776,112071,2021-05-27,1622070000.0
12632,75,2,2021-05-28,2921,1707,225697,113778,2021-05-28,1622156400.0
12633,75,2,2021-05-29,1609,1072,227306,114850,2021-05-29,1622242800.0
12634,75,2,2021-05-30,50,823,227356,115673,2021-05-30,1622329200.0
12635,75,2,2021-05-31,1541,1763,228897,117436,2021-05-31,1622415600.0
12636,75,2,2021-06-01,3389,1460,232286,118896,2021-06-01,1622502000.0
12637,75,2,2021-06-02,4177,1719,236463,120615,2021-06-02,1622588400.0
12638,75,2,2021-06-03,6393,1632,242856,122247,2021-06-03,1622674800.0
12639,75,2,2021-06-04,7372,2058,250228,124305,2021-06-04,1622761200.0
12640,75,2,2021-06-05,3305,1367,253533,125672,2021-06-05,1622847600.0
12641,75,2,2021-06-06,407,844,253940,126516,2021-06-06,1622934000.0
12642,75,2,2021-06-07,2753,2157,256693,128673,2021-06-07,1623020400.0
12643,75,2,2021-06-08,5362,2475,262055,131148,2021-06-08,1623106800.0
12644,75,2,2021-06-09,3822,2620,265877,133768,2021-06-09,1623193200.0
12645,75,2,2021-06-10,4638,954,270515,134722,2021-06-10,1623279600.0
12646,75,2,2021-06-11,6744,1746,277259,136468,2021-06-11,1623366000.0
12647,75,2,2021-06-12,2920,2802,280179,139270,2021-06-12,1623452400.0
12648,75,2,2021-06-13,259,357,280438,139627,2021-06-13,1623538800.0
12649,75,2,2021-06-14,2584,3113,283022,142740,2021-06-14,1623625200.0
12650,75,2,2021-06-15,4399,2911,287421,145651,2021-06-15,1623711600.0
12651,75,2,2021-06-16,3706,2853,291127,148504,2021-06-16,1623798000.0
12652,75,2,2021-06-17,4930,4180,296057,152684,2021-06-17,1623884400.0
12653,75,2,2021-06-18,6056,4055,302113,156739,2021-06-18,1623970800.0
12654,75,2,2021-06-19,2408,2341,304521,159080,2021-06-19,1624057200.0
12655,75,2,2021-06-20,131,376,304652,159456,2021-06-20,1624143600.0
12656,75,2,2021-06-21,1969,2765,306621,162221,2021-06-21,1624230000.0
12657,75,2,2021-06-22,3639,3855,310260,166076,2021-06-22,1624316400.0
12658,75,2,2021-06-23,2487,3665,312747,169741,2021-06-23,1624402800.0
12659,75,2,2021-06-24,3825,2670,316572,172411,2021-06-24,1624489200.0
12660,75,2,2021-06-25,4048,4116,320620,176527,2021-06-25,1624575600.0
12661,75,2,2021-06-26,1549,4010,322169,180537,2021-06-26,1624662000.0
12662,75,2,2021-06-27,146,1764,322315,182301,2021-06-27,1624748400.0
12663,75,2,2021-06-28,1544,5216,323859,187517,2021-06-28,1624834800.0
12664,75,2,2021-06-29,2705,6886,326564,194403,2021-06-29,1624921200.0
12665,75,2,2021-06-30,2063,6891,328627,201294,2021-06-30,1625007600.0
12666,75,2,2021-07-01,2315,7014,330942,208308,2021-07-01,1625094000.0
12667,75,2,2021-07-02,2797,7486,333739,215794,2021-07-02,1625180400.0
12668,75,2,2021-07-03,949,5056,334688,220850,2021-07-03,1625266800.0
12669,75,2,2021-07-04,58,1151,334746,222001,2021-07-04,1625353200.0
12670,75,2,2021-07-05,952,3466,335698,225467,2021-07-05,1625439600.0
12671,75,2,2021-07-06,1842,5021,337540,230488,2021-07-06,1625526000.0
12672,75,3,2020-12-27,0,0,0,0,2020-12-27,1609023600.0
12673,75,3,2020-12-28,0,0,0,0,2020-12-28,1609110000.0
12674,75,3,2020-12-29,0,0,0,0,2020-12-29,1609196400.0
12675,75,3,2020-12-30,0,0,0,0,2020-12-30,1609282800.0
12676,75,3,2020-12-31,0,0,0,0,2020-12-31,1609369200.0
12677,75,3,2021-01-01,0,0,0,0,2021-01-01,1609455600.0
12678,75,3,2021-01-02,0,0,0,0,2021-01-02,1609542000.0
12679,75,3,2021-01-03,0,0,0,0,2021-01-03,1609628400.0
12680,75,3,2021-01-04,0,0,0,0,2021-01-04,1609714800.0
12681,75,3,2021-01-05,0,0,0,0,2021-01-05,1609801200.0
12682,75,3,2021-01-06,0,0,0,0,2021-01-06,1609887600.0
12683,75,3,2021-01-07,0,0,0,0,2021-01-07,1609974000.0
12684,75,3,2021-01-08,0,0,0,0,2021-01-08,1610060400.0
12685,75,3,2021-01-09,0,0,0,0,2021-01-09,1610146800.0
12686,75,3,2021-01-10,0,0,0,0,2021-01-10,1610233200.0
12687,75,3,2021-01-11,0,0,0,0,2021-01-11,1610319600.0
12688,75,3,2021-01-12,0,0,0,0,2021-01-12,1610406000.0
12689,75,3,2021-01-13,0,0,0,0,2021-01-13,1610492400.0
12690,75,3,2021-01-14,0,0,0,0,2021-01-14,1610578800.0
12691,75,3,2021-01-15,0,0,0,0,2021-01-15,1610665200.0
12692,75,3,2021-01-16,0,0,0,0,2021-01-16,1610751600.0
12693,75,3,2021-01-17,0,0,0,0,2021-01-17,1610838000.0
12694,75,3,2021-01-18,0,0,0,0,2021-01-18,1610924400.0
12695,75,3,2021-01-19,0,0,0,0,2021-01-19,1611010800.0
12696,75,3,2021-01-20,0,0,0,0,2021-01-20,1611097200.0
12697,75,3,2021-01-21,0,0,0,0,2021-01-21,1611183600.0
12698,75,3,2021-01-22,0,0,0,0,2021-01-22,1611270000.0
12699,75,3,2021-01-23,0,0,0,0,2021-01-23,1611356400.0
12700,75,3,2021-01-24,0,0,0,0,2021-01-24,1611442800.0
12701,75,3,2021-01-25,0,0,0,0,2021-01-25,1611529200.0
12702,75,3,2021-01-26,0,0,0,0,2021-01-26,1611615600.0
12703,75,3,2021-01-27,0,0,0,0,2021-01-27,1611702000.0
12704,75,3,2021-01-28,0,0,0,0,2021-01-28,1611788400.0
12705,75,3,2021-01-29,0,0,0,0,2021-01-29,1611874800.0
12706,75,3,2021-01-30,0,0,0,0,2021-01-30,1611961200.0
12707,75,3,2021-01-31,0,0,0,0,2021-01-31,1612047600.0
12708,75,3,2021-02-01,0,0,0,0,2021-02-01,1612134000.0
12709,75,3,2021-02-02,0,0,0,0,2021-02-02,1612220400.0
12710,75,3,2021-02-03,0,0,0,0,2021-02-03,1612306800.0
12711,75,3,2021-02-04,0,0,0,0,2021-02-04,1612393200.0
12712,75,3,2021-02-05,0,0,0,0,2021-02-05,1612479600.0
12713,75,3,2021-02-06,32,0,32,0,2021-02-06,1612566000.0
12714,75,3,2021-02-07,358,0,390,0,2021-02-07,1612652400.0
12715,75,3,2021-02-08,321,0,711,0,2021-02-08,1612738800.0
12716,75,3,2021-02-09,452,0,1163,0,2021-02-09,1612825200.0
12717,75,3,2021-02-10,744,0,1907,0,2021-02-10,1612911600.0
12718,75,3,2021-02-11,1051,0,2958,0,2021-02-11,1612998000.0
12719,75,3,2021-02-12,870,0,3828,0,2021-02-12,1613084400.0
12720,75,3,2021-02-13,111,0,3939,0,2021-02-13,1613170800.0
12721,75,3,2021-02-14,20,0,3959,0,2021-02-14,1613257200.0
12722,75,3,2021-02-15,644,0,4603,0,2021-02-15,1613343600.0
12723,75,3,2021-02-16,808,0,5411,0,2021-02-16,1613430000.0
12724,75,3,2021-02-17,747,0,6158,0,2021-02-17,1613516400.0
12725,75,3,2021-02-18,906,0,7064,0,2021-02-18,1613602800.0
12726,75,3,2021-02-19,958,0,8022,0,2021-02-19,1613689200.0
12727,75,3,2021-02-20,196,0,8218,0,2021-02-20,1613775600.0
12728,75,3,2021-02-21,49,0,8267,0,2021-02-21,1613862000.0
12729,75,3,2021-02-22,977,0,9244,0,2021-02-22,1613948400.0
12730,75,3,2021-02-23,1191,0,10435,0,2021-02-23,1614034800.0
12731,75,3,2021-02-24,1279,0,11714,0,2021-02-24,1614121200.0
12732,75,3,2021-02-25,4339,0,16053,0,2021-02-25,1614207600.0
12733,75,3,2021-02-26,7016,0,23069,0,2021-02-26,1614294000.0
12734,75,3,2021-02-27,4206,0,27275,0,2021-02-27,1614380400.0
12735,75,3,2021-02-28,179,0,27454,0,2021-02-28,1614466800.0
12736,75,3,2021-03-01,2258,1,29712,1,2021-03-01,1614553200.0
12737,75,3,2021-03-02,4616,0,34328,1,2021-03-02,1614639600.0
12738,75,3,2021-03-03,5791,0,40119,1,2021-03-03,1614726000.0
12739,75,3,2021-03-04,10026,1,50145,2,2021-03-04,1614812400.0
12740,75,3,2021-03-05,14439,6,64584,8,2021-03-05,1614898800.0
12741,75,3,2021-03-06,11445,1,76029,9,2021-03-06,1614985200.0
12742,75,3,2021-03-07,3207,1,79236,10,2021-03-07,1615071600.0
12743,75,3,2021-03-08,4904,1,84140,11,2021-03-08,1615158000.0
12744,75,3,2021-03-09,8580,2,92720,13,2021-03-09,1615244400.0
12745,75,3,2021-03-10,9028,2,101748,15,2021-03-10,1615330800.0
12746,75,3,2021-03-11,15594,2,117342,17,2021-03-11,1615417200.0
12747,75,3,2021-03-12,20944,8,138286,25,2021-03-12,1615503600.0
12748,75,3,2021-03-13,13512,4,151798,29,2021-03-13,1615590000.0
12749,75,3,2021-03-14,848,0,152646,29,2021-03-14,1615676400.0
12750,75,3,2021-03-15,4029,1,156675,30,2021-03-15,1615762800.0
12751,75,3,2021-03-16,103,2,156778,32,2021-03-16,1615849200.0
12752,75,3,2021-03-17,63,0,156841,32,2021-03-17,1615935600.0
12753,75,3,2021-03-18,118,0,156959,32,2021-03-18,1616022000.0
12754,75,3,2021-03-19,6915,3,163874,35,2021-03-19,1616108400.0
12755,75,3,2021-03-20,6524,2,170398,37,2021-03-20,1616194800.0
12756,75,3,2021-03-21,293,0,170691,37,2021-03-21,1616281200.0
12757,75,3,2021-03-22,3381,5,174072,42,2021-03-22,1616367600.0
12758,75,3,2021-03-23,8403,7,182475,49,2021-03-23,1616454000.0
12759,75,3,2021-03-24,9563,7,192038,56,2021-03-24,1616540400.0
12760,75,3,2021-03-25,16029,12,208067,68,2021-03-25,1616626800.0
12761,75,3,2021-03-26,17940,15,226007,83,2021-03-26,1616713200.0
12762,75,3,2021-03-27,6636,4,232643,87,2021-03-27,1616799600.0
12763,75,3,2021-03-28,276,0,232919,87,2021-03-28,1616886000.0
12764,75,3,2021-03-29,5483,5,238402,92,2021-03-29,1616972400.0
12765,75,3,2021-03-30,9746,9,248148,101,2021-03-30,1617058800.0
12766,75,3,2021-03-31,7074,3,255222,104,2021-03-31,1617145200.0
12767,75,3,2021-04-01,9719,10,264941,114,2021-04-01,1617231600.0
12768,75,3,2021-04-02,9228,17,274169,131,2021-04-02,1617318000.0
12769,75,3,2021-04-03,3356,3,277525,134,2021-04-03,1617404400.0
12770,75,3,2021-04-04,122,0,277647,134,2021-04-04,1617490800.0
12771,75,3,2021-04-05,220,14,277867,148,2021-04-05,1617577200.0
12772,75,3,2021-04-06,2982,2,280849,150,2021-04-06,1617663600.0
12773,75,3,2021-04-07,3229,2,284078,152,2021-04-07,1617750000.0
12774,75,3,2021-04-08,8659,14,292737,166,2021-04-08,1617836400.0
12775,75,3,2021-04-09,19393,27,312130,193,2021-04-09,1617922800.0
12776,75,3,2021-04-10,8512,12,320642,205,2021-04-10,1618009200.0
12777,75,3,2021-04-11,539,1,321181,206,2021-04-11,1618095600.0
12778,75,3,2021-04-12,5605,4,326786,210,2021-04-12,1618185600.0
12779,75,3,2021-04-13,10064,22,336850,232,2021-04-13,1618272000.0
12780,75,3,2021-04-14,8263,29,345113,261,2021-04-14,1618358400.0
12781,75,3,2021-04-15,10615,44,355728,305,2021-04-15,1618444800.0
12782,75,3,2021-04-16,12582,62,368310,367,2021-04-16,1618531200.0
12783,75,3,2021-04-17,5098,13,373408,380,2021-04-17,1618617600.0
12784,75,3,2021-04-18,718,3,374126,383,2021-04-18,1618704000.0
12785,75,3,2021-04-19,2352,18,376478,401,2021-04-19,1618790400.0
12786,75,3,2021-04-20,5372,37,381850,438,2021-04-20,1618876800.0
12787,75,3,2021-04-21,4698,17,386548,455,2021-04-21,1618963200.0
12788,75,3,2021-04-22,6932,72,393480,527,2021-04-22,1619049600.0
12789,75,3,2021-04-23,7510,82,400990,609,2021-04-23,1619136000.0
12790,75,3,2021-04-24,3831,130,404821,739,2021-04-24,1619222400.0
12791,75,3,2021-04-25,715,11,405536,750,2021-04-25,1619308800.0
12792,75,3,2021-04-26,2034,76,407570,826,2021-04-26,1619395200.0
12793,75,3,2021-04-27,3937,120,411507,946,2021-04-27,1619481600.0
12794,75,3,2021-04-28,3587,178,415094,1124,2021-04-28,1619568000.0
12795,75,3,2021-04-29,5876,535,420970,1659,2021-04-29,1619654400.0
12796,75,3,2021-04-30,6360,1061,427330,2720,2021-04-30,1619740800.0
12797,75,3,2021-05-01,983,183,428313,2903,2021-05-01,1619827200.0
12798,75,3,2021-05-02,487,20,428800,2923,2021-05-02,1619913600.0
12799,75,3,2021-05-03,1331,406,430131,3329,2021-05-03,1620000000.0
12800,75,3,2021-05-04,2621,790,432752,4119,2021-05-04,1620086400.0
12801,75,3,2021-05-05,2168,1196,434920,5315,2021-05-05,1620172800.0
12802,75,3,2021-05-06,4566,2592,439486,7907,2021-05-06,1620259200.0
12803,75,3,2021-05-07,5906,3156,445392,11063,2021-05-07,1620345600.0
12804,75,3,2021-05-08,843,655,446235,11718,2021-05-08,1620432000.0
12805,75,3,2021-05-09,191,146,446426,11864,2021-05-09,1620518400.0
12806,75,3,2021-05-10,1460,1499,447886,13363,2021-05-10,1620604800.0
12807,75,3,2021-05-11,3400,2997,451286,16360,2021-05-11,1620691200.0
12808,75,3,2021-05-12,1934,3149,453220,19509,2021-05-12,1620777600.0
12809,75,3,2021-05-13,264,560,453484,20069,2021-05-13,1620864000.0
12810,75,3,2021-05-14,1677,2854,455161,22923,2021-05-14,1620950400.0
12811,75,3,2021-05-15,857,2174,456018,25097,2021-05-15,1621036800.0
12812,75,3,2021-05-16,114,218,456132,25315,2021-05-16,1621123200.0
12813,75,3,2021-05-17,861,2241,456993,27556,2021-05-17,1621206000.0
12814,75,3,2021-05-18,1647,3069,458640,30625,2021-05-18,1621292400.0
12815,75,3,2021-05-19,1067,3137,459707,33762,2021-05-19,1621378800.0
12816,75,3,2021-05-20,1494,6613,461201,40375,2021-05-20,1621465200.0
12817,75,3,2021-05-21,1487,7275,462688,47650,2021-05-21,1621551600.0
12818,75,3,2021-05-22,495,3527,463183,51177,2021-05-22,1621638000.0
12819,75,3,2021-05-23,40,305,463223,51482,2021-05-23,1621724400.0
12820,75,3,2021-05-24,51,511,463274,51993,2021-05-24,1621810800.0
12821,75,3,2021-05-25,608,4520,463882,56513,2021-05-25,1621897200.0
12822,75,3,2021-05-26,481,5908,464363,62421,2021-05-26,1621983600.0
12823,75,3,2021-05-27,686,9753,465049,72174,2021-05-27,1622070000.0
12824,75,3,2021-05-28,838,11818,465887,83992,2021-05-28,1622156400.0
12825,75,3,2021-05-29,304,6591,466191,90583,2021-05-29,1622242800.0
12826,75,3,2021-05-30,16,363,466207,90946,2021-05-30,1622329200.0
12827,75,3,2021-05-31,197,3652,466404,94598,2021-05-31,1622415600.0
12828,75,3,2021-06-01,320,7141,466724,101739,2021-06-01,1622502000.0
12829,75,3,2021-06-02,248,6916,466972,108655,2021-06-02,1622588400.0
12830,75,3,2021-06-03,363,10553,467335,119208,2021-06-03,1622674800.0
12831,75,3,2021-06-04,432,12353,467767,131561,2021-06-04,1622761200.0
12832,75,3,2021-06-05,195,5264,467962,136825,2021-06-05,1622847600.0
12833,75,3,2021-06-06,20,380,467982,137205,2021-06-06,1622934000.0
12834,75,3,2021-06-07,86,3087,468068,140292,2021-06-07,1623020400.0
12835,75,3,2021-06-08,197,4861,468265,145153,2021-06-08,1623106800.0
12836,75,3,2021-06-09,107,4832,468372,149985,2021-06-09,1623193200.0
12837,75,3,2021-06-10,202,7781,468574,157766,2021-06-10,1623279600.0
12838,75,3,2021-06-11,226,11178,468800,168944,2021-06-11,1623366000.0
12839,75,3,2021-06-12,117,3966,468917,172910,2021-06-12,1623452400.0
12840,75,3,2021-06-13,22,298,468939,173208,2021-06-13,1623538800.0
12841,75,3,2021-06-14,58,4375,468997,177583,2021-06-14,1623625200.0
12842,75,3,2021-06-15,110,8490,469107,186073,2021-06-15,1623711600.0
12843,75,3,2021-06-16,93,7496,469200,193569,2021-06-16,1623798000.0
12844,75,3,2021-06-17,161,11881,469361,205450,2021-06-17,1623884400.0
12845,75,3,2021-06-18,138,13284,469499,218734,2021-06-18,1623970800.0
12846,75,3,2021-06-19,63,3930,469562,222664,2021-06-19,1624057200.0
12847,75,3,2021-06-20,4,364,469566,223028,2021-06-20,1624143600.0
12848,75,3,2021-06-21,41,4022,469607,227050,2021-06-21,1624230000.0
12849,75,3,2021-06-22,80,7975,469687,235025,2021-06-22,1624316400.0
12850,75,3,2021-06-23,63,6290,469750,241315,2021-06-23,1624402800.0
12851,75,3,2021-06-24,91,8803,469841,250118,2021-06-24,1624489200.0
12852,75,3,2021-06-25,113,10285,469954,260403,2021-06-25,1624575600.0
12853,75,3,2021-06-26,53,3027,470007,263430,2021-06-26,1624662000.0
12854,75,3,2021-06-27,1,210,470008,263640,2021-06-27,1624748400.0
12855,75,3,2021-06-28,27,3102,470035,266742,2021-06-28,1624834800.0
12856,75,3,2021-06-29,59,6598,470094,273340,2021-06-29,1624921200.0
12857,75,3,2021-06-30,58,5351,470152,278691,2021-06-30,1625007600.0
12858,75,3,2021-07-01,83,7689,470235,286380,2021-07-01,1625094000.0
12859,75,3,2021-07-02,110,10497,470345,296877,2021-07-02,1625180400.0
12860,75,3,2021-07-03,52,3104,470397,299981,2021-07-03,1625266800.0
12861,75,3,2021-07-04,5,383,470402,300364,2021-07-04,1625353200.0
12862,75,3,2021-07-05,42,3550,470444,303914,2021-07-05,1625439600.0
12863,75,3,2021-07-06,70,7327,470514,311241,2021-07-06,1625526000.0
12864,75,4,2020-12-27,0,0,0,0,2020-12-27,1609023600.0
12865,75,4,2020-12-28,0,0,0,0,2020-12-28,1609110000.0
12866,75,4,2020-12-29,0,0,0,0,2020-12-29,1609196400.0
12867,75,4,2020-12-30,0,0,0,0,2020-12-30,1609282800.0
12868,75,4,2020-12-31,0,0,0,0,2020-12-31,1609369200.0
12869,75,4,2021-01-01,0,0,0,0,2021-01-01,1609455600.0
12870,75,4,2021-01-02,0,0,0,0,2021-01-02,1609542000.0
12871,75,4,2021-01-03,0,0,0,0,2021-01-03,1609628400.0
12872,75,4,2021-01-04,0,0,0,0,2021-01-04,1609714800.0
12873,75,4,2021-01-05,0,0,0,0,2021-01-05,1609801200.0
12874,75,4,2021-01-06,0,0,0,0,2021-01-06,1609887600.0
12875,75,4,2021-01-07,0,0,0,0,2021-01-07,1609974000.0
12876,75,4,2021-01-08,0,0,0,0,2021-01-08,1610060400.0
12877,75,4,2021-01-09,0,0,0,0,2021-01-09,1610146800.0
12878,75,4,2021-01-10,0,0,0,0,2021-01-10,1610233200.0
12879,75,4,2021-01-11,0,0,0,0,2021-01-11,1610319600.0
12880,75,4,2021-01-12,0,0,0,0,2021-01-12,1610406000.0
12881,75,4,2021-01-13,0,0,0,0,2021-01-13,1610492400.0
12882,75,4,2021-01-14,0,0,0,0,2021-01-14,1610578800.0
12883,75,4,2021-01-15,0,0,0,0,2021-01-15,1610665200.0
12884,75,4,2021-01-16,0,0,0,0,2021-01-16,1610751600.0
12885,75,4,2021-01-17,0,0,0,0,2021-01-17,1610838000.0
12886,75,4,2021-01-18,0,0,0,0,2021-01-18,1610924400.0
12887,75,4,2021-01-19,0,0,0,0,2021-01-19,1611010800.0
12888,75,4,2021-01-20,0,0,0,0,2021-01-20,1611097200.0
12889,75,4,2021-01-21,0,0,0,0,2021-01-21,1611183600.0
12890,75,4,2021-01-22,0,0,0,0,2021-01-22,1611270000.0
12891,75,4,2021-01-23,0,0,0,0,2021-01-23,1611356400.0
12892,75,4,2021-01-24,0,0,0,0,2021-01-24,1611442800.0
12893,75,4,2021-01-25,0,0,0,0,2021-01-25,1611529200.0
12894,75,4,2021-01-26,0,0,0,0,2021-01-26,1611615600.0
12895,75,4,2021-01-27,0,0,0,0,2021-01-27,1611702000.0
12896,75,4,2021-01-28,0,0,0,0,2021-01-28,1611788400.0
12897,75,4,2021-01-29,0,0,0,0,2021-01-29,1611874800.0
12898,75,4,2021-01-30,0,0,0,0,2021-01-30,1611961200.0
12899,75,4,2021-01-31,0,0,0,0,2021-01-31,1612047600.0
12900,75,4,2021-02-01,0,0,0,0,2021-02-01,1612134000.0
12901,75,4,2021-02-02,0,0,0,0,2021-02-02,1612220400.0
12902,75,4,2021-02-03,0,0,0,0,2021-02-03,1612306800.0
12903,75,4,2021-02-04,0,0,0,0,2021-02-04,1612393200.0
12904,75,4,2021-02-05,0,0,0,0,2021-02-05,1612479600.0
12905,75,4,2021-02-06,0,0,0,0,2021-02-06,1612566000.0
12906,75,4,2021-02-07,0,0,0,0,2021-02-07,1612652400.0
12907,75,4,2021-02-08,0,0,0,0,2021-02-08,1612738800.0
12908,75,4,2021-02-09,0,0,0,0,2021-02-09,1612825200.0
12909,75,4,2021-02-10,0,0,0,0,2021-02-10,1612911600.0
12910,75,4,2021-02-11,0,0,0,0,2021-02-11,1612998000.0
12911,75,4,2021-02-12,0,0,0,0,2021-02-12,1613084400.0
12912,75,4,2021-02-13,0,0,0,0,2021-02-13,1613170800.0
12913,75,4,2021-02-14,0,0,0,0,2021-02-14,1613257200.0
12914,75,4,2021-02-15,0,0,0,0,2021-02-15,1613343600.0
12915,75,4,2021-02-16,0,0,0,0,2021-02-16,1613430000.0
12916,75,4,2021-02-17,0,0,0,0,2021-02-17,1613516400.0
12917,75,4,2021-02-18,0,0,0,0,2021-02-18,1613602800.0
12918,75,4,2021-02-19,0,0,0,0,2021-02-19,1613689200.0
12919,75,4,2021-02-20,0,0,0,0,2021-02-20,1613775600.0
12920,75,4,2021-02-21,0,0,0,0,2021-02-21,1613862000.0
12921,75,4,2021-02-22,0,0,0,0,2021-02-22,1613948400.0
12922,75,4,2021-02-23,0,0,0,0,2021-02-23,1614034800.0
12923,75,4,2021-02-24,0,0,0,0,2021-02-24,1614121200.0
12924,75,4,2021-02-25,0,0,0,0,2021-02-25,1614207600.0
12925,75,4,2021-02-26,0,0,0,0,2021-02-26,1614294000.0
12926,75,4,2021-02-27,0,0,0,0,2021-02-27,1614380400.0
12927,75,4,2021-02-28,0,0,0,0,2021-02-28,1614466800.0
12928,75,4,2021-03-01,0,0,0,0,2021-03-01,1614553200.0
12929,75,4,2021-03-02,0,0,0,0,2021-03-02,1614639600.0
12930,75,4,2021-03-03,0,0,0,0,2021-03-03,1614726000.0
12931,75,4,2021-03-04,0,0,0,0,2021-03-04,1614812400.0
12932,75,4,2021-03-05,0,0,0,0,2021-03-05,1614898800.0
12933,75,4,2021-03-06,0,0,0,0,2021-03-06,1614985200.0
12934,75,4,2021-03-07,0,0,0,0,2021-03-07,1615071600.0
12935,75,4,2021-03-08,0,0,0,0,2021-03-08,1615158000.0
12936,75,4,2021-03-09,0,0,0,0,2021-03-09,1615244400.0
12937,75,4,2021-03-10,0,0,0,0,2021-03-10,1615330800.0
12938,75,4,2021-03-11,0,0,0,0,2021-03-11,1615417200.0
12939,75,4,2021-03-12,0,0,0,0,2021-03-12,1615503600.0
12940,75,4,2021-03-13,0,0,0,0,2021-03-13,1615590000.0
12941,75,4,2021-03-14,0,0,0,0,2021-03-14,1615676400.0
12942,75,4,2021-03-15,0,0,0,0,2021-03-15,1615762800.0
12943,75,4,2021-03-16,0,0,0,0,2021-03-16,1615849200.0
12944,75,4,2021-03-17,0,0,0,0,2021-03-17,1615935600.0
12945,75,4,2021-03-18,0,0,0,0,2021-03-18,1616022000.0
12946,75,4,2021-03-19,0,0,0,0,2021-03-19,1616108400.0
12947,75,4,2021-03-20,0,0,0,0,2021-03-20,1616194800.0
12948,75,4,2021-03-21,0,0,0,0,2021-03-21,1616281200.0
12949,75,4,2021-03-22,0,0,0,0,2021-03-22,1616367600.0
12950,75,4,2021-03-23,0,0,0,0,2021-03-23,1616454000.0
12951,75,4,2021-03-24,0,0,0,0,2021-03-24,1616540400.0
12952,75,4,2021-03-25,0,0,0,0,2021-03-25,1616626800.0
12953,75,4,2021-03-26,0,0,0,0,2021-03-26,1616713200.0
12954,75,4,2021-03-27,0,0,0,0,2021-03-27,1616799600.0
12955,75,4,2021-03-28,0,0,0,0,2021-03-28,1616886000.0
12956,75,4,2021-03-29,0,0,0,0,2021-03-29,1616972400.0
12957,75,4,2021-03-30,0,0,0,0,2021-03-30,1617058800.0
12958,75,4,2021-03-31,0,0,0,0,2021-03-31,1617145200.0
12959,75,4,2021-04-01,0,0,0,0,2021-04-01,1617231600.0
12960,75,4,2021-04-02,0,0,0,0,2021-04-02,1617318000.0
12961,75,4,2021-04-03,0,0,0,0,2021-04-03,1617404400.0
12962,75,4,2021-04-04,0,0,0,0,2021-04-04,1617490800.0
12963,75,4,2021-04-05,0,0,0,0,2021-04-05,1617577200.0
12964,75,4,2021-04-06,0,0,0,0,2021-04-06,1617663600.0
12965,75,4,2021-04-07,0,0,0,0,2021-04-07,1617750000.0
12966,75,4,2021-04-08,0,0,0,0,2021-04-08,1617836400.0
12967,75,4,2021-04-09,0,0,0,0,2021-04-09,1617922800.0
12968,75,4,2021-04-10,0,0,0,0,2021-04-10,1618009200.0
12969,75,4,2021-04-11,0,0,0,0,2021-04-11,1618095600.0
12970,75,4,2021-04-12,0,0,0,0,2021-04-12,1618185600.0
12971,75,4,2021-04-13,0,0,0,0,2021-04-13,1618272000.0
12972,75,4,2021-04-14,0,0,0,0,2021-04-14,1618358400.0
12973,75,4,2021-04-15,0,0,0,0,2021-04-15,1618444800.0
12974,75,4,2021-04-16,0,0,0,0,2021-04-16,1618531200.0
12975,75,4,2021-04-17,0,0,0,0,2021-04-17,1618617600.0
12976,75,4,2021-04-18,0,0,0,0,2021-04-18,1618704000.0
12977,75,4,2021-04-19,0,0,0,0,2021-04-19,1618790400.0
12978,75,4,2021-04-20,0,0,0,0,2021-04-20,1618876800.0
12979,75,4,2021-04-21,0,0,0,0,2021-04-21,1618963200.0
12980,75,4,2021-04-22,0,0,0,0,2021-04-22,1619049600.0
12981,75,4,2021-04-23,96,0,96,0,2021-04-23,1619136000.0
12982,75,4,2021-04-24,177,0,273,0,2021-04-24,1619222400.0
12983,75,4,2021-04-25,10,0,283,0,2021-04-25,1619308800.0
12984,75,4,2021-04-26,343,0,626,0,2021-04-26,1619395200.0
12985,75,4,2021-04-27,1107,1,1733,1,2021-04-27,1619481600.0
12986,75,4,2021-04-28,1067,1,2800,2,2021-04-28,1619568000.0
12987,75,4,2021-04-29,1958,1,4758,3,2021-04-29,1619654400.0
12988,75,4,2021-04-30,2253,0,7011,3,2021-04-30,1619740800.0
12989,75,4,2021-05-01,244,0,7255,3,2021-05-01,1619827200.0
12990,75,4,2021-05-02,40,0,7295,3,2021-05-02,1619913600.0
12991,75,4,2021-05-03,526,0,7821,3,2021-05-03,1620000000.0
12992,75,4,2021-05-04,967,1,8788,4,2021-05-04,1620086400.0
12993,75,4,2021-05-05,775,0,9563,4,2021-05-05,1620172800.0
12994,75,4,2021-05-06,1497,6,11060,10,2021-05-06,1620259200.0
12995,75,4,2021-05-07,2402,1,13462,11,2021-05-07,1620345600.0
12996,75,4,2021-05-08,245,1,13707,12,2021-05-08,1620432000.0
12997,75,4,2021-05-09,35,0,13742,12,2021-05-09,1620518400.0
12998,75,4,2021-05-10,770,0,14512,12,2021-05-10,1620604800.0
12999,75,4,2021-05-11,1638,0,16150,12,2021-05-11,1620691200.0
13000,75,4,2021-05-12,1145,0,17295,12,2021-05-12,1620777600.0
13001,75,4,2021-05-13,263,0,17558,12,2021-05-13,1620864000.0
13002,75,4,2021-05-14,784,1,18342,13,2021-05-14,1620950400.0
13003,75,4,2021-05-15,379,0,18721,13,2021-05-15,1621036800.0
13004,75,4,2021-05-16,22,0,18743,13,2021-05-16,1621123200.0
13005,75,4,2021-05-17,553,1,19296,14,2021-05-17,1621206000.0
13006,75,4,2021-05-18,932,0,20228,14,2021-05-18,1621292400.0
13007,75,4,2021-05-19,502,0,20730,14,2021-05-19,1621378800.0
13008,75,4,2021-05-20,1001,0,21731,14,2021-05-20,1621465200.0
13009,75,4,2021-05-21,1391,0,23122,14,2021-05-21,1621551600.0
13010,75,4,2021-05-22,469,1,23591,15,2021-05-22,1621638000.0
13011,75,4,2021-05-23,24,0,23615,15,2021-05-23,1621724400.0
13012,75,4,2021-05-24,97,0,23712,15,2021-05-24,1621810800.0
13013,75,4,2021-05-25,703,5,24415,20,2021-05-25,1621897200.0
13014,75,4,2021-05-26,917,1,25332,21,2021-05-26,1621983600.0
13015,75,4,2021-05-27,1461,2,26793,23,2021-05-27,1622070000.0
13016,75,4,2021-05-28,3216,4,30009,27,2021-05-28,1622156400.0
13017,75,4,2021-05-29,1200,1,31209,28,2021-05-29,1622242800.0
13018,75,4,2021-05-30,52,0,31261,28,2021-05-30,1622329200.0
13019,75,4,2021-05-31,1386,1,32647,29,2021-05-31,1622415600.0
13020,75,4,2021-06-01,2302,3,34949,32,2021-06-01,1622502000.0
13021,75,4,2021-06-02,1651,3,36600,35,2021-06-02,1622588400.0
13022,75,4,2021-06-03,2363,3,38963,38,2021-06-03,1622674800.0
13023,75,4,2021-06-04,2566,3,41529,41,2021-06-04,1622761200.0
13024,75,4,2021-06-05,1143,3,42672,44,2021-06-05,1622847600.0
13025,75,4,2021-06-06,69,0,42741,44,2021-06-06,1622934000.0
13026,75,4,2021-06-07,1085,2,43826,46,2021-06-07,1623020400.0
13027,75,4,2021-06-08,1693,4,45519,50,2021-06-08,1623106800.0
13028,75,4,2021-06-09,1340,4,46859,54,2021-06-09,1623193200.0
13029,75,4,2021-06-10,1997,1,48856,55,2021-06-10,1623279600.0
13030,75,4,2021-06-11,2182,2,51038,57,2021-06-11,1623366000.0
13031,75,4,2021-06-12,808,0,51846,57,2021-06-12,1623452400.0
13032,75,4,2021-06-13,41,0,51887,57,2021-06-13,1623538800.0
13033,75,4,2021-06-14,784,1,52671,58,2021-06-14,1623625200.0
13034,75,4,2021-06-15,1426,3,54097,61,2021-06-15,1623711600.0
13035,75,4,2021-06-16,1053,0,55150,61,2021-06-16,1623798000.0
13036,75,4,2021-06-17,1506,1,56656,62,2021-06-17,1623884400.0
13037,75,4,2021-06-18,1433,5,58089,67,2021-06-18,1623970800.0
13038,75,4,2021-06-19,656,1,58745,68,2021-06-19,1624057200.0
13039,75,4,2021-06-20,38,0,58783,68,2021-06-20,1624143600.0
13040,75,4,2021-06-21,605,0,59388,68,2021-06-21,1624230000.0
13041,75,4,2021-06-22,890,2,60278,70,2021-06-22,1624316400.0
13042,75,4,2021-06-23,837,4,61115,74,2021-06-23,1624402800.0
13043,75,4,2021-06-24,1095,1,62210,75,2021-06-24,1624489200.0
13044,75,4,2021-06-25,1227,2,63437,77,2021-06-25,1624575600.0
13045,75,4,2021-06-26,495,2,63932,79,2021-06-26,1624662000.0
13046,75,4,2021-06-27,15,0,63947,79,2021-06-27,1624748400.0
13047,75,4,2021-06-28,530,1,64477,80,2021-06-28,1624834800.0
13048,75,4,2021-06-29,761,3,65238,83,2021-06-29,1624921200.0
13049,75,4,2021-06-30,838,6,66076,89,2021-06-30,1625007600.0
13050,75,4,2021-07-01,994,4,67070,93,2021-07-01,1625094000.0
13051,75,4,2021-07-02,1209,16,68279,109,2021-07-02,1625180400.0
13052,75,4,2021-07-03,559,1,68838,110,2021-07-03,1625266800.0
13053,75,4,2021-07-04,21,0,68859,110,2021-07-04,1625353200.0
13054,75,4,2021-07-05,457,1,69316,111,2021-07-05,1625439600.0
13055,75,4,2021-07-06,897,1,70213,112,2021-07-06,1625526000.0
13056,76,1,2020-12-27,0,0,0,0,2020-12-27,1609023600.0
13057,76,1,2020-12-28,5,0,5,0,2020-12-28,1609110000.0
13058,76,1,2020-12-29,0,0,5,0,2020-12-29,1609196400.0
13059,76,1,2020-12-30,0,0,5,0,2020-12-30,1609282800.0
13060,76,1,2020-12-31,1,0,6,0,2020-12-31,1609369200.0
13061,76,1,2021-01-01,3,0,9,0,2021-01-01,1609455600.0
13062,76,1,2021-01-02,2,0,11,0,2021-01-02,1609542000.0
13063,76,1,2021-01-03,2,0,13,0,2021-01-03,1609628400.0
13064,76,1,2021-01-04,59,0,72,0,2021-01-04,1609714800.0
13065,76,1,2021-01-05,473,0,545,0,2021-01-05,1609801200.0
13066,76,1,2021-01-06,784,0,1329,0,2021-01-06,1609887600.0
13067,76,1,2021-01-07,2541,0,3870,0,2021-01-07,1609974000.0
13068,76,1,2021-01-08,3217,0,7087,0,2021-01-08,1610060400.0
13069,76,1,2021-01-09,1539,0,8626,0,2021-01-09,1610146800.0
13070,76,1,2021-01-10,517,0,9143,0,2021-01-10,1610233200.0
13071,76,1,2021-01-11,3524,0,12667,0,2021-01-11,1610319600.0
13072,76,1,2021-01-12,5751,0,18418,0,2021-01-12,1610406000.0
13073,76,1,2021-01-13,6477,0,24895,0,2021-01-13,1610492400.0
13074,76,1,2021-01-14,8996,0,33891,0,2021-01-14,1610578800.0
13075,76,1,2021-01-15,7252,0,41143,0,2021-01-15,1610665200.0
13076,76,1,2021-01-16,1953,16,43096,16,2021-01-16,1610751600.0
13077,76,1,2021-01-17,710,2,43806,18,2021-01-17,1610838000.0
13078,76,1,2021-01-18,7706,12,51512,30,2021-01-18,1610924400.0
13079,76,1,2021-01-19,11207,10,62719,40,2021-01-19,1611010800.0
13080,76,1,2021-01-20,13723,9,76442,49,2021-01-20,1611097200.0
13081,76,1,2021-01-21,16722,6,93164,55,2021-01-21,1611183600.0
13082,76,1,2021-01-22,11924,15,105088,70,2021-01-22,1611270000.0
13083,76,1,2021-01-23,3897,5,108985,75,2021-01-23,1611356400.0
13084,76,1,2021-01-24,771,10,109756,85,2021-01-24,1611442800.0
13085,76,1,2021-01-25,7828,85,117584,170,2021-01-25,1611529200.0
13086,76,1,2021-01-26,10349,266,127933,436,2021-01-26,1611615600.0
13087,76,1,2021-01-27,10848,461,138781,897,2021-01-27,1611702000.0
13088,76,1,2021-01-28,10140,1681,148921,2578,2021-01-28,1611788400.0
13089,76,1,2021-01-29,8091,1980,157012,4558,2021-01-29,1611874800.0
13090,76,1,2021-01-30,3186,769,160198,5327,2021-01-30,1611961200.0
13091,76,1,2021-01-31,521,267,160719,5594,2021-01-31,1612047600.0
13092,76,1,2021-02-01,5857,2596,166576,8190,2021-02-01,1612134000.0
13093,76,1,2021-02-02,10064,3987,176640,12177,2021-02-02,1612220400.0
13094,76,1,2021-02-03,9519,4048,186159,16225,2021-02-03,1612306800.0
13095,76,1,2021-02-04,10108,5925,196267,22150,2021-02-04,1612393200.0
13096,76,1,2021-02-05,7775,4984,204042,27134,2021-02-05,1612479600.0
13097,76,1,2021-02-06,2679,1047,206721,28181,2021-02-06,1612566000.0
13098,76,1,2021-02-07,476,494,207197,28675,2021-02-07,1612652400.0
13099,76,1,2021-02-08,4579,4512,211776,33187,2021-02-08,1612738800.0
13100,76,1,2021-02-09,5787,6788,217563,39975,2021-02-09,1612825200.0
13101,76,1,2021-02-10,6353,9194,223916,49169,2021-02-10,1612911600.0
13102,76,1,2021-02-11,7844,10665,231760,59834,2021-02-11,1612998000.0
13103,76,1,2021-02-12,6427,7629,238187,67463,2021-02-12,1613084400.0
13104,76,1,2021-02-13,2218,2260,240405,69723,2021-02-13,1613170800.0
13105,76,1,2021-02-14,335,993,240740,70716,2021-02-14,1613257200.0
13106,76,1,2021-02-15,2287,6444,243027,77160,2021-02-15,1613343600.0
13107,76,1,2021-02-16,3039,8658,246066,85818,2021-02-16,1613430000.0
13108,76,1,2021-02-17,3130,9603,249196,95421,2021-02-17,1613516400.0
13109,76,1,2021-02-18,4026,9927,253222,105348,2021-02-18,1613602800.0
13110,76,1,2021-02-19,3179,8075,256401,113423,2021-02-19,1613689200.0
13111,76,1,2021-02-20,836,3023,257237,116446,2021-02-20,1613775600.0
13112,76,1,2021-02-21,201,589,257438,117035,2021-02-21,1613862000.0
13113,76,1,2021-02-22,2229,7614,259667,124649,2021-02-22,1613948400.0
13114,76,1,2021-02-23,3606,10189,263273,134838,2021-02-23,1614034800.0
13115,76,1,2021-02-24,3628,10373,266901,145211,2021-02-24,1614121200.0
13116,76,1,2021-02-25,4788,9801,271689,155012,2021-02-25,1614207600.0
13117,76,1,2021-02-26,4556,8295,276245,163307,2021-02-26,1614294000.0
13118,76,1,2021-02-27,1106,3066,277351,166373,2021-02-27,1614380400.0
13119,76,1,2021-02-28,122,449,277473,166822,2021-02-28,1614466800.0
13120,76,1,2021-03-01,2593,6074,280066,172896,2021-03-01,1614553200.0
13121,76,1,2021-03-02,3775,7476,283841,180372,2021-03-02,1614639600.0
13122,76,1,2021-03-03,4359,7363,288200,187735,2021-03-03,1614726000.0
13123,76,1,2021-03-04,5310,7693,293510,195428,2021-03-04,1614812400.0
13124,76,1,2021-03-05,5333,6897,298843,202325,2021-03-05,1614898800.0
13125,76,1,2021-03-06,2055,2002,300898,204327,2021-03-06,1614985200.0
13126,76,1,2021-03-07,479,351,301377,204678,2021-03-07,1615071600.0
13127,76,1,2021-03-08,4581,5291,305958,209969,2021-03-08,1615158000.0
13128,76,1,2021-03-09,7413,6000,313371,215969,2021-03-09,1615244400.0
13129,76,1,2021-03-10,7492,5871,320863,221840,2021-03-10,1615330800.0
13130,76,1,2021-03-11,8530,5567,329393,227407,2021-03-11,1615417200.0
13131,76,1,2021-03-12,8626,4420,338019,231827,2021-03-12,1615503600.0
13132,76,1,2021-03-13,3895,1728,341914,233555,2021-03-13,1615590000.0
13133,76,1,2021-03-14,1288,283,343202,233838,2021-03-14,1615676400.0
13134,76,1,2021-03-15,8595,2687,351797,236525,2021-03-15,1615762800.0
13135,76,1,2021-03-16,10994,3731,362791,240256,2021-03-16,1615849200.0
13136,76,1,2021-03-17,12041,3177,374832,243433,2021-03-17,1615935600.0
13137,76,1,2021-03-18,12801,4092,387633,247525,2021-03-18,1616022000.0
13138,76,1,2021-03-19,12414,3179,400047,250704,2021-03-19,1616108400.0
13139,76,1,2021-03-20,5261,679,405308,251383,2021-03-20,1616194800.0
13140,76,1,2021-03-21,1134,187,406442,251570,2021-03-21,1616281200.0
13141,76,1,2021-03-22,10733,3052,417175,254622,2021-03-22,1616367600.0
13142,76,1,2021-03-23,13381,3500,430556,258122,2021-03-23,1616454000.0
13143,76,1,2021-03-24,13216,3577,443772,261699,2021-03-24,1616540400.0
13144,76,1,2021-03-25,15152,3610,458924,265309,2021-03-25,1616626800.0
13145,76,1,2021-03-26,13826,3432,472750,268741,2021-03-26,1616713200.0
13146,76,1,2021-03-27,9695,1062,482445,269803,2021-03-27,1616799600.0
13147,76,1,2021-03-28,3359,145,485804,269948,2021-03-28,1616886000.0
13148,76,1,2021-03-29,14181,4040,499985,273988,2021-03-29,1616972400.0
13149,76,1,2021-03-30,17814,4770,517799,278758,2021-03-30,1617058800.0
13150,76,1,2021-03-31,17723,4674,535522,283432,2021-03-31,1617145200.0
13151,76,1,2021-04-01,21536,4365,557058,287797,2021-04-01,1617231600.0
13152,76,1,2021-04-02,18150,4615,575208,292412,2021-04-02,1617318000.0
13153,76,1,2021-04-03,7459,2075,582667,294487,2021-04-03,1617404400.0
13154,76,1,2021-04-04,3314,578,585981,295065,2021-04-04,1617490800.0
13155,76,1,2021-04-05,3301,373,589282,295438,2021-04-05,1617577200.0
13156,76,1,2021-04-06,17847,8887,607129,304325,2021-04-06,1617663600.0
13157,76,1,2021-04-07,20000,8646,627129,312971,2021-04-07,1617750000.0
13158,76,1,2021-04-08,23581,8497,650710,321468,2021-04-08,1617836400.0
13159,76,1,2021-04-09,21287,7905,671997,329373,2021-04-09,1617922800.0
13160,76,1,2021-04-10,14754,3939,686751,333312,2021-04-10,1618009200.0
13161,76,1,2021-04-11,7447,1249,694198,334561,2021-04-11,1618095600.0
13162,76,1,2021-04-12,18747,9506,712945,344067,2021-04-12,1618185600.0
13163,76,1,2021-04-13,24986,11446,737931,355513,2021-04-13,1618272000.0
13164,76,1,2021-04-14,24221,11722,762152,367235,2021-04-14,1618358400.0
13165,76,1,2021-04-15,26294,12023,788446,379258,2021-04-15,1618444800.0
13166,76,1,2021-04-16,23039,11291,811485,390549,2021-04-16,1618531200.0
13167,76,1,2021-04-17,16617,4799,828102,395348,2021-04-17,1618617600.0
13168,76,1,2021-04-18,6985,906,835087,396254,2021-04-18,1618704000.0
13169,76,1,2021-04-19,18414,11685,853501,407939,2021-04-19,1618790400.0
13170,76,1,2021-04-20,22258,14890,875759,422829,2021-04-20,1618876800.0
13171,76,1,2021-04-21,21736,14633,897495,437462,2021-04-21,1618963200.0
13172,76,1,2021-04-22,23229,15292,920724,452754,2021-04-22,1619049600.0
13173,76,1,2021-04-23,20848,13564,941572,466318,2021-04-23,1619136000.0
13174,76,1,2021-04-24,14028,8310,955600,474628,2021-04-24,1619222400.0
13175,76,1,2021-04-25,6033,3087,961633,477715,2021-04-25,1619308800.0
13176,76,1,2021-04-26,17016,15569,978649,493284,2021-04-26,1619395200.0
13177,76,1,2021-04-27,21690,17799,1000339,511083,2021-04-27,1619481600.0
13178,76,1,2021-04-28,21570,16743,1021909,527826,2021-04-28,1619568000.0
13179,76,1,2021-04-29,23357,16262,1045266,544088,2021-04-29,1619654400.0
13180,76,1,2021-04-30,23738,14706,1069004,558794,2021-04-30,1619740800.0
13181,76,1,2021-05-01,15479,4635,1084483,563429,2021-05-01,1619827200.0
13182,76,1,2021-05-02,8725,3358,1093208,566787,2021-05-02,1619913600.0
13183,76,1,2021-05-03,23399,13149,1116607,579936,2021-05-03,1620000000.0
13184,76,1,2021-05-04,25868,21111,1142475,601047,2021-05-04,1620086400.0
13185,76,1,2021-05-05,24137,21366,1166612,622413,2021-05-05,1620172800.0
13186,76,1,2021-05-06,24772,22680,1191384,645093,2021-05-06,1620259200.0
13187,76,1,2021-05-07,22434,21817,1213818,666910,2021-05-07,1620345600.0
13188,76,1,2021-05-08,13322,7279,1227140,674189,2021-05-08,1620432000.0
13189,76,1,2021-05-09,5952,7169,1233092,681358,2021-05-09,1620518400.0
13190,76,1,2021-05-10,17635,23103,1250727,704461,2021-05-10,1620604800.0
13191,76,1,2021-05-11,21353,24725,1272080,729186,2021-05-11,1620691200.0
13192,76,1,2021-05-12,24266,22303,1296346,751489,2021-05-12,1620777600.0
13193,76,1,2021-05-13,19329,8029,1315675,759518,2021-05-13,1620864000.0
13194,76,1,2021-05-14,26480,16052,1342155,775570,2021-05-14,1620950400.0
13195,76,1,2021-05-15,16684,8445,1358839,784015,2021-05-15,1621036800.0
13196,76,1,2021-05-16,9149,2757,1367988,786772,2021-05-16,1621123200.0
13197,76,1,2021-05-17,20917,13742,1388905,800514,2021-05-17,1621206000.0
13198,76,1,2021-05-18,27203,12180,1416108,812694,2021-05-18,1621292400.0
13199,76,1,2021-05-19,29373,10672,1445481,823366,2021-05-19,1621378800.0
13200,76,1,2021-05-20,31617,9151,1477098,832517,2021-05-20,1621465200.0
13201,76,1,2021-05-21,29241,9633,1506339,842150,2021-05-21,1621551600.0
13202,76,1,2021-05-22,16932,4360,1523271,846510,2021-05-22,1621638000.0
13203,76,1,2021-05-23,8986,740,1532257,847250,2021-05-23,1621724400.0
13204,76,1,2021-05-24,14314,2336,1546571,849586,2021-05-24,1621810800.0
13205,76,1,2021-05-25,28218,12491,1574789,862077,2021-05-25,1621897200.0
13206,76,1,2021-05-26,30643,10341,1605432,872418,2021-05-26,1621983600.0
13207,76,1,2021-05-27,32322,10959,1637754,883377,2021-05-27,1622070000.0
13208,76,1,2021-05-28,28359,12286,1666113,895663,2021-05-28,1622156400.0
13209,76,1,2021-05-29,17970,9127,1684083,904790,2021-05-29,1622242800.0
13210,76,1,2021-05-30,5998,4715,1690081,909505,2021-05-30,1622329200.0
13211,76,1,2021-05-31,23151,14794,1713232,924299,2021-05-31,1622415600.0
13212,76,1,2021-06-01,25689,17352,1738921,941651,2021-06-01,1622502000.0
13213,76,1,2021-06-02,25591,15903,1764512,957554,2021-06-02,1622588400.0
13214,76,1,2021-06-03,26696,16464,1791208,974018,2021-06-03,1622674800.0
13215,76,1,2021-06-04,25620,17283,1816828,991301,2021-06-04,1622761200.0
13216,76,1,2021-06-05,22814,12063,1839642,1003364,2021-06-05,1622847600.0
13217,76,1,2021-06-06,13826,4302,1853468,1007666,2021-06-06,1622934000.0
13218,76,1,2021-06-07,21964,19758,1875432,1027424,2021-06-07,1623020400.0
13219,76,1,2021-06-08,26728,21491,1902160,1048915,2021-06-08,1623106800.0
13220,76,1,2021-06-09,27479,20504,1929639,1069419,2021-06-09,1623193200.0
13221,76,1,2021-06-10,25827,17512,1955466,1086931,2021-06-10,1623279600.0
13222,76,1,2021-06-11,26398,21368,1981864,1108299,2021-06-11,1623366000.0
13223,76,1,2021-06-12,20959,15776,2002823,1124075,2021-06-12,1623452400.0
13224,76,1,2021-06-13,11781,5394,2014604,1129469,2021-06-13,1623538800.0
13225,76,1,2021-06-14,18372,25764,2032976,1155233,2021-06-14,1623625200.0
13226,76,1,2021-06-15,23355,25598,2056331,1180831,2021-06-15,1623711600.0
13227,76,1,2021-06-16,22961,23880,2079292,1204711,2021-06-16,1623798000.0
13228,76,1,2021-06-17,21661,17611,2100953,1222322,2021-06-17,1623884400.0
13229,76,1,2021-06-18,21341,21876,2122294,1244198,2021-06-18,1623970800.0
13230,76,1,2021-06-19,18828,13939,2141122,1258137,2021-06-19,1624057200.0
13231,76,1,2021-06-20,8747,6659,2149869,1264796,2021-06-20,1624143600.0
13232,76,1,2021-06-21,13016,22804,2162885,1287600,2021-06-21,1624230000.0
13233,76,1,2021-06-22,14828,24061,2177713,1311661,2021-06-22,1624316400.0
13234,76,1,2021-06-23,15772,24222,2193485,1335883,2021-06-23,1624402800.0
13235,76,1,2021-06-24,13552,18609,2207037,1354492,2021-06-24,1624489200.0
13236,76,1,2021-06-25,13920,27063,2220957,1381555,2021-06-25,1624575600.0
13237,76,1,2021-06-26,10820,18163,2231777,1399718,2021-06-26,1624662000.0
13238,76,1,2021-06-27,5570,9009,2237347,1408727,2021-06-27,1624748400.0
13239,76,1,2021-06-28,10897,25676,2248244,1434403,2021-06-28,1624834800.0
13240,76,1,2021-06-29,12200,29034,2260444,1463437,2021-06-29,1624921200.0
13241,76,1,2021-06-30,14646,30426,2275090,1493863,2021-06-30,1625007600.0
13242,76,1,2021-07-01,13396,24200,2288486,1518063,2021-07-01,1625094000.0
13243,76,1,2021-07-02,14658,27496,2303144,1545559,2021-07-02,1625180400.0
13244,76,1,2021-07-03,10742,19943,2313886,1565502,2021-07-03,1625266800.0
13245,76,1,2021-07-04,5308,9347,2319194,1574849,2021-07-04,1625353200.0
13246,76,1,2021-07-05,12386,26674,2331580,1601523,2021-07-05,1625439600.0
13247,76,1,2021-07-06,14470,31956,2346050,1633479,2021-07-06,1625526000.0
13248,76,2,2020-12-27,0,0,0,0,2020-12-27,1609023600.0
13249,76,2,2020-12-28,0,0,0,0,2020-12-28,1609110000.0
13250,76,2,2020-12-29,0,0,0,0,2020-12-29,1609196400.0
13251,76,2,2020-12-30,0,0,0,0,2020-12-30,1609282800.0
13252,76,2,2020-12-31,0,0,0,0,2020-12-31,1609369200.0
13253,76,2,2021-01-01,0,0,0,0,2021-01-01,1609455600.0
13254,76,2,2021-01-02,0,0,0,0,2021-01-02,1609542000.0
13255,76,2,2021-01-03,0,0,0,0,2021-01-03,1609628400.0
13256,76,2,2021-01-04,0,0,0,0,2021-01-04,1609714800.0
13257,76,2,2021-01-05,0,0,0,0,2021-01-05,1609801200.0
13258,76,2,2021-01-06,0,0,0,0,2021-01-06,1609887600.0
13259,76,2,2021-01-07,0,0,0,0,2021-01-07,1609974000.0
13260,76,2,2021-01-08,0,0,0,0,2021-01-08,1610060400.0
13261,76,2,2021-01-09,0,0,0,0,2021-01-09,1610146800.0
13262,76,2,2021-01-10,0,0,0,0,2021-01-10,1610233200.0
13263,76,2,2021-01-11,0,0,0,0,2021-01-11,1610319600.0
13264,76,2,2021-01-12,0,0,0,0,2021-01-12,1610406000.0
13265,76,2,2021-01-13,0,0,0,0,2021-01-13,1610492400.0
13266,76,2,2021-01-14,1,0,1,0,2021-01-14,1610578800.0
13267,76,2,2021-01-15,2,0,3,0,2021-01-15,1610665200.0
13268,76,2,2021-01-16,1,0,4,0,2021-01-16,1610751600.0
13269,76,2,2021-01-17,0,0,4,0,2021-01-17,1610838000.0
13270,76,2,2021-01-18,2,0,6,0,2021-01-18,1610924400.0
13271,76,2,2021-01-19,4,0,10,0,2021-01-19,1611010800.0
13272,76,2,2021-01-20,2,0,12,0,2021-01-20,1611097200.0
13273,76,2,2021-01-21,3,0,15,0,2021-01-21,1611183600.0
13274,76,2,2021-01-22,4,0,19,0,2021-01-22,1611270000.0
13275,76,2,2021-01-23,1,0,20,0,2021-01-23,1611356400.0
13276,76,2,2021-01-24,0,0,20,0,2021-01-24,1611442800.0
13277,76,2,2021-01-25,2,0,22,0,2021-01-25,1611529200.0
13278,76,2,2021-01-26,0,0,22,0,2021-01-26,1611615600.0
13279,76,2,2021-01-27,0,0,22,0,2021-01-27,1611702000.0
13280,76,2,2021-01-28,1,0,23,0,2021-01-28,1611788400.0
13281,76,2,2021-01-29,0,0,23,0,2021-01-29,1611874800.0
13282,76,2,2021-01-30,1,0,24,0,2021-01-30,1611961200.0
13283,76,2,2021-01-31,0,0,24,0,2021-01-31,1612047600.0
13284,76,2,2021-02-01,0,0,24,0,2021-02-01,1612134000.0
13285,76,2,2021-02-02,0,0,24,0,2021-02-02,1612220400.0
13286,76,2,2021-02-03,3,0,27,0,2021-02-03,1612306800.0
13287,76,2,2021-02-04,0,0,27,0,2021-02-04,1612393200.0
13288,76,2,2021-02-05,0,1,27,1,2021-02-05,1612479600.0
13289,76,2,2021-02-06,0,0,27,1,2021-02-06,1612566000.0
13290,76,2,2021-02-07,0,0,27,1,2021-02-07,1612652400.0
13291,76,2,2021-02-08,78,3,105,4,2021-02-08,1612738800.0
13292,76,2,2021-02-09,130,1,235,5,2021-02-09,1612825200.0
13293,76,2,2021-02-10,303,3,538,8,2021-02-10,1612911600.0
13294,76,2,2021-02-11,621,1,1159,9,2021-02-11,1612998000.0
13295,76,2,2021-02-12,698,1,1857,10,2021-02-12,1613084400.0
13296,76,2,2021-02-13,362,0,2219,10,2021-02-13,1613170800.0
13297,76,2,2021-02-14,0,0,2219,10,2021-02-14,1613257200.0
13298,76,2,2021-02-15,437,1,2656,11,2021-02-15,1613343600.0
13299,76,2,2021-02-16,584,2,3240,13,2021-02-16,1613430000.0
13300,76,2,2021-02-17,573,2,3813,15,2021-02-17,1613516400.0
13301,76,2,2021-02-18,778,2,4591,17,2021-02-18,1613602800.0
13302,76,2,2021-02-19,648,3,5239,20,2021-02-19,1613689200.0
13303,76,2,2021-02-20,385,1,5624,21,2021-02-20,1613775600.0
13304,76,2,2021-02-21,0,0,5624,21,2021-02-21,1613862000.0
13305,76,2,2021-02-22,308,1,5932,22,2021-02-22,1613948400.0
13306,76,2,2021-02-23,469,1,6401,23,2021-02-23,1614034800.0
13307,76,2,2021-02-24,308,2,6709,25,2021-02-24,1614121200.0
13308,76,2,2021-02-25,590,2,7299,27,2021-02-25,1614207600.0
13309,76,2,2021-02-26,248,1,7547,28,2021-02-26,1614294000.0
13310,76,2,2021-02-27,135,2,7682,30,2021-02-27,1614380400.0
13311,76,2,2021-02-28,1,0,7683,30,2021-02-28,1614466800.0
13312,76,2,2021-03-01,457,2,8140,32,2021-03-01,1614553200.0
13313,76,2,2021-03-02,549,0,8689,32,2021-03-02,1614639600.0
13314,76,2,2021-03-03,526,0,9215,32,2021-03-03,1614726000.0
13315,76,2,2021-03-04,913,5,10128,37,2021-03-04,1614812400.0
13316,76,2,2021-03-05,541,4,10669,41,2021-03-05,1614898800.0
13317,76,2,2021-03-06,648,3,11317,44,2021-03-06,1614985200.0
13318,76,2,2021-03-07,1,0,11318,44,2021-03-07,1615071600.0
13319,76,2,2021-03-08,486,99,11804,143,2021-03-08,1615158000.0
13320,76,2,2021-03-09,457,254,12261,397,2021-03-09,1615244400.0
13321,76,2,2021-03-10,716,410,12977,807,2021-03-10,1615330800.0
13322,76,2,2021-03-11,1196,554,14173,1361,2021-03-11,1615417200.0
13323,76,2,2021-03-12,802,581,14975,1942,2021-03-12,1615503600.0
13324,76,2,2021-03-13,772,311,15747,2253,2021-03-13,1615590000.0
13325,76,2,2021-03-14,2,48,15749,2301,2021-03-14,1615676400.0
13326,76,2,2021-03-15,529,464,16278,2765,2021-03-15,1615762800.0
13327,76,2,2021-03-16,695,622,16973,3387,2021-03-16,1615849200.0
13328,76,2,2021-03-17,735,606,17708,3993,2021-03-17,1615935600.0
13329,76,2,2021-03-18,789,674,18497,4667,2021-03-18,1616022000.0
13330,76,2,2021-03-19,938,493,19435,5160,2021-03-19,1616108400.0
13331,76,2,2021-03-20,1464,343,20899,5503,2021-03-20,1616194800.0
13332,76,2,2021-03-21,1736,1,22635,5504,2021-03-21,1616281200.0
13333,76,2,2021-03-22,793,305,23428,5809,2021-03-22,1616367600.0
13334,76,2,2021-03-23,1165,516,24593,6325,2021-03-23,1616454000.0
13335,76,2,2021-03-24,1744,295,26337,6620,2021-03-24,1616540400.0
13336,76,2,2021-03-25,1736,534,28073,7154,2021-03-25,1616626800.0
13337,76,2,2021-03-26,2035,239,30108,7393,2021-03-26,1616713200.0
13338,76,2,2021-03-27,1815,129,31923,7522,2021-03-27,1616799600.0
13339,76,2,2021-03-28,1092,0,33015,7522,2021-03-28,1616886000.0
13340,76,2,2021-03-29,2210,536,35225,8058,2021-03-29,1616972400.0
13341,76,2,2021-03-30,1949,469,37174,8527,2021-03-30,1617058800.0
13342,76,2,2021-03-31,2551,484,39725,9011,2021-03-31,1617145200.0
13343,76,2,2021-04-01,4298,864,44023,9875,2021-04-01,1617231600.0
13344,76,2,2021-04-02,2458,602,46481,10477,2021-04-02,1617318000.0
13345,76,2,2021-04-03,2092,586,48573,11063,2021-04-03,1617404400.0
13346,76,2,2021-04-04,958,3,49531,11066,2021-04-04,1617490800.0
13347,76,2,2021-04-05,894,239,50425,11305,2021-04-05,1617577200.0
13348,76,2,2021-04-06,1564,443,51989,11748,2021-04-06,1617663600.0
13349,76,2,2021-04-07,2304,663,54293,12411,2021-04-07,1617750000.0
13350,76,2,2021-04-08,3378,1051,57671,13462,2021-04-08,1617836400.0
13351,76,2,2021-04-09,3235,891,60906,14353,2021-04-09,1617922800.0
13352,76,2,2021-04-10,3044,744,63950,15097,2021-04-10,1618009200.0
13353,76,2,2021-04-11,758,3,64708,15100,2021-04-11,1618095600.0
13354,76,2,2021-04-12,1770,450,66478,15550,2021-04-12,1618185600.0
13355,76,2,2021-04-13,1871,617,68349,16167,2021-04-13,1618272000.0
13356,76,2,2021-04-14,1837,639,70186,16806,2021-04-14,1618358400.0
13357,76,2,2021-04-15,2284,772,72470,17578,2021-04-15,1618444800.0
13358,76,2,2021-04-16,1625,937,74095,18515,2021-04-16,1618531200.0
13359,76,2,2021-04-17,1397,1375,75492,19890,2021-04-17,1618617600.0
13360,76,2,2021-04-18,136,1583,75628,21473,2021-04-18,1618704000.0
13361,76,2,2021-04-19,1236,699,76864,22172,2021-04-19,1618790400.0
13362,76,2,2021-04-20,1376,1014,78240,23186,2021-04-20,1618876800.0
13363,76,2,2021-04-21,1886,1525,80126,24711,2021-04-21,1618963200.0
13364,76,2,2021-04-22,2587,1725,82713,26436,2021-04-22,1619049600.0
13365,76,2,2021-04-23,2299,1824,85012,28260,2021-04-23,1619136000.0
13366,76,2,2021-04-24,2553,1493,87565,29753,2021-04-24,1619222400.0
13367,76,2,2021-04-25,497,917,88062,30670,2021-04-25,1619308800.0
13368,76,2,2021-04-26,1273,1957,89335,32627,2021-04-26,1619395200.0
13369,76,2,2021-04-27,1242,1874,90577,34501,2021-04-27,1619481600.0
13370,76,2,2021-04-28,1096,2355,91673,36856,2021-04-28,1619568000.0
13371,76,2,2021-04-29,1571,4093,93244,40949,2021-04-29,1619654400.0
13372,76,2,2021-04-30,1756,1988,95000,42937,2021-04-30,1619740800.0
13373,76,2,2021-05-01,1209,1467,96209,44404,2021-05-01,1619827200.0
13374,76,2,2021-05-02,571,1019,96780,45423,2021-05-02,1619913600.0
13375,76,2,2021-05-03,1543,1695,98323,47118,2021-05-03,1620000000.0
13376,76,2,2021-05-04,1358,1716,99681,48834,2021-05-04,1620086400.0
13377,76,2,2021-05-05,1955,2182,101636,51016,2021-05-05,1620172800.0
13378,76,2,2021-05-06,2782,3729,104418,54745,2021-05-06,1620259200.0
13379,76,2,2021-05-07,4334,3291,108752,58036,2021-05-07,1620345600.0
13380,76,2,2021-05-08,3628,1705,112380,59741,2021-05-08,1620432000.0
13381,76,2,2021-05-09,3545,799,115925,60540,2021-05-09,1620518400.0
13382,76,2,2021-05-10,4739,1948,120664,62488,2021-05-10,1620604800.0
13383,76,2,2021-05-11,6670,1982,127334,64470,2021-05-11,1620691200.0
13384,76,2,2021-05-12,6724,2122,134058,66592,2021-05-12,1620777600.0
13385,76,2,2021-05-13,6423,386,140481,66978,2021-05-13,1620864000.0
13386,76,2,2021-05-14,6372,1080,146853,68058,2021-05-14,1620950400.0
13387,76,2,2021-05-15,7370,1163,154223,69221,2021-05-15,1621036800.0
13388,76,2,2021-05-16,6207,202,160430,69423,2021-05-16,1621123200.0
13389,76,2,2021-05-17,5826,1312,166256,70735,2021-05-17,1621206000.0
13390,76,2,2021-05-18,6211,1458,172467,72193,2021-05-18,1621292400.0
13391,76,2,2021-05-19,6293,1107,178760,73300,2021-05-19,1621378800.0
13392,76,2,2021-05-20,7467,1215,186227,74515,2021-05-20,1621465200.0
13393,76,2,2021-05-21,6279,831,192506,75346,2021-05-21,1621551600.0
13394,76,2,2021-05-22,9451,786,201957,76132,2021-05-22,1621638000.0
13395,76,2,2021-05-23,4261,115,206218,76247,2021-05-23,1621724400.0
13396,76,2,2021-05-24,985,17,207203,76264,2021-05-24,1621810800.0
13397,76,2,2021-05-25,2291,959,209494,77223,2021-05-25,1621897200.0
13398,76,2,2021-05-26,1717,742,211211,77965,2021-05-26,1621983600.0
13399,76,2,2021-05-27,2345,1685,213556,79650,2021-05-27,1622070000.0
13400,76,2,2021-05-28,1156,1643,214712,81293,2021-05-28,1622156400.0
13401,76,2,2021-05-29,687,881,215399,82174,2021-05-29,1622242800.0
13402,76,2,2021-05-30,157,149,215556,82323,2021-05-30,1622329200.0
13403,76,2,2021-05-31,1109,1370,216665,83693,2021-05-31,1622415600.0
13404,76,2,2021-06-01,2860,1659,219525,85352,2021-06-01,1622502000.0
13405,76,2,2021-06-02,3437,2362,222962,87714,2021-06-02,1622588400.0
13406,76,2,2021-06-03,4946,2764,227908,90478,2021-06-03,1622674800.0
13407,76,2,2021-06-04,6848,2395,234756,92873,2021-06-04,1622761200.0
13408,76,2,2021-06-05,2426,1608,237182,94481,2021-06-05,1622847600.0
13409,76,2,2021-06-06,175,596,237357,95077,2021-06-06,1622934000.0
13410,76,2,2021-06-07,2730,2166,240087,97243,2021-06-07,1623020400.0
13411,76,2,2021-06-08,3978,1527,244065,98770,2021-06-08,1623106800.0
13412,76,2,2021-06-09,3376,1144,247441,99914,2021-06-09,1623193200.0
13413,76,2,2021-06-10,4221,1610,251662,101524,2021-06-10,1623279600.0
13414,76,2,2021-06-11,5095,2072,256757,103596,2021-06-11,1623366000.0
13415,76,2,2021-06-12,1674,1432,258431,105028,2021-06-12,1623452400.0
13416,76,2,2021-06-13,150,600,258581,105628,2021-06-13,1623538800.0
13417,76,2,2021-06-14,2508,1317,261089,106945,2021-06-14,1623625200.0
13418,76,2,2021-06-15,4174,1871,265263,108816,2021-06-15,1623711600.0
13419,76,2,2021-06-16,3001,2539,268264,111355,2021-06-16,1623798000.0
13420,76,2,2021-06-17,3712,2554,271976,113909,2021-06-17,1623884400.0
13421,76,2,2021-06-18,4581,4343,276557,118252,2021-06-18,1623970800.0
13422,76,2,2021-06-19,1579,4627,278136,122879,2021-06-19,1624057200.0
13423,76,2,2021-06-20,101,2634,278237,125513,2021-06-20,1624143600.0
13424,76,2,2021-06-21,1484,6504,279721,132017,2021-06-21,1624230000.0
13425,76,2,2021-06-22,2531,6438,282252,138455,2021-06-22,1624316400.0
13426,76,2,2021-06-23,2346,5494,284598,143949,2021-06-23,1624402800.0
13427,76,2,2021-06-24,2788,6013,287386,149962,2021-06-24,1624489200.0
13428,76,2,2021-06-25,3182,6691,290568,156653,2021-06-25,1624575600.0
13429,76,2,2021-06-26,1063,6938,291631,163591,2021-06-26,1624662000.0
13430,76,2,2021-06-27,91,4709,291722,168300,2021-06-27,1624748400.0
13431,76,2,2021-06-28,1176,7515,292898,175815,2021-06-28,1624834800.0
13432,76,2,2021-06-29,1872,6523,294770,182338,2021-06-29,1624921200.0
13433,76,2,2021-06-30,1592,5846,296362,188184,2021-06-30,1625007600.0
13434,76,2,2021-07-01,1958,7330,298320,195514,2021-07-01,1625094000.0
13435,76,2,2021-07-02,2160,6135,300480,201649,2021-07-02,1625180400.0
13436,76,2,2021-07-03,761,9271,301241,210920,2021-07-03,1625266800.0
13437,76,2,2021-07-04,127,2328,301368,213248,2021-07-04,1625353200.0
13438,76,2,2021-07-05,797,2266,302165,215514,2021-07-05,1625439600.0
13439,76,2,2021-07-06,1368,4108,303533,219622,2021-07-06,1625526000.0
13440,76,3,2020-12-27,0,0,0,0,2020-12-27,1609023600.0
13441,76,3,2020-12-28,0,0,0,0,2020-12-28,1609110000.0
13442,76,3,2020-12-29,0,0,0,0,2020-12-29,1609196400.0
13443,76,3,2020-12-30,0,0,0,0,2020-12-30,1609282800.0
13444,76,3,2020-12-31,0,0,0,0,2020-12-31,1609369200.0
13445,76,3,2021-01-01,0,0,0,0,2021-01-01,1609455600.0
13446,76,3,2021-01-02,0,0,0,0,2021-01-02,1609542000.0
13447,76,3,2021-01-03,0,0,0,0,2021-01-03,1609628400.0
13448,76,3,2021-01-04,0,0,0,0,2021-01-04,1609714800.0
13449,76,3,2021-01-05,0,0,0,0,2021-01-05,1609801200.0
13450,76,3,2021-01-06,0,0,0,0,2021-01-06,1609887600.0
13451,76,3,2021-01-07,0,0,0,0,2021-01-07,1609974000.0
13452,76,3,2021-01-08,0,0,0,0,2021-01-08,1610060400.0
13453,76,3,2021-01-09,0,0,0,0,2021-01-09,1610146800.0
13454,76,3,2021-01-10,0,0,0,0,2021-01-10,1610233200.0
13455,76,3,2021-01-11,0,0,0,0,2021-01-11,1610319600.0
13456,76,3,2021-01-12,0,0,0,0,2021-01-12,1610406000.0
13457,76,3,2021-01-13,0,0,0,0,2021-01-13,1610492400.0
13458,76,3,2021-01-14,0,0,0,0,2021-01-14,1610578800.0
13459,76,3,2021-01-15,0,0,0,0,2021-01-15,1610665200.0
13460,76,3,2021-01-16,0,0,0,0,2021-01-16,1610751600.0
13461,76,3,2021-01-17,0,0,0,0,2021-01-17,1610838000.0
13462,76,3,2021-01-18,0,0,0,0,2021-01-18,1610924400.0
13463,76,3,2021-01-19,0,0,0,0,2021-01-19,1611010800.0
13464,76,3,2021-01-20,0,0,0,0,2021-01-20,1611097200.0
13465,76,3,2021-01-21,0,0,0,0,2021-01-21,1611183600.0
13466,76,3,2021-01-22,0,0,0,0,2021-01-22,1611270000.0
13467,76,3,2021-01-23,0,0,0,0,2021-01-23,1611356400.0
13468,76,3,2021-01-24,0,0,0,0,2021-01-24,1611442800.0
13469,76,3,2021-01-25,0,0,0,0,2021-01-25,1611529200.0
13470,76,3,2021-01-26,0,0,0,0,2021-01-26,1611615600.0
13471,76,3,2021-01-27,0,0,0,0,2021-01-27,1611702000.0
13472,76,3,2021-01-28,0,0,0,0,2021-01-28,1611788400.0
13473,76,3,2021-01-29,0,0,0,0,2021-01-29,1611874800.0
13474,76,3,2021-01-30,0,0,0,0,2021-01-30,1611961200.0
13475,76,3,2021-01-31,0,0,0,0,2021-01-31,1612047600.0
13476,76,3,2021-02-01,0,0,0,0,2021-02-01,1612134000.0
13477,76,3,2021-02-02,0,0,0,0,2021-02-02,1612220400.0
13478,76,3,2021-02-03,0,0,0,0,2021-02-03,1612306800.0
13479,76,3,2021-02-04,0,0,0,0,2021-02-04,1612393200.0
13480,76,3,2021-02-05,0,0,0,0,2021-02-05,1612479600.0
13481,76,3,2021-02-06,21,0,21,0,2021-02-06,1612566000.0
13482,76,3,2021-02-07,66,0,87,0,2021-02-07,1612652400.0
13483,76,3,2021-02-08,185,0,272,0,2021-02-08,1612738800.0
13484,76,3,2021-02-09,410,0,682,0,2021-02-09,1612825200.0
13485,76,3,2021-02-10,525,0,1207,0,2021-02-10,1612911600.0
13486,76,3,2021-02-11,680,0,1887,0,2021-02-11,1612998000.0
13487,76,3,2021-02-12,925,0,2812,0,2021-02-12,1613084400.0
13488,76,3,2021-02-13,68,0,2880,0,2021-02-13,1613170800.0
13489,76,3,2021-02-14,23,0,2903,0,2021-02-14,1613257200.0
13490,76,3,2021-02-15,656,0,3559,0,2021-02-15,1613343600.0
13491,76,3,2021-02-16,619,0,4178,0,2021-02-16,1613430000.0
13492,76,3,2021-02-17,671,0,4849,0,2021-02-17,1613516400.0
13493,76,3,2021-02-18,1067,0,5916,0,2021-02-18,1613602800.0
13494,76,3,2021-02-19,1016,0,6932,0,2021-02-19,1613689200.0
13495,76,3,2021-02-20,309,0,7241,0,2021-02-20,1613775600.0
13496,76,3,2021-02-21,64,0,7305,0,2021-02-21,1613862000.0
13497,76,3,2021-02-22,743,0,8048,0,2021-02-22,1613948400.0
13498,76,3,2021-02-23,844,0,8892,0,2021-02-23,1614034800.0
13499,76,3,2021-02-24,712,0,9604,0,2021-02-24,1614121200.0
13500,76,3,2021-02-25,2943,0,12547,0,2021-02-25,1614207600.0
13501,76,3,2021-02-26,4834,0,17381,0,2021-02-26,1614294000.0
13502,76,3,2021-02-27,2493,1,19874,1,2021-02-27,1614380400.0
13503,76,3,2021-02-28,308,0,20182,1,2021-02-28,1614466800.0
13504,76,3,2021-03-01,2266,2,22448,3,2021-03-01,1614553200.0
13505,76,3,2021-03-02,3893,2,26341,5,2021-03-02,1614639600.0
13506,76,3,2021-03-03,4365,1,30706,6,2021-03-03,1614726000.0
13507,76,3,2021-03-04,8099,3,38805,9,2021-03-04,1614812400.0
13508,76,3,2021-03-05,11000,4,49805,13,2021-03-05,1614898800.0
13509,76,3,2021-03-06,13188,14,62993,27,2021-03-06,1614985200.0
13510,76,3,2021-03-07,10898,10,73891,37,2021-03-07,1615071600.0
13511,76,3,2021-03-08,4913,3,78804,40,2021-03-08,1615158000.0
13512,76,3,2021-03-09,8364,2,87168,42,2021-03-09,1615244400.0
13513,76,3,2021-03-10,8215,6,95383,48,2021-03-10,1615330800.0
13514,76,3,2021-03-11,12878,6,108261,54,2021-03-11,1615417200.0
13515,76,3,2021-03-12,17019,5,125280,59,2021-03-12,1615503600.0
13516,76,3,2021-03-13,10260,7,135540,66,2021-03-13,1615590000.0
13517,76,3,2021-03-14,1032,2,136572,68,2021-03-14,1615676400.0
13518,76,3,2021-03-15,4407,6,140979,74,2021-03-15,1615762800.0
13519,76,3,2021-03-16,73,0,141052,74,2021-03-16,1615849200.0
13520,76,3,2021-03-17,64,0,141116,74,2021-03-17,1615935600.0
13521,76,3,2021-03-18,113,0,141229,74,2021-03-18,1616022000.0
13522,76,3,2021-03-19,5302,2,146531,76,2021-03-19,1616108400.0
13523,76,3,2021-03-20,3938,1,150469,77,2021-03-20,1616194800.0
13524,76,3,2021-03-21,326,0,150795,77,2021-03-21,1616281200.0
13525,76,3,2021-03-22,3156,3,153951,80,2021-03-22,1616367600.0
13526,76,3,2021-03-23,7705,1,161656,81,2021-03-23,1616454000.0
13527,76,3,2021-03-24,8646,19,170302,100,2021-03-24,1616540400.0
13528,76,3,2021-03-25,15133,13,185435,113,2021-03-25,1616626800.0
13529,76,3,2021-03-26,14993,14,200428,127,2021-03-26,1616713200.0
13530,76,3,2021-03-27,4742,4,205170,131,2021-03-27,1616799600.0
13531,76,3,2021-03-28,414,0,205584,131,2021-03-28,1616886000.0
13532,76,3,2021-03-29,5912,7,211496,138,2021-03-29,1616972400.0
13533,76,3,2021-03-30,9953,16,221449,154,2021-03-30,1617058800.0
13534,76,3,2021-03-31,6620,15,228069,169,2021-03-31,1617145200.0
13535,76,3,2021-04-01,8639,10,236708,179,2021-04-01,1617231600.0
13536,76,3,2021-04-02,8740,27,245448,206,2021-04-02,1617318000.0
13537,76,3,2021-04-03,2605,1,248053,207,2021-04-03,1617404400.0
13538,76,3,2021-04-04,81,0,248134,207,2021-04-04,1617490800.0
13539,76,3,2021-04-05,95,0,248229,207,2021-04-05,1617577200.0
13540,76,3,2021-04-06,3445,5,251674,212,2021-04-06,1617663600.0
13541,76,3,2021-04-07,2974,6,254648,218,2021-04-07,1617750000.0
13542,76,3,2021-04-08,6162,11,260810,229,2021-04-08,1617836400.0
13543,76,3,2021-04-09,14404,70,275214,299,2021-04-09,1617922800.0
13544,76,3,2021-04-10,4908,21,280122,320,2021-04-10,1618009200.0
13545,76,3,2021-04-11,656,3,280778,323,2021-04-11,1618095600.0
13546,76,3,2021-04-12,5535,11,286313,334,2021-04-12,1618185600.0
13547,76,3,2021-04-13,8931,21,295244,355,2021-04-13,1618272000.0
13548,76,3,2021-04-14,6820,38,302064,393,2021-04-14,1618358400.0
13549,76,3,2021-04-15,8893,49,310957,442,2021-04-15,1618444800.0
13550,76,3,2021-04-16,9791,71,320748,513,2021-04-16,1618531200.0
13551,76,3,2021-04-17,3383,28,324131,541,2021-04-17,1618617600.0
13552,76,3,2021-04-18,591,0,324722,541,2021-04-18,1618704000.0
13553,76,3,2021-04-19,2398,18,327120,559,2021-04-19,1618790400.0
13554,76,3,2021-04-20,4339,38,331459,597,2021-04-20,1618876800.0
13555,76,3,2021-04-21,3410,44,334869,641,2021-04-21,1618963200.0
13556,76,3,2021-04-22,4535,45,339404,686,2021-04-22,1619049600.0
13557,76,3,2021-04-23,5429,65,344833,751,2021-04-23,1619136000.0
13558,76,3,2021-04-24,1877,65,346710,816,2021-04-24,1619222400.0
13559,76,3,2021-04-25,370,1,347080,817,2021-04-25,1619308800.0
13560,76,3,2021-04-26,1525,47,348605,864,2021-04-26,1619395200.0
13561,76,3,2021-04-27,3012,113,351617,977,2021-04-27,1619481600.0
13562,76,3,2021-04-28,2291,137,353908,1114,2021-04-28,1619568000.0
13563,76,3,2021-04-29,3264,303,357172,1417,2021-04-29,1619654400.0
13564,76,3,2021-04-30,3523,623,360695,2040,2021-04-30,1619740800.0
13565,76,3,2021-05-01,564,162,361259,2202,2021-05-01,1619827200.0
13566,76,3,2021-05-02,144,7,361403,2209,2021-05-02,1619913600.0
13567,76,3,2021-05-03,1054,404,362457,2613,2021-05-03,1620000000.0
13568,76,3,2021-05-04,1817,867,364274,3480,2021-05-04,1620086400.0
13569,76,3,2021-05-05,1435,1113,365709,4593,2021-05-05,1620172800.0
13570,76,3,2021-05-06,2434,2014,368143,6607,2021-05-06,1620259200.0
13571,76,3,2021-05-07,3110,2664,371253,9271,2021-05-07,1620345600.0
13572,76,3,2021-05-08,233,724,371486,9995,2021-05-08,1620432000.0
13573,76,3,2021-05-09,143,263,371629,10258,2021-05-09,1620518400.0
13574,76,3,2021-05-10,1118,1454,372747,11712,2021-05-10,1620604800.0
13575,76,3,2021-05-11,1979,3342,374726,15054,2021-05-11,1620691200.0
13576,76,3,2021-05-12,1344,2463,376070,17517,2021-05-12,1620777600.0
13577,76,3,2021-05-13,143,222,376213,17739,2021-05-13,1620864000.0
13578,76,3,2021-05-14,1070,2087,377283,19826,2021-05-14,1620950400.0
13579,76,3,2021-05-15,268,1322,377551,21148,2021-05-15,1621036800.0
13580,76,3,2021-05-16,72,139,377623,21287,2021-05-16,1621123200.0
13581,76,3,2021-05-17,609,2274,378232,23561,2021-05-17,1621206000.0
13582,76,3,2021-05-18,1032,3175,379264,26736,2021-05-18,1621292400.0
13583,76,3,2021-05-19,640,2629,379904,29365,2021-05-19,1621378800.0
13584,76,3,2021-05-20,1027,5284,380931,34649,2021-05-20,1621465200.0
13585,76,3,2021-05-21,1043,6295,381974,40944,2021-05-21,1621551600.0
13586,76,3,2021-05-22,236,2373,382210,43317,2021-05-22,1621638000.0
13587,76,3,2021-05-23,32,248,382242,43565,2021-05-23,1621724400.0
13588,76,3,2021-05-24,51,887,382293,44452,2021-05-24,1621810800.0
13589,76,3,2021-05-25,402,4775,382695,49227,2021-05-25,1621897200.0
13590,76,3,2021-05-26,483,5605,383178,54832,2021-05-26,1621983600.0
13591,76,3,2021-05-27,524,8512,383702,63344,2021-05-27,1622070000.0
13592,76,3,2021-05-28,686,10323,384388,73667,2021-05-28,1622156400.0
13593,76,3,2021-05-29,177,4945,384565,78612,2021-05-29,1622242800.0
13594,76,3,2021-05-30,27,1010,384592,79622,2021-05-30,1622329200.0
13595,76,3,2021-05-31,158,3975,384750,83597,2021-05-31,1622415600.0
13596,76,3,2021-06-01,342,6799,385092,90396,2021-06-01,1622502000.0
13597,76,3,2021-06-02,227,5974,385319,96370,2021-06-02,1622588400.0
13598,76,3,2021-06-03,329,9553,385648,105923,2021-06-03,1622674800.0
13599,76,3,2021-06-04,361,10338,386009,116261,2021-06-04,1622761200.0
13600,76,3,2021-06-05,108,3932,386117,120193,2021-06-05,1622847600.0
13601,76,3,2021-06-06,15,620,386132,120813,2021-06-06,1622934000.0
13602,76,3,2021-06-07,96,3163,386228,123976,2021-06-07,1623020400.0
13603,76,3,2021-06-08,188,4925,386416,128901,2021-06-08,1623106800.0
13604,76,3,2021-06-09,136,4095,386552,132996,2021-06-09,1623193200.0
13605,76,3,2021-06-10,148,6393,386700,139389,2021-06-10,1623279600.0
13606,76,3,2021-06-11,192,8562,386892,147951,2021-06-11,1623366000.0
13607,76,3,2021-06-12,58,2611,386950,150562,2021-06-12,1623452400.0
13608,76,3,2021-06-13,21,283,386971,150845,2021-06-13,1623538800.0
13609,76,3,2021-06-14,52,4219,387023,155064,2021-06-14,1623625200.0
13610,76,3,2021-06-15,105,8963,387128,164027,2021-06-15,1623711600.0
13611,76,3,2021-06-16,87,6987,387215,171014,2021-06-16,1623798000.0
13612,76,3,2021-06-17,144,10677,387359,181691,2021-06-17,1623884400.0
13613,76,3,2021-06-18,145,11377,387504,193068,2021-06-18,1623970800.0
13614,76,3,2021-06-19,38,2780,387542,195848,2021-06-19,1624057200.0
13615,76,3,2021-06-20,11,325,387553,196173,2021-06-20,1624143600.0
13616,76,3,2021-06-21,48,4025,387601,200198,2021-06-21,1624230000.0
13617,76,3,2021-06-22,75,7575,387676,207773,2021-06-22,1624316400.0
13618,76,3,2021-06-23,77,5618,387753,213391,2021-06-23,1624402800.0
13619,76,3,2021-06-24,126,7896,387879,221287,2021-06-24,1624489200.0
13620,76,3,2021-06-25,107,8051,387986,229338,2021-06-25,1624575600.0
13621,76,3,2021-06-26,22,2218,388008,231556,2021-06-26,1624662000.0
13622,76,3,2021-06-27,7,272,388015,231828,2021-06-27,1624748400.0
13623,76,3,2021-06-28,33,3088,388048,234916,2021-06-28,1624834800.0
13624,76,3,2021-06-29,78,5830,388126,240746,2021-06-29,1624921200.0
13625,76,3,2021-06-30,91,4488,388217,245234,2021-06-30,1625007600.0
13626,76,3,2021-07-01,84,5918,388301,251152,2021-07-01,1625094000.0
13627,76,3,2021-07-02,94,7515,388395,258667,2021-07-02,1625180400.0
13628,76,3,2021-07-03,33,1668,388428,260335,2021-07-03,1625266800.0
13629,76,3,2021-07-04,6,482,388434,260817,2021-07-04,1625353200.0
13630,76,3,2021-07-05,42,2944,388476,263761,2021-07-05,1625439600.0
13631,76,3,2021-07-06,67,4741,388543,268502,2021-07-06,1625526000.0
13632,76,4,2020-12-27,0,0,0,0,2020-12-27,1609023600.0
13633,76,4,2020-12-28,0,0,0,0,2020-12-28,1609110000.0
13634,76,4,2020-12-29,0,0,0,0,2020-12-29,1609196400.0
13635,76,4,2020-12-30,0,0,0,0,2020-12-30,1609282800.0
13636,76,4,2020-12-31,0,0,0,0,2020-12-31,1609369200.0
13637,76,4,2021-01-01,0,0,0,0,2021-01-01,1609455600.0
13638,76,4,2021-01-02,0,0,0,0,2021-01-02,1609542000.0
13639,76,4,2021-01-03,0,0,0,0,2021-01-03,1609628400.0
13640,76,4,2021-01-04,0,0,0,0,2021-01-04,1609714800.0
13641,76,4,2021-01-05,0,0,0,0,2021-01-05,1609801200.0
13642,76,4,2021-01-06,0,0,0,0,2021-01-06,1609887600.0
13643,76,4,2021-01-07,0,0,0,0,2021-01-07,1609974000.0
13644,76,4,2021-01-08,0,0,0,0,2021-01-08,1610060400.0
13645,76,4,2021-01-09,0,0,0,0,2021-01-09,1610146800.0
13646,76,4,2021-01-10,0,0,0,0,2021-01-10,1610233200.0
13647,76,4,2021-01-11,0,0,0,0,2021-01-11,1610319600.0
13648,76,4,2021-01-12,0,0,0,0,2021-01-12,1610406000.0
13649,76,4,2021-01-13,0,0,0,0,2021-01-13,1610492400.0
13650,76,4,2021-01-14,0,0,0,0,2021-01-14,1610578800.0
13651,76,4,2021-01-15,0,0,0,0,2021-01-15,1610665200.0
13652,76,4,2021-01-16,0,0,0,0,2021-01-16,1610751600.0
13653,76,4,2021-01-17,0,0,0,0,2021-01-17,1610838000.0
13654,76,4,2021-01-18,0,0,0,0,2021-01-18,1610924400.0
13655,76,4,2021-01-19,0,0,0,0,2021-01-19,1611010800.0
13656,76,4,2021-01-20,0,0,0,0,2021-01-20,1611097200.0
13657,76,4,2021-01-21,0,0,0,0,2021-01-21,1611183600.0
13658,76,4,2021-01-22,0,0,0,0,2021-01-22,1611270000.0
13659,76,4,2021-01-23,0,0,0,0,2021-01-23,1611356400.0
13660,76,4,2021-01-24,0,0,0,0,2021-01-24,1611442800.0
13661,76,4,2021-01-25,0,0,0,0,2021-01-25,1611529200.0
13662,76,4,2021-01-26,0,0,0,0,2021-01-26,1611615600.0
13663,76,4,2021-01-27,0,0,0,0,2021-01-27,1611702000.0
13664,76,4,2021-01-28,0,0,0,0,2021-01-28,1611788400.0
13665,76,4,2021-01-29,0,0,0,0,2021-01-29,1611874800.0
13666,76,4,2021-01-30,0,0,0,0,2021-01-30,1611961200.0
13667,76,4,2021-01-31,0,0,0,0,2021-01-31,1612047600.0
13668,76,4,2021-02-01,0,0,0,0,2021-02-01,1612134000.0
13669,76,4,2021-02-02,0,0,0,0,2021-02-02,1612220400.0
13670,76,4,2021-02-03,0,0,0,0,2021-02-03,1612306800.0
13671,76,4,2021-02-04,0,0,0,0,2021-02-04,1612393200.0
13672,76,4,2021-02-05,0,0,0,0,2021-02-05,1612479600.0
13673,76,4,2021-02-06,0,0,0,0,2021-02-06,1612566000.0
13674,76,4,2021-02-07,0,0,0,0,2021-02-07,1612652400.0
13675,76,4,2021-02-08,0,0,0,0,2021-02-08,1612738800.0
13676,76,4,2021-02-09,0,0,0,0,2021-02-09,1612825200.0
13677,76,4,2021-02-10,0,0,0,0,2021-02-10,1612911600.0
13678,76,4,2021-02-11,0,0,0,0,2021-02-11,1612998000.0
13679,76,4,2021-02-12,0,0,0,0,2021-02-12,1613084400.0
13680,76,4,2021-02-13,0,0,0,0,2021-02-13,1613170800.0
13681,76,4,2021-02-14,0,0,0,0,2021-02-14,1613257200.0
13682,76,4,2021-02-15,0,0,0,0,2021-02-15,1613343600.0
13683,76,4,2021-02-16,0,0,0,0,2021-02-16,1613430000.0
13684,76,4,2021-02-17,0,0,0,0,2021-02-17,1613516400.0
13685,76,4,2021-02-18,0,0,0,0,2021-02-18,1613602800.0
13686,76,4,2021-02-19,0,0,0,0,2021-02-19,1613689200.0
13687,76,4,2021-02-20,0,0,0,0,2021-02-20,1613775600.0
13688,76,4,2021-02-21,0,0,0,0,2021-02-21,1613862000.0
13689,76,4,2021-02-22,0,0,0,0,2021-02-22,1613948400.0
13690,76,4,2021-02-23,0,0,0,0,2021-02-23,1614034800.0
13691,76,4,2021-02-24,0,0,0,0,2021-02-24,1614121200.0
13692,76,4,2021-02-25,0,0,0,0,2021-02-25,1614207600.0
13693,76,4,2021-02-26,0,0,0,0,2021-02-26,1614294000.0
13694,76,4,2021-02-27,0,0,0,0,2021-02-27,1614380400.0
13695,76,4,2021-02-28,0,0,0,0,2021-02-28,1614466800.0
13696,76,4,2021-03-01,0,0,0,0,2021-03-01,1614553200.0
13697,76,4,2021-03-02,0,0,0,0,2021-03-02,1614639600.0
13698,76,4,2021-03-03,0,0,0,0,2021-03-03,1614726000.0
13699,76,4,2021-03-04,0,0,0,0,2021-03-04,1614812400.0
13700,76,4,2021-03-05,0,0,0,0,2021-03-05,1614898800.0
13701,76,4,2021-03-06,0,0,0,0,2021-03-06,1614985200.0
13702,76,4,2021-03-07,0,0,0,0,2021-03-07,1615071600.0
13703,76,4,2021-03-08,0,0,0,0,2021-03-08,1615158000.0
13704,76,4,2021-03-09,0,0,0,0,2021-03-09,1615244400.0
13705,76,4,2021-03-10,0,0,0,0,2021-03-10,1615330800.0
13706,76,4,2021-03-11,0,0,0,0,2021-03-11,1615417200.0
13707,76,4,2021-03-12,0,0,0,0,2021-03-12,1615503600.0
13708,76,4,2021-03-13,0,0,0,0,2021-03-13,1615590000.0
13709,76,4,2021-03-14,0,0,0,0,2021-03-14,1615676400.0
13710,76,4,2021-03-15,0,0,0,0,2021-03-15,1615762800.0
13711,76,4,2021-03-16,0,0,0,0,2021-03-16,1615849200.0
13712,76,4,2021-03-17,0,0,0,0,2021-03-17,1615935600.0
13713,76,4,2021-03-18,0,0,0,0,2021-03-18,1616022000.0
13714,76,4,2021-03-19,0,0,0,0,2021-03-19,1616108400.0
13715,76,4,2021-03-20,0,0,0,0,2021-03-20,1616194800.0
13716,76,4,2021-03-21,0,0,0,0,2021-03-21,1616281200.0
13717,76,4,2021-03-22,0,0,0,0,2021-03-22,1616367600.0
13718,76,4,2021-03-23,0,0,0,0,2021-03-23,1616454000.0
13719,76,4,2021-03-24,0,0,0,0,2021-03-24,1616540400.0
13720,76,4,2021-03-25,0,0,0,0,2021-03-25,1616626800.0
13721,76,4,2021-03-26,0,0,0,0,2021-03-26,1616713200.0
13722,76,4,2021-03-27,0,0,0,0,2021-03-27,1616799600.0
13723,76,4,2021-03-28,0,0,0,0,2021-03-28,1616886000.0
13724,76,4,2021-03-29,0,0,0,0,2021-03-29,1616972400.0
13725,76,4,2021-03-30,0,0,0,0,2021-03-30,1617058800.0
13726,76,4,2021-03-31,0,0,0,0,2021-03-31,1617145200.0
13727,76,4,2021-04-01,0,0,0,0,2021-04-01,1617231600.0
13728,76,4,2021-04-02,0,0,0,0,2021-04-02,1617318000.0
13729,76,4,2021-04-03,0,0,0,0,2021-04-03,1617404400.0
13730,76,4,2021-04-04,0,0,0,0,2021-04-04,1617490800.0
13731,76,4,2021-04-05,0,0,0,0,2021-04-05,1617577200.0
13732,76,4,2021-04-06,0,0,0,0,2021-04-06,1617663600.0
13733,76,4,2021-04-07,0,0,0,0,2021-04-07,1617750000.0
13734,76,4,2021-04-08,0,0,0,0,2021-04-08,1617836400.0
13735,76,4,2021-04-09,0,0,0,0,2021-04-09,1617922800.0
13736,76,4,2021-04-10,0,0,0,0,2021-04-10,1618009200.0
13737,76,4,2021-04-11,0,0,0,0,2021-04-11,1618095600.0
13738,76,4,2021-04-12,0,0,0,0,2021-04-12,1618185600.0
13739,76,4,2021-04-13,0,0,0,0,2021-04-13,1618272000.0
13740,76,4,2021-04-14,0,0,0,0,2021-04-14,1618358400.0
13741,76,4,2021-04-15,0,0,0,0,2021-04-15,1618444800.0
13742,76,4,2021-04-16,0,0,0,0,2021-04-16,1618531200.0
13743,76,4,2021-04-17,0,0,0,0,2021-04-17,1618617600.0
13744,76,4,2021-04-18,0,0,0,0,2021-04-18,1618704000.0
13745,76,4,2021-04-19,0,0,0,0,2021-04-19,1618790400.0
13746,76,4,2021-04-20,0,0,0,0,2021-04-20,1618876800.0
13747,76,4,2021-04-21,0,0,0,0,2021-04-21,1618963200.0
13748,76,4,2021-04-22,0,0,0,0,2021-04-22,1619049600.0
13749,76,4,2021-04-23,130,0,130,0,2021-04-23,1619136000.0
13750,76,4,2021-04-24,32,0,162,0,2021-04-24,1619222400.0
13751,76,4,2021-04-25,11,0,173,0,2021-04-25,1619308800.0
13752,76,4,2021-04-26,128,0,301,0,2021-04-26,1619395200.0
13753,76,4,2021-04-27,783,0,1084,0,2021-04-27,1619481600.0
13754,76,4,2021-04-28,933,0,2017,0,2021-04-28,1619568000.0
13755,76,4,2021-04-29,1540,0,3557,0,2021-04-29,1619654400.0
13756,76,4,2021-04-30,1758,0,5315,0,2021-04-30,1619740800.0
13757,76,4,2021-05-01,171,0,5486,0,2021-05-01,1619827200.0
13758,76,4,2021-05-02,51,0,5537,0,2021-05-02,1619913600.0
13759,76,4,2021-05-03,533,0,6070,0,2021-05-03,1620000000.0
13760,76,4,2021-05-04,964,1,7034,1,2021-05-04,1620086400.0
13761,76,4,2021-05-05,671,0,7705,1,2021-05-05,1620172800.0
13762,76,4,2021-05-06,1046,0,8751,1,2021-05-06,1620259200.0
13763,76,4,2021-05-07,1738,4,10489,5,2021-05-07,1620345600.0
13764,76,4,2021-05-08,173,0,10662,5,2021-05-08,1620432000.0
13765,76,4,2021-05-09,68,0,10730,5,2021-05-09,1620518400.0
13766,76,4,2021-05-10,587,2,11317,7,2021-05-10,1620604800.0
13767,76,4,2021-05-11,1646,1,12963,8,2021-05-11,1620691200.0
13768,76,4,2021-05-12,1001,3,13964,11,2021-05-12,1620777600.0
13769,76,4,2021-05-13,54,0,14018,11,2021-05-13,1620864000.0
13770,76,4,2021-05-14,618,0,14636,11,2021-05-14,1620950400.0
13771,76,4,2021-05-15,165,1,14801,12,2021-05-15,1621036800.0
13772,76,4,2021-05-16,25,0,14826,12,2021-05-16,1621123200.0
13773,76,4,2021-05-17,488,1,15314,13,2021-05-17,1621206000.0
13774,76,4,2021-05-18,974,2,16288,15,2021-05-18,1621292400.0
13775,76,4,2021-05-19,523,0,16811,15,2021-05-19,1621378800.0
13776,76,4,2021-05-20,882,1,17693,16,2021-05-20,1621465200.0
13777,76,4,2021-05-21,1213,4,18906,20,2021-05-21,1621551600.0
13778,76,4,2021-05-22,369,0,19275,20,2021-05-22,1621638000.0
13779,76,4,2021-05-23,34,0,19309,20,2021-05-23,1621724400.0
13780,76,4,2021-05-24,66,0,19375,20,2021-05-24,1621810800.0
13781,76,4,2021-05-25,779,0,20154,20,2021-05-25,1621897200.0
13782,76,4,2021-05-26,712,1,20866,21,2021-05-26,1621983600.0
13783,76,4,2021-05-27,1136,11,22002,32,2021-05-27,1622070000.0
13784,76,4,2021-05-28,2260,10,24262,42,2021-05-28,1622156400.0
13785,76,4,2021-05-29,772,9,25034,51,2021-05-29,1622242800.0
13786,76,4,2021-05-30,73,0,25107,51,2021-05-30,1622329200.0
13787,76,4,2021-05-31,1313,2,26420,53,2021-05-31,1622415600.0
13788,76,4,2021-06-01,2280,4,28700,57,2021-06-01,1622502000.0
13789,76,4,2021-06-02,1505,2,30205,59,2021-06-02,1622588400.0
13790,76,4,2021-06-03,2203,1,32408,60,2021-06-03,1622674800.0
13791,76,4,2021-06-04,2243,5,34651,65,2021-06-04,1622761200.0
13792,76,4,2021-06-05,667,4,35318,69,2021-06-05,1622847600.0
13793,76,4,2021-06-06,72,0,35390,69,2021-06-06,1622934000.0
13794,76,4,2021-06-07,939,2,36329,71,2021-06-07,1623020400.0
13795,76,4,2021-06-08,1511,4,37840,75,2021-06-08,1623106800.0
13796,76,4,2021-06-09,1275,2,39115,77,2021-06-09,1623193200.0
13797,76,4,2021-06-10,1745,1,40860,78,2021-06-10,1623279600.0
13798,76,4,2021-06-11,1846,10,42706,88,2021-06-11,1623366000.0
13799,76,4,2021-06-12,497,1,43203,89,2021-06-12,1623452400.0
13800,76,4,2021-06-13,81,0,43284,89,2021-06-13,1623538800.0
13801,76,4,2021-06-14,621,2,43905,91,2021-06-14,1623625200.0
13802,76,4,2021-06-15,1080,2,44985,93,2021-06-15,1623711600.0
13803,76,4,2021-06-16,944,1,45929,94,2021-06-16,1623798000.0
13804,76,4,2021-06-17,1245,1,47174,95,2021-06-17,1623884400.0
13805,76,4,2021-06-18,1328,4,48502,99,2021-06-18,1623970800.0
13806,76,4,2021-06-19,345,2,48847,101,2021-06-19,1624057200.0
13807,76,4,2021-06-20,49,0,48896,101,2021-06-20,1624143600.0
13808,76,4,2021-06-21,483,4,49379,105,2021-06-21,1624230000.0
13809,76,4,2021-06-22,787,1,50166,106,2021-06-22,1624316400.0
13810,76,4,2021-06-23,755,7,50921,113,2021-06-23,1624402800.0
13811,76,4,2021-06-24,973,3,51894,116,2021-06-24,1624489200.0
13812,76,4,2021-06-25,1093,3,52987,119,2021-06-25,1624575600.0
13813,76,4,2021-06-26,336,0,53323,119,2021-06-26,1624662000.0
13814,76,4,2021-06-27,44,0,53367,119,2021-06-27,1624748400.0
13815,76,4,2021-06-28,455,3,53822,122,2021-06-28,1624834800.0
13816,76,4,2021-06-29,688,5,54510,127,2021-06-29,1624921200.0
13817,76,4,2021-06-30,683,2,55193,129,2021-06-30,1625007600.0
13818,76,4,2021-07-01,924,1,56117,130,2021-07-01,1625094000.0
13819,76,4,2021-07-02,809,5,56926,135,2021-07-02,1625180400.0
13820,76,4,2021-07-03,347,3,57273,138,2021-07-03,1625266800.0
13821,76,4,2021-07-04,59,0,57332,138,2021-07-04,1625353200.0
13822,76,4,2021-07-05,468,3,57800,141,2021-07-05,1625439600.0
13823,76,4,2021-07-06,825,4,58625,145,2021-07-06,1625526000.0
13824,84,1,2020-12-27,1,0,1,0,2020-12-27,1609023600.0
13825,84,1,2020-12-28,7,0,8,0,2020-12-28,1609110000.0
13826,84,1,2020-12-29,5,0,13,0,2020-12-29,1609196400.0
13827,84,1,2020-12-30,6,0,19,0,2020-12-30,1609282800.0
13828,84,1,2020-12-31,15,0,34,0,2020-12-31,1609369200.0
13829,84,1,2021-01-01,10,0,44,0,2021-01-01,1609455600.0
13830,84,1,2021-01-02,2,0,46,0,2021-01-02,1609542000.0
13831,84,1,2021-01-03,0,0,46,0,2021-01-03,1609628400.0
13832,84,1,2021-01-04,174,0,220,0,2021-01-04,1609714800.0
13833,84,1,2021-01-05,470,0,690,0,2021-01-05,1609801200.0
13834,84,1,2021-01-06,1135,0,1825,0,2021-01-06,1609887600.0
13835,84,1,2021-01-07,2888,0,4713,0,2021-01-07,1609974000.0
13836,84,1,2021-01-08,3082,0,7795,0,2021-01-08,1610060400.0
13837,84,1,2021-01-09,514,0,8309,0,2021-01-09,1610146800.0
13838,84,1,2021-01-10,161,0,8470,0,2021-01-10,1610233200.0
13839,84,1,2021-01-11,4298,0,12768,0,2021-01-11,1610319600.0
13840,84,1,2021-01-12,6365,0,19133,0,2021-01-12,1610406000.0
13841,84,1,2021-01-13,6845,0,25978,0,2021-01-13,1610492400.0
13842,84,1,2021-01-14,9062,0,35040,0,2021-01-14,1610578800.0
13843,84,1,2021-01-15,7724,0,42764,0,2021-01-15,1610665200.0
13844,84,1,2021-01-16,2953,2,45717,2,2021-01-16,1610751600.0
13845,84,1,2021-01-17,918,2,46635,4,2021-01-17,1610838000.0
13846,84,1,2021-01-18,8304,20,54939,24,2021-01-18,1610924400.0
13847,84,1,2021-01-19,14181,16,69120,40,2021-01-19,1611010800.0
13848,84,1,2021-01-20,14476,16,83596,56,2021-01-20,1611097200.0
13849,84,1,2021-01-21,13585,19,97181,75,2021-01-21,1611183600.0
13850,84,1,2021-01-22,11522,19,108703,94,2021-01-22,1611270000.0
13851,84,1,2021-01-23,4305,1,113008,95,2021-01-23,1611356400.0
13852,84,1,2021-01-24,810,0,113818,95,2021-01-24,1611442800.0
13853,84,1,2021-01-25,8646,136,122464,231,2021-01-25,1611529200.0
13854,84,1,2021-01-26,11812,294,134276,525,2021-01-26,1611615600.0
13855,84,1,2021-01-27,12028,588,146304,1113,2021-01-27,1611702000.0
13856,84,1,2021-01-28,13792,1502,160096,2615,2021-01-28,1611788400.0
13857,84,1,2021-01-29,10745,1287,170841,3902,2021-01-29,1611874800.0
13858,84,1,2021-01-30,4142,142,174983,4044,2021-01-30,1611961200.0
13859,84,1,2021-01-31,499,1,175482,4045,2021-01-31,1612047600.0
13860,84,1,2021-02-01,6488,1862,181970,5907,2021-02-01,1612134000.0
13861,84,1,2021-02-02,10314,3463,192284,9370,2021-02-02,1612220400.0
13862,84,1,2021-02-03,11160,3870,203444,13240,2021-02-03,1612306800.0
13863,84,1,2021-02-04,12343,5449,215787,18689,2021-02-04,1612393200.0
13864,84,1,2021-02-05,8277,4644,224064,23333,2021-02-05,1612479600.0
13865,84,1,2021-02-06,2435,931,226499,24264,2021-02-06,1612566000.0
13866,84,1,2021-02-07,270,435,226769,24699,2021-02-07,1612652400.0
13867,84,1,2021-02-08,5202,4916,231971,29615,2021-02-08,1612738800.0
13868,84,1,2021-02-09,7093,8136,239064,37751,2021-02-09,1612825200.0
13869,84,1,2021-02-10,7191,8460,246255,46211,2021-02-10,1612911600.0
13870,84,1,2021-02-11,7622,9688,253877,55899,2021-02-11,1612998000.0
13871,84,1,2021-02-12,7002,7725,260879,63624,2021-02-12,1613084400.0
13872,84,1,2021-02-13,1882,2287,262761,65911,2021-02-13,1613170800.0
13873,84,1,2021-02-14,303,445,263064,66356,2021-02-14,1613257200.0
13874,84,1,2021-02-15,2859,7525,265923,73881,2021-02-15,1613343600.0
13875,84,1,2021-02-16,3921,9754,269844,83635,2021-02-16,1613430000.0
13876,84,1,2021-02-17,3992,10409,273836,94044,2021-02-17,1613516400.0
13877,84,1,2021-02-18,5012,10487,278848,104531,2021-02-18,1613602800.0
13878,84,1,2021-02-19,4334,8473,283182,113004,2021-02-19,1613689200.0
13879,84,1,2021-02-20,1186,3068,284368,116072,2021-02-20,1613775600.0
13880,84,1,2021-02-21,151,504,284519,116576,2021-02-21,1613862000.0
13881,84,1,2021-02-22,2719,8632,287238,125208,2021-02-22,1613948400.0
13882,84,1,2021-02-23,4885,11097,292123,136305,2021-02-23,1614034800.0
13883,84,1,2021-02-24,5601,11693,297724,147998,2021-02-24,1614121200.0
13884,84,1,2021-02-25,7101,13356,304825,161354,2021-02-25,1614207600.0
13885,84,1,2021-02-26,6289,9983,311114,171337,2021-02-26,1614294000.0
13886,84,1,2021-02-27,1684,2770,312798,174107,2021-02-27,1614380400.0
13887,84,1,2021-02-28,242,498,313040,174605,2021-02-28,1614466800.0
13888,84,1,2021-03-01,5619,6096,318659,180701,2021-03-01,1614553200.0
13889,84,1,2021-03-02,7964,8218,326623,188919,2021-03-02,1614639600.0
13890,84,1,2021-03-03,7730,7934,334353,196853,2021-03-03,1614726000.0
13891,84,1,2021-03-04,9566,7729,343919,204582,2021-03-04,1614812400.0
13892,84,1,2021-03-05,8622,6857,352541,211439,2021-03-05,1614898800.0
13893,84,1,2021-03-06,5742,1958,358283,213397,2021-03-06,1614985200.0
13894,84,1,2021-03-07,3023,330,361306,213727,2021-03-07,1615071600.0
13895,84,1,2021-03-08,7336,6097,368642,219824,2021-03-08,1615158000.0
13896,84,1,2021-03-09,9548,6779,378190,226603,2021-03-09,1615244400.0
13897,84,1,2021-03-10,9695,6494,387885,233097,2021-03-10,1615330800.0
13898,84,1,2021-03-11,11588,6928,399473,240025,2021-03-11,1615417200.0
13899,84,1,2021-03-12,10650,6441,410123,246466,2021-03-12,1615503600.0
13900,84,1,2021-03-13,6295,1394,416418,247860,2021-03-13,1615590000.0
13901,84,1,2021-03-14,2706,390,419124,248250,2021-03-14,1615676400.0
13902,84,1,2021-03-15,10832,4027,429956,252277,2021-03-15,1615762800.0
13903,84,1,2021-03-16,13781,5271,443737,257548,2021-03-16,1615849200.0
13904,84,1,2021-03-17,14159,5464,457896,263012,2021-03-17,1615935600.0
13905,84,1,2021-03-18,16720,5855,474616,268867,2021-03-18,1616022000.0
13906,84,1,2021-03-19,15276,4185,489892,273052,2021-03-19,1616108400.0
13907,84,1,2021-03-20,6826,1006,496718,274058,2021-03-20,1616194800.0
13908,84,1,2021-03-21,2782,170,499500,274228,2021-03-21,1616281200.0
13909,84,1,2021-03-22,12700,4019,512200,278247,2021-03-22,1616367600.0
13910,84,1,2021-03-23,16122,4719,528322,282966,2021-03-23,1616454000.0
13911,84,1,2021-03-24,15910,4408,544232,287374,2021-03-24,1616540400.0
13912,84,1,2021-03-25,19224,4564,563456,291938,2021-03-25,1616626800.0
13913,84,1,2021-03-26,18874,4808,582330,296746,2021-03-26,1616713200.0
13914,84,1,2021-03-27,9727,2252,592057,298998,2021-03-27,1616799600.0
13915,84,1,2021-03-28,4303,361,596360,299359,2021-03-28,1616886000.0
13916,84,1,2021-03-29,13466,6879,609826,306238,2021-03-29,1616972400.0
13917,84,1,2021-03-30,17228,8208,627054,314446,2021-03-30,1617058800.0
13918,84,1,2021-03-31,17049,9079,644103,323525,2021-03-31,1617145200.0
13919,84,1,2021-04-01,20347,8525,664450,332050,2021-04-01,1617231600.0
13920,84,1,2021-04-02,18063,8504,682513,340554,2021-04-02,1617318000.0
13921,84,1,2021-04-03,7126,5129,689639,345683,2021-04-03,1617404400.0
13922,84,1,2021-04-04,4967,1525,694606,347208,2021-04-04,1617490800.0
13923,84,1,2021-04-05,7981,990,702587,348198,2021-04-05,1617577200.0
13924,84,1,2021-04-06,18833,10939,721420,359137,2021-04-06,1617663600.0
13925,84,1,2021-04-07,21537,11859,742957,370996,2021-04-07,1617750000.0
13926,84,1,2021-04-08,24932,11859,767889,382855,2021-04-08,1617836400.0
13927,84,1,2021-04-09,24786,11561,792675,394416,2021-04-09,1617922800.0
13928,84,1,2021-04-10,12158,6102,804833,400518,2021-04-10,1618009200.0
13929,84,1,2021-04-11,6126,2212,810959,402730,2021-04-11,1618095600.0
13930,84,1,2021-04-12,19326,12229,830285,414959,2021-04-12,1618185600.0
13931,84,1,2021-04-13,24091,13881,854376,428840,2021-04-13,1618272000.0
13932,84,1,2021-04-14,25125,13469,879501,442309,2021-04-14,1618358400.0
13933,84,1,2021-04-15,27198,13661,906699,455970,2021-04-15,1618444800.0
13934,84,1,2021-04-16,23680,13980,930379,469950,2021-04-16,1618531200.0
13935,84,1,2021-04-17,15032,6258,945411,476208,2021-04-17,1618617600.0
13936,84,1,2021-04-18,5832,2359,951243,478567,2021-04-18,1618704000.0
13937,84,1,2021-04-19,21110,14362,972353,492929,2021-04-19,1618790400.0
13938,84,1,2021-04-20,24140,17008,996493,509937,2021-04-20,1618876800.0
13939,84,1,2021-04-21,22444,16575,1018937,526512,2021-04-21,1618963200.0
13940,84,1,2021-04-22,24726,17003,1043663,543515,2021-04-22,1619049600.0
13941,84,1,2021-04-23,23325,17230,1066988,560745,2021-04-23,1619136000.0
13942,84,1,2021-04-24,14208,8451,1081196,569196,2021-04-24,1619222400.0
13943,84,1,2021-04-25,6871,2736,1088067,571932,2021-04-25,1619308800.0
13944,84,1,2021-04-26,20444,15723,1108511,587655,2021-04-26,1619395200.0
13945,84,1,2021-04-27,25077,17715,1133588,605370,2021-04-27,1619481600.0
13946,84,1,2021-04-28,26505,16733,1160093,622103,2021-04-28,1619568000.0
13947,84,1,2021-04-29,29700,17052,1189793,639155,2021-04-29,1619654400.0
13948,84,1,2021-04-30,26274,16821,1216067,655976,2021-04-30,1619740800.0
13949,84,1,2021-05-01,15246,3056,1231313,659032,2021-05-01,1619827200.0
13950,84,1,2021-05-02,7482,3835,1238795,662867,2021-05-02,1619913600.0
13951,84,1,2021-05-03,25569,18353,1264364,681220,2021-05-03,1620000000.0
13952,84,1,2021-05-04,29993,22959,1294357,704179,2021-05-04,1620086400.0
13953,84,1,2021-05-05,34254,21388,1328611,725567,2021-05-05,1620172800.0
13954,84,1,2021-05-06,39051,21579,1367662,747146,2021-05-06,1620259200.0
13955,84,1,2021-05-07,37531,23436,1405193,770582,2021-05-07,1620345600.0
13956,84,1,2021-05-08,20283,4483,1425476,775065,2021-05-08,1620432000.0
13957,84,1,2021-05-09,14471,6780,1439947,781845,2021-05-09,1620518400.0
13958,84,1,2021-05-10,29810,23251,1469757,805096,2021-05-10,1620604800.0
13959,84,1,2021-05-11,42745,24628,1512502,829724,2021-05-11,1620691200.0
13960,84,1,2021-05-12,48729,20578,1561231,850302,2021-05-12,1620777600.0
13961,84,1,2021-05-13,39366,6288,1600597,856590,2021-05-13,1620864000.0
13962,84,1,2021-05-14,49068,15297,1649665,871887,2021-05-14,1620950400.0
13963,84,1,2021-05-15,41024,7481,1690689,879368,2021-05-15,1621036800.0
13964,84,1,2021-05-16,27340,2220,1718029,881588,2021-05-16,1621123200.0
13965,84,1,2021-05-17,39355,15852,1757384,897440,2021-05-17,1621206000.0
13966,84,1,2021-05-18,46164,15519,1803548,912959,2021-05-18,1621292400.0
13967,84,1,2021-05-19,46058,12473,1849606,925432,2021-05-19,1621378800.0
13968,84,1,2021-05-20,49889,13029,1899495,938461,2021-05-20,1621465200.0
13969,84,1,2021-05-21,48460,13063,1947955,951524,2021-05-21,1621551600.0
13970,84,1,2021-05-22,31682,5423,1979637,956947,2021-05-22,1621638000.0
13971,84,1,2021-05-23,14374,1913,1994011,958860,2021-05-23,1621724400.0
13972,84,1,2021-05-24,35827,4222,2029838,963082,2021-05-24,1621810800.0
13973,84,1,2021-05-25,47694,18053,2077532,981135,2021-05-25,1621897200.0
13974,84,1,2021-05-26,47636,15615,2125168,996750,2021-05-26,1621983600.0
13975,84,1,2021-05-27,52061,14385,2177229,1011135,2021-05-27,1622070000.0
13976,84,1,2021-05-28,48938,17732,2226167,1028867,2021-05-28,1622156400.0
13977,84,1,2021-05-29,35817,11028,2261984,1039895,2021-05-29,1622242800.0
13978,84,1,2021-05-30,15866,4700,2277850,1044595,2021-05-30,1622329200.0
13979,84,1,2021-05-31,42558,18151,2320408,1062746,2021-05-31,1622415600.0
13980,84,1,2021-06-01,43181,19628,2363589,1082374,2021-06-01,1622502000.0
13981,84,1,2021-06-02,43236,16557,2406825,1098931,2021-06-02,1622588400.0
13982,84,1,2021-06-03,48334,15764,2455159,1114695,2021-06-03,1622674800.0
13983,84,1,2021-06-04,44541,18823,2499700,1133518,2021-06-04,1622761200.0
13984,84,1,2021-06-05,34677,11748,2534377,1145266,2021-06-05,1622847600.0
13985,84,1,2021-06-06,15637,4089,2550014,1149355,2021-06-06,1622934000.0
13986,84,1,2021-06-07,37373,23843,2587387,1173198,2021-06-07,1623020400.0
13987,84,1,2021-06-08,38756,23016,2626143,1196214,2021-06-08,1623106800.0
13988,84,1,2021-06-09,35879,21303,2662022,1217517,2021-06-09,1623193200.0
13989,84,1,2021-06-10,35016,17625,2697038,1235142,2021-06-10,1623279600.0
13990,84,1,2021-06-11,35744,23906,2732782,1259048,2021-06-11,1623366000.0
13991,84,1,2021-06-12,25071,14673,2757853,1273721,2021-06-12,1623452400.0
13992,84,1,2021-06-13,8394,5397,2766247,1279118,2021-06-13,1623538800.0
13993,84,1,2021-06-14,22653,32336,2788900,1311454,2021-06-14,1623625200.0
13994,84,1,2021-06-15,26793,31183,2815693,1342637,2021-06-15,1623711600.0
13995,84,1,2021-06-16,29784,31069,2845477,1373706,2021-06-16,1623798000.0
13996,84,1,2021-06-17,26221,27186,2871698,1400892,2021-06-17,1623884400.0
13997,84,1,2021-06-18,29009,36948,2900707,1437840,2021-06-18,1623970800.0
13998,84,1,2021-06-19,20762,26777,2921469,1464617,2021-06-19,1624057200.0
13999,84,1,2021-06-20,8512,11433,2929981,1476050,2021-06-20,1624143600.0
14000,84,1,2021-06-21,17867,42210,2947848,1518260,2021-06-21,1624230000.0
14001,84,1,2021-06-22,17710,43680,2965558,1561940,2021-06-22,1624316400.0
14002,84,1,2021-06-23,19732,42514,2985290,1604454,2021-06-23,1624402800.0
14003,84,1,2021-06-24,19735,36566,3005025,1641020,2021-06-24,1624489200.0
14004,84,1,2021-06-25,19404,48220,3024429,1689240,2021-06-25,1624575600.0
14005,84,1,2021-06-26,12567,37800,3036996,1727040,2021-06-26,1624662000.0
14006,84,1,2021-06-27,6634,18635,3043630,1745675,2021-06-27,1624748400.0
14007,84,1,2021-06-28,14174,47621,3057804,1793296,2021-06-28,1624834800.0
14008,84,1,2021-06-29,16172,45991,3073976,1839287,2021-06-29,1624921200.0
14009,84,1,2021-06-30,19299,43150,3093275,1882437,2021-06-30,1625007600.0
14010,84,1,2021-07-01,19747,36798,3113022,1919235,2021-07-01,1625094000.0
14011,84,1,2021-07-02,19150,44847,3132172,1964082,2021-07-02,1625180400.0
14012,84,1,2021-07-03,14266,34132,3146438,1998214,2021-07-03,1625266800.0
14013,84,1,2021-07-04,7571,12981,3154009,2011195,2021-07-04,1625353200.0
14014,84,1,2021-07-05,17379,50476,3171388,2061671,2021-07-05,1625439600.0
14015,84,1,2021-07-06,18470,47083,3189858,2108754,2021-07-06,1625526000.0
14016,84,2,2020-12-27,0,0,0,0,2020-12-27,1609023600.0
14017,84,2,2020-12-28,0,0,0,0,2020-12-28,1609110000.0
14018,84,2,2020-12-29,0,0,0,0,2020-12-29,1609196400.0
14019,84,2,2020-12-30,0,0,0,0,2020-12-30,1609282800.0
14020,84,2,2020-12-31,0,0,0,0,2020-12-31,1609369200.0
14021,84,2,2021-01-01,0,0,0,0,2021-01-01,1609455600.0
14022,84,2,2021-01-02,0,0,0,0,2021-01-02,1609542000.0
14023,84,2,2021-01-03,0,0,0,0,2021-01-03,1609628400.0
14024,84,2,2021-01-04,0,0,0,0,2021-01-04,1609714800.0
14025,84,2,2021-01-05,0,0,0,0,2021-01-05,1609801200.0
14026,84,2,2021-01-06,0,0,0,0,2021-01-06,1609887600.0
14027,84,2,2021-01-07,0,0,0,0,2021-01-07,1609974000.0
14028,84,2,2021-01-08,0,0,0,0,2021-01-08,1610060400.0
14029,84,2,2021-01-09,0,0,0,0,2021-01-09,1610146800.0
14030,84,2,2021-01-10,0,0,0,0,2021-01-10,1610233200.0
14031,84,2,2021-01-11,0,0,0,0,2021-01-11,1610319600.0
14032,84,2,2021-01-12,0,0,0,0,2021-01-12,1610406000.0
14033,84,2,2021-01-13,0,0,0,0,2021-01-13,1610492400.0
14034,84,2,2021-01-14,12,0,12,0,2021-01-14,1610578800.0
14035,84,2,2021-01-15,38,0,50,0,2021-01-15,1610665200.0
14036,84,2,2021-01-16,0,0,50,0,2021-01-16,1610751600.0
14037,84,2,2021-01-17,3,0,53,0,2021-01-17,1610838000.0
14038,84,2,2021-01-18,664,0,717,0,2021-01-18,1610924400.0
14039,84,2,2021-01-19,869,0,1586,0,2021-01-19,1611010800.0
14040,84,2,2021-01-20,1027,0,2613,0,2021-01-20,1611097200.0
14041,84,2,2021-01-21,1014,0,3627,0,2021-01-21,1611183600.0
14042,84,2,2021-01-22,900,0,4527,0,2021-01-22,1611270000.0
14043,84,2,2021-01-23,458,0,4985,0,2021-01-23,1611356400.0
14044,84,2,2021-01-24,0,0,4985,0,2021-01-24,1611442800.0
14045,84,2,2021-01-25,123,0,5108,0,2021-01-25,1611529200.0
14046,84,2,2021-01-26,92,0,5200,0,2021-01-26,1611615600.0
14047,84,2,2021-01-27,60,0,5260,0,2021-01-27,1611702000.0
14048,84,2,2021-01-28,62,0,5322,0,2021-01-28,1611788400.0
14049,84,2,2021-01-29,61,0,5383,0,2021-01-29,1611874800.0
14050,84,2,2021-01-30,0,0,5383,0,2021-01-30,1611961200.0
14051,84,2,2021-01-31,0,0,5383,0,2021-01-31,1612047600.0
14052,84,2,2021-02-01,65,0,5448,0,2021-02-01,1612134000.0
14053,84,2,2021-02-02,294,0,5742,0,2021-02-02,1612220400.0
14054,84,2,2021-02-03,371,0,6113,0,2021-02-03,1612306800.0
14055,84,2,2021-02-04,229,0,6342,0,2021-02-04,1612393200.0
14056,84,2,2021-02-05,343,1,6685,1,2021-02-05,1612479600.0
14057,84,2,2021-02-06,66,0,6751,1,2021-02-06,1612566000.0
14058,84,2,2021-02-07,13,0,6764,1,2021-02-07,1612652400.0
14059,84,2,2021-02-08,271,0,7035,1,2021-02-08,1612738800.0
14060,84,2,2021-02-09,549,1,7584,2,2021-02-09,1612825200.0
14061,84,2,2021-02-10,697,18,8281,20,2021-02-10,1612911600.0
14062,84,2,2021-02-11,681,0,8962,20,2021-02-11,1612998000.0
14063,84,2,2021-02-12,618,36,9580,56,2021-02-12,1613084400.0
14064,84,2,2021-02-13,140,1,9720,57,2021-02-13,1613170800.0
14065,84,2,2021-02-14,0,0,9720,57,2021-02-14,1613257200.0
14066,84,2,2021-02-15,428,699,10148,756,2021-02-15,1613343600.0
14067,84,2,2021-02-16,537,883,10685,1639,2021-02-16,1613430000.0
14068,84,2,2021-02-17,579,1040,11264,2679,2021-02-17,1613516400.0
14069,84,2,2021-02-18,422,1096,11686,3775,2021-02-18,1613602800.0
14070,84,2,2021-02-19,617,706,12303,4481,2021-02-19,1613689200.0
14071,84,2,2021-02-20,85,168,12388,4649,2021-02-20,1613775600.0
14072,84,2,2021-02-21,0,0,12388,4649,2021-02-21,1613862000.0
14073,84,2,2021-02-22,362,105,12750,4754,2021-02-22,1613948400.0
14074,84,2,2021-02-23,494,136,13244,4890,2021-02-23,1614034800.0
14075,84,2,2021-02-24,526,141,13770,5031,2021-02-24,1614121200.0
14076,84,2,2021-02-25,851,36,14621,5067,2021-02-25,1614207600.0
14077,84,2,2021-02-26,411,1,15032,5068,2021-02-26,1614294000.0
14078,84,2,2021-02-27,65,42,15097,5110,2021-02-27,1614380400.0
14079,84,2,2021-02-28,0,0,15097,5110,2021-02-28,1614466800.0
14080,84,2,2021-03-01,748,168,15845,5278,2021-03-01,1614553200.0
14081,84,2,2021-03-02,980,258,16825,5536,2021-03-02,1614639600.0
14082,84,2,2021-03-03,886,384,17711,5920,2021-03-03,1614726000.0
14083,84,2,2021-03-04,915,187,18626,6107,2021-03-04,1614812400.0
14084,84,2,2021-03-05,1192,203,19818,6310,2021-03-05,1614898800.0
14085,84,2,2021-03-06,672,116,20490,6426,2021-03-06,1614985200.0
14086,84,2,2021-03-07,160,0,20650,6426,2021-03-07,1615071600.0
14087,84,2,2021-03-08,509,467,21159,6893,2021-03-08,1615158000.0
14088,84,2,2021-03-09,1148,522,22307,7415,2021-03-09,1615244400.0
14089,84,2,2021-03-10,1266,633,23573,8048,2021-03-10,1615330800.0
14090,84,2,2021-03-11,1498,558,25071,8606,2021-03-11,1615417200.0
14091,84,2,2021-03-12,1167,462,26238,9068,2021-03-12,1615503600.0
14092,84,2,2021-03-13,1342,113,27580,9181,2021-03-13,1615590000.0
14093,84,2,2021-03-14,272,2,27852,9183,2021-03-14,1615676400.0
14094,84,2,2021-03-15,2007,329,29859,9512,2021-03-15,1615762800.0
14095,84,2,2021-03-16,3169,439,33028,9951,2021-03-16,1615849200.0
14096,84,2,2021-03-17,3333,532,36361,10483,2021-03-17,1615935600.0
14097,84,2,2021-03-18,4619,399,40980,10882,2021-03-18,1616022000.0
14098,84,2,2021-03-19,4718,543,45698,11425,2021-03-19,1616108400.0
14099,84,2,2021-03-20,1765,31,47463,11456,2021-03-20,1616194800.0
14100,84,2,2021-03-21,3,0,47466,11456,2021-03-21,1616281200.0
14101,84,2,2021-03-22,3053,598,50519,12054,2021-03-22,1616367600.0
14102,84,2,2021-03-23,3894,346,54413,12400,2021-03-23,1616454000.0
14103,84,2,2021-03-24,3877,550,58290,12950,2021-03-24,1616540400.0
14104,84,2,2021-03-25,4350,571,62640,13521,2021-03-25,1616626800.0
14105,84,2,2021-03-26,3931,500,66571,14021,2021-03-26,1616713200.0
14106,84,2,2021-03-27,2322,64,68893,14085,2021-03-27,1616799600.0
14107,84,2,2021-03-28,1858,0,70751,14085,2021-03-28,1616886000.0
14108,84,2,2021-03-29,2711,266,73462,14351,2021-03-29,1616972400.0
14109,84,2,2021-03-30,4519,691,77981,15042,2021-03-30,1617058800.0
14110,84,2,2021-03-31,4566,683,82547,15725,2021-03-31,1617145200.0
14111,84,2,2021-04-01,5238,1220,87785,16945,2021-04-01,1617231600.0
14112,84,2,2021-04-02,4449,1295,92234,18240,2021-04-02,1617318000.0
14113,84,2,2021-04-03,4360,483,96594,18723,2021-04-03,1617404400.0
14114,84,2,2021-04-04,4889,4,101483,18727,2021-04-04,1617490800.0
14115,84,2,2021-04-05,5304,9,106787,18736,2021-04-05,1617577200.0
14116,84,2,2021-04-06,3295,1101,110082,19837,2021-04-06,1617663600.0
14117,84,2,2021-04-07,4043,1441,114125,21278,2021-04-07,1617750000.0
14118,84,2,2021-04-08,4102,1577,118227,22855,2021-04-08,1617836400.0
14119,84,2,2021-04-09,3817,1274,122044,24129,2021-04-09,1617922800.0
14120,84,2,2021-04-10,1742,1029,123786,25158,2021-04-10,1618009200.0
14121,84,2,2021-04-11,710,22,124496,25180,2021-04-11,1618095600.0
14122,84,2,2021-04-12,2399,1994,126895,27174,2021-04-12,1618185600.0
14123,84,2,2021-04-13,1972,3568,128867,30742,2021-04-13,1618272000.0
14124,84,2,2021-04-14,2153,2925,131020,33667,2021-04-14,1618358400.0
14125,84,2,2021-04-15,2261,3784,133281,37451,2021-04-15,1618444800.0
14126,84,2,2021-04-16,2229,4003,135510,41454,2021-04-16,1618531200.0
14127,84,2,2021-04-17,1231,1635,136741,43089,2021-04-17,1618617600.0
14128,84,2,2021-04-18,670,16,137411,43105,2021-04-18,1618704000.0
14129,84,2,2021-04-19,2055,2686,139466,45791,2021-04-19,1618790400.0
14130,84,2,2021-04-20,1628,3570,141094,49361,2021-04-20,1618876800.0
14131,84,2,2021-04-21,1573,3141,142667,52502,2021-04-21,1618963200.0
14132,84,2,2021-04-22,1797,3419,144464,55921,2021-04-22,1619049600.0
14133,84,2,2021-04-23,1724,3493,146188,59414,2021-04-23,1619136000.0
14134,84,2,2021-04-24,675,2177,146863,61591,2021-04-24,1619222400.0
14135,84,2,2021-04-25,159,1080,147022,62671,2021-04-25,1619308800.0
14136,84,2,2021-04-26,1110,2458,148132,65129,2021-04-26,1619395200.0
14137,84,2,2021-04-27,1356,4382,149488,69511,2021-04-27,1619481600.0
14138,84,2,2021-04-28,2025,4745,151513,74256,2021-04-28,1619568000.0
14139,84,2,2021-04-29,3274,4367,154787,78623,2021-04-29,1619654400.0
14140,84,2,2021-04-30,3127,4529,157914,83152,2021-04-30,1619740800.0
14141,84,2,2021-05-01,1095,825,159009,83977,2021-05-01,1619827200.0
14142,84,2,2021-05-02,381,4120,159390,88097,2021-05-02,1619913600.0
14143,84,2,2021-05-03,2867,5825,162257,93922,2021-05-03,1620000000.0
14144,84,2,2021-05-04,3241,5609,165498,99531,2021-05-04,1620086400.0
14145,84,2,2021-05-05,3175,3659,168673,103190,2021-05-05,1620172800.0
14146,84,2,2021-05-06,2956,3455,171629,106645,2021-05-06,1620259200.0
14147,84,2,2021-05-07,2706,3608,174335,110253,2021-05-07,1620345600.0
14148,84,2,2021-05-08,1419,608,175754,110861,2021-05-08,1620432000.0
14149,84,2,2021-05-09,1293,703,177047,111564,2021-05-09,1620518400.0
14150,84,2,2021-05-10,4097,3303,181144,114867,2021-05-10,1620604800.0
14151,84,2,2021-05-11,5545,2376,186689,117243,2021-05-11,1620691200.0
14152,84,2,2021-05-12,5538,2464,192227,119707,2021-05-12,1620777600.0
14153,84,2,2021-05-13,7790,442,200017,120149,2021-05-13,1620864000.0
14154,84,2,2021-05-14,6641,1639,206658,121788,2021-05-14,1620950400.0
14155,84,2,2021-05-15,2666,823,209324,122611,2021-05-15,1621036800.0
14156,84,2,2021-05-16,3208,149,212532,122760,2021-05-16,1621123200.0
14157,84,2,2021-05-17,7908,1579,220440,124339,2021-05-17,1621206000.0
14158,84,2,2021-05-18,11151,1792,231591,126131,2021-05-18,1621292400.0
14159,84,2,2021-05-19,11301,1573,242892,127704,2021-05-19,1621378800.0
14160,84,2,2021-05-20,10090,1075,252982,128779,2021-05-20,1621465200.0
14161,84,2,2021-05-21,10666,1288,263648,130067,2021-05-21,1621551600.0
14162,84,2,2021-05-22,8247,520,271895,130587,2021-05-22,1621638000.0
14163,84,2,2021-05-23,7109,92,279004,130679,2021-05-23,1621724400.0
14164,84,2,2021-05-24,4214,355,283218,131034,2021-05-24,1621810800.0
14165,84,2,2021-05-25,1626,1795,284844,132829,2021-05-25,1621897200.0
14166,84,2,2021-05-26,1355,1842,286199,134671,2021-05-26,1621983600.0
14167,84,2,2021-05-27,1995,1409,288194,136080,2021-05-27,1622070000.0
14168,84,2,2021-05-28,2639,1525,290833,137605,2021-05-28,1622156400.0
14169,84,2,2021-05-29,806,772,291639,138377,2021-05-29,1622242800.0
14170,84,2,2021-05-30,189,295,291828,138672,2021-05-30,1622329200.0
14171,84,2,2021-05-31,316,1530,292144,140202,2021-05-31,1622415600.0
14172,84,2,2021-06-01,2558,1523,294702,141725,2021-06-01,1622502000.0
14173,84,2,2021-06-02,2947,1463,297649,143188,2021-06-02,1622588400.0
14174,84,2,2021-06-03,5357,1641,303006,144829,2021-06-03,1622674800.0
14175,84,2,2021-06-04,7512,1926,310518,146755,2021-06-04,1622761200.0
14176,84,2,2021-06-05,2634,1085,313152,147840,2021-06-05,1622847600.0
14177,84,2,2021-06-06,236,297,313388,148137,2021-06-06,1622934000.0
14178,84,2,2021-06-07,2999,1917,316387,150054,2021-06-07,1623020400.0
14179,84,2,2021-06-08,4654,1948,321041,152002,2021-06-08,1623106800.0
14180,84,2,2021-06-09,3435,1742,324476,153744,2021-06-09,1623193200.0
14181,84,2,2021-06-10,4659,1943,329135,155687,2021-06-10,1623279600.0
14182,84,2,2021-06-11,5831,3190,334966,158877,2021-06-11,1623366000.0
14183,84,2,2021-06-12,2465,1394,337431,160271,2021-06-12,1623452400.0
14184,84,2,2021-06-13,171,487,337602,160758,2021-06-13,1623538800.0
14185,84,2,2021-06-14,2282,3714,339884,164472,2021-06-14,1623625200.0
14186,84,2,2021-06-15,3717,3492,343601,167964,2021-06-15,1623711600.0
14187,84,2,2021-06-16,2655,2639,346256,170603,2021-06-16,1623798000.0
14188,84,2,2021-06-17,3110,2709,349366,173312,2021-06-17,1623884400.0
14189,84,2,2021-06-18,4511,3223,353877,176535,2021-06-18,1623970800.0
14190,84,2,2021-06-19,1539,2131,355416,178666,2021-06-19,1624057200.0
14191,84,2,2021-06-20,129,1464,355545,180130,2021-06-20,1624143600.0
14192,84,2,2021-06-21,1565,5934,357110,186064,2021-06-21,1624230000.0
14193,84,2,2021-06-22,2460,6216,359570,192280,2021-06-22,1624316400.0
14194,84,2,2021-06-23,1770,5314,361340,197594,2021-06-23,1624402800.0
14195,84,2,2021-06-24,2505,4464,363845,202058,2021-06-24,1624489200.0
14196,84,2,2021-06-25,2923,6020,366768,208078,2021-06-25,1624575600.0
14197,84,2,2021-06-26,1109,3323,367877,211401,2021-06-26,1624662000.0
14198,84,2,2021-06-27,179,3390,368056,214791,2021-06-27,1624748400.0
14199,84,2,2021-06-28,1035,10733,369091,225524,2021-06-28,1624834800.0
14200,84,2,2021-06-29,1887,10877,370978,236401,2021-06-29,1624921200.0
14201,84,2,2021-06-30,1624,10467,372602,246868,2021-06-30,1625007600.0
14202,84,2,2021-07-01,1918,8727,374520,255595,2021-07-01,1625094000.0
14203,84,2,2021-07-02,2287,8590,376807,264185,2021-07-02,1625180400.0
14204,84,2,2021-07-03,886,5383,377693,269568,2021-07-03,1625266800.0
14205,84,2,2021-07-04,112,2563,377805,272131,2021-07-04,1625353200.0
14206,84,2,2021-07-05,705,4091,378510,276222,2021-07-05,1625439600.0
14207,84,2,2021-07-06,1326,3790,379836,280012,2021-07-06,1625526000.0
14208,84,3,2020-12-27,0,0,0,0,2020-12-27,1609023600.0
14209,84,3,2020-12-28,0,0,0,0,2020-12-28,1609110000.0
14210,84,3,2020-12-29,0,0,0,0,2020-12-29,1609196400.0
14211,84,3,2020-12-30,0,0,0,0,2020-12-30,1609282800.0
14212,84,3,2020-12-31,0,0,0,0,2020-12-31,1609369200.0
14213,84,3,2021-01-01,0,0,0,0,2021-01-01,1609455600.0
14214,84,3,2021-01-02,0,0,0,0,2021-01-02,1609542000.0
14215,84,3,2021-01-03,0,0,0,0,2021-01-03,1609628400.0
14216,84,3,2021-01-04,0,0,0,0,2021-01-04,1609714800.0
14217,84,3,2021-01-05,0,0,0,0,2021-01-05,1609801200.0
14218,84,3,2021-01-06,0,0,0,0,2021-01-06,1609887600.0
14219,84,3,2021-01-07,0,0,0,0,2021-01-07,1609974000.0
14220,84,3,2021-01-08,0,0,0,0,2021-01-08,1610060400.0
14221,84,3,2021-01-09,0,0,0,0,2021-01-09,1610146800.0
14222,84,3,2021-01-10,0,0,0,0,2021-01-10,1610233200.0
14223,84,3,2021-01-11,0,0,0,0,2021-01-11,1610319600.0
14224,84,3,2021-01-12,0,0,0,0,2021-01-12,1610406000.0
14225,84,3,2021-01-13,0,0,0,0,2021-01-13,1610492400.0
14226,84,3,2021-01-14,0,0,0,0,2021-01-14,1610578800.0
14227,84,3,2021-01-15,0,0,0,0,2021-01-15,1610665200.0
14228,84,3,2021-01-16,0,0,0,0,2021-01-16,1610751600.0
14229,84,3,2021-01-17,0,0,0,0,2021-01-17,1610838000.0
14230,84,3,2021-01-18,0,0,0,0,2021-01-18,1610924400.0
14231,84,3,2021-01-19,0,0,0,0,2021-01-19,1611010800.0
14232,84,3,2021-01-20,0,0,0,0,2021-01-20,1611097200.0
14233,84,3,2021-01-21,0,0,0,0,2021-01-21,1611183600.0
14234,84,3,2021-01-22,0,0,0,0,2021-01-22,1611270000.0
14235,84,3,2021-01-23,0,0,0,0,2021-01-23,1611356400.0
14236,84,3,2021-01-24,0,0,0,0,2021-01-24,1611442800.0
14237,84,3,2021-01-25,0,0,0,0,2021-01-25,1611529200.0
14238,84,3,2021-01-26,0,0,0,0,2021-01-26,1611615600.0
14239,84,3,2021-01-27,0,0,0,0,2021-01-27,1611702000.0
14240,84,3,2021-01-28,0,0,0,0,2021-01-28,1611788400.0
14241,84,3,2021-01-29,0,0,0,0,2021-01-29,1611874800.0
14242,84,3,2021-01-30,0,0,0,0,2021-01-30,1611961200.0
14243,84,3,2021-01-31,0,0,0,0,2021-01-31,1612047600.0
14244,84,3,2021-02-01,0,0,0,0,2021-02-01,1612134000.0
14245,84,3,2021-02-02,0,0,0,0,2021-02-02,1612220400.0
14246,84,3,2021-02-03,0,0,0,0,2021-02-03,1612306800.0
14247,84,3,2021-02-04,0,0,0,0,2021-02-04,1612393200.0
14248,84,3,2021-02-05,0,0,0,0,2021-02-05,1612479600.0
14249,84,3,2021-02-06,156,0,156,0,2021-02-06,1612566000.0
14250,84,3,2021-02-07,169,0,325,0,2021-02-07,1612652400.0
14251,84,3,2021-02-08,747,0,1072,0,2021-02-08,1612738800.0
14252,84,3,2021-02-09,1695,0,2767,0,2021-02-09,1612825200.0
14253,84,3,2021-02-10,1798,0,4565,0,2021-02-10,1612911600.0
14254,84,3,2021-02-11,2392,0,6957,0,2021-02-11,1612998000.0
14255,84,3,2021-02-12,2103,0,9060,0,2021-02-12,1613084400.0
14256,84,3,2021-02-13,1474,0,10534,0,2021-02-13,1613170800.0
14257,84,3,2021-02-14,320,0,10854,0,2021-02-14,1613257200.0
14258,84,3,2021-02-15,1594,0,12448,0,2021-02-15,1613343600.0
14259,84,3,2021-02-16,1648,0,14096,0,2021-02-16,1613430000.0
14260,84,3,2021-02-17,1517,0,15613,0,2021-02-17,1613516400.0
14261,84,3,2021-02-18,1675,0,17288,0,2021-02-18,1613602800.0
14262,84,3,2021-02-19,1696,0,18984,0,2021-02-19,1613689200.0
14263,84,3,2021-02-20,567,0,19551,0,2021-02-20,1613775600.0
14264,84,3,2021-02-21,29,0,19580,0,2021-02-21,1613862000.0
14265,84,3,2021-02-22,1206,0,20786,0,2021-02-22,1613948400.0
14266,84,3,2021-02-23,1908,0,22694,0,2021-02-23,1614034800.0
14267,84,3,2021-02-24,1678,0,24372,0,2021-02-24,1614121200.0
14268,84,3,2021-02-25,4782,0,29154,0,2021-02-25,1614207600.0
14269,84,3,2021-02-26,8180,0,37334,0,2021-02-26,1614294000.0
14270,84,3,2021-02-27,3814,0,41148,0,2021-02-27,1614380400.0
14271,84,3,2021-02-28,259,0,41407,0,2021-02-28,1614466800.0
14272,84,3,2021-03-01,2927,2,44334,2,2021-03-01,1614553200.0
14273,84,3,2021-03-02,6029,1,50363,3,2021-03-02,1614639600.0
14274,84,3,2021-03-03,6188,1,56551,4,2021-03-03,1614726000.0
14275,84,3,2021-03-04,10558,3,67109,7,2021-03-04,1614812400.0
14276,84,3,2021-03-05,15967,6,83076,13,2021-03-05,1614898800.0
14277,84,3,2021-03-06,13086,6,96162,19,2021-03-06,1614985200.0
14278,84,3,2021-03-07,5234,0,101396,19,2021-03-07,1615071600.0
14279,84,3,2021-03-08,4370,2,105766,21,2021-03-08,1615158000.0
14280,84,3,2021-03-09,9990,3,115756,24,2021-03-09,1615244400.0
14281,84,3,2021-03-10,9280,8,125036,32,2021-03-10,1615330800.0
14282,84,3,2021-03-11,16397,5,141433,37,2021-03-11,1615417200.0
14283,84,3,2021-03-12,24375,6,165808,43,2021-03-12,1615503600.0
14284,84,3,2021-03-13,13801,13,179609,56,2021-03-13,1615590000.0
14285,84,3,2021-03-14,1710,0,181319,56,2021-03-14,1615676400.0
14286,84,3,2021-03-15,6038,7,187357,63,2021-03-15,1615762800.0
14287,84,3,2021-03-16,110,2,187467,65,2021-03-16,1615849200.0
14288,84,3,2021-03-17,92,0,187559,65,2021-03-17,1615935600.0
14289,84,3,2021-03-18,171,1,187730,66,2021-03-18,1616022000.0
14290,84,3,2021-03-19,9009,6,196739,72,2021-03-19,1616108400.0
14291,84,3,2021-03-20,5946,10,202685,82,2021-03-20,1616194800.0
14292,84,3,2021-03-21,455,1,203140,83,2021-03-21,1616281200.0
14293,84,3,2021-03-22,3985,3,207125,86,2021-03-22,1616367600.0
14294,84,3,2021-03-23,10788,7,217913,93,2021-03-23,1616454000.0
14295,84,3,2021-03-24,10189,4,228102,97,2021-03-24,1616540400.0
14296,84,3,2021-03-25,17992,21,246094,118,2021-03-25,1616626800.0
14297,84,3,2021-03-26,20177,19,266271,137,2021-03-26,1616713200.0
14298,84,3,2021-03-27,6171,12,272442,149,2021-03-27,1616799600.0
14299,84,3,2021-03-28,348,14,272790,163,2021-03-28,1616886000.0
14300,84,3,2021-03-29,6775,1,279565,164,2021-03-29,1616972400.0
14301,84,3,2021-03-30,13224,19,292789,183,2021-03-30,1617058800.0
14302,84,3,2021-03-31,7977,11,300766,194,2021-03-31,1617145200.0
14303,84,3,2021-04-01,11696,15,312462,209,2021-04-01,1617231600.0
14304,84,3,2021-04-02,12390,9,324852,218,2021-04-02,1617318000.0
14305,84,3,2021-04-03,3314,13,328166,231,2021-04-03,1617404400.0
14306,84,3,2021-04-04,74,10,328240,241,2021-04-04,1617490800.0
14307,84,3,2021-04-05,252,2,328492,243,2021-04-05,1617577200.0
14308,84,3,2021-04-06,4181,3,332673,246,2021-04-06,1617663600.0
14309,84,3,2021-04-07,3923,3,336596,249,2021-04-07,1617750000.0
14310,84,3,2021-04-08,10687,51,347283,300,2021-04-08,1617836400.0
14311,84,3,2021-04-09,20901,59,368184,359,2021-04-09,1617922800.0
14312,84,3,2021-04-10,6579,61,374763,420,2021-04-10,1618009200.0
14313,84,3,2021-04-11,396,18,375159,438,2021-04-11,1618095600.0
14314,84,3,2021-04-12,5600,23,380759,461,2021-04-12,1618185600.0
14315,84,3,2021-04-13,10093,70,390852,531,2021-04-13,1618272000.0
14316,84,3,2021-04-14,7371,24,398223,555,2021-04-14,1618358400.0
14317,84,3,2021-04-15,10671,29,408894,584,2021-04-15,1618444800.0
14318,84,3,2021-04-16,12328,83,421222,667,2021-04-16,1618531200.0
14319,84,3,2021-04-17,4210,79,425432,746,2021-04-17,1618617600.0
14320,84,3,2021-04-18,337,1,425769,747,2021-04-18,1618704000.0
14321,84,3,2021-04-19,3069,34,428838,781,2021-04-19,1618790400.0
14322,84,3,2021-04-20,5444,71,434282,852,2021-04-20,1618876800.0
14323,84,3,2021-04-21,4035,35,438317,887,2021-04-21,1618963200.0
14324,84,3,2021-04-22,5727,115,444044,1002,2021-04-22,1619049600.0
14325,84,3,2021-04-23,7567,149,451611,1151,2021-04-23,1619136000.0
14326,84,3,2021-04-24,2901,107,454512,1258,2021-04-24,1619222400.0
14327,84,3,2021-04-25,106,8,454618,1266,2021-04-25,1619308800.0
14328,84,3,2021-04-26,1922,118,456540,1384,2021-04-26,1619395200.0
14329,84,3,2021-04-27,4295,169,460835,1553,2021-04-27,1619481600.0
14330,84,3,2021-04-28,2889,161,463724,1714,2021-04-28,1619568000.0
14331,84,3,2021-04-29,4892,745,468616,2459,2021-04-29,1619654400.0
14332,84,3,2021-04-30,6238,1203,474854,3662,2021-04-30,1619740800.0
14333,84,3,2021-05-01,721,192,475575,3854,2021-05-01,1619827200.0
14334,84,3,2021-05-02,94,34,475669,3888,2021-05-02,1619913600.0
14335,84,3,2021-05-03,1334,533,477003,4421,2021-05-03,1620000000.0
14336,84,3,2021-05-04,2736,1308,479739,5729,2021-05-04,1620086400.0
14337,84,3,2021-05-05,2141,1266,481880,6995,2021-05-05,1620172800.0
14338,84,3,2021-05-06,3207,2526,485087,9521,2021-05-06,1620259200.0
14339,84,3,2021-05-07,4646,3871,489733,13392,2021-05-07,1620345600.0
14340,84,3,2021-05-08,520,804,490253,14196,2021-05-08,1620432000.0
14341,84,3,2021-05-09,103,137,490356,14333,2021-05-09,1620518400.0
14342,84,3,2021-05-10,1351,1829,491707,16162,2021-05-10,1620604800.0
14343,84,3,2021-05-11,2579,3399,494286,19561,2021-05-11,1620691200.0
14344,84,3,2021-05-12,1686,3507,495972,23068,2021-05-12,1620777600.0
14345,84,3,2021-05-13,154,182,496126,23250,2021-05-13,1620864000.0
14346,84,3,2021-05-14,1067,2583,497193,25833,2021-05-14,1620950400.0
14347,84,3,2021-05-15,485,1699,497678,27532,2021-05-15,1621036800.0
14348,84,3,2021-05-16,53,195,497731,27727,2021-05-16,1621123200.0
14349,84,3,2021-05-17,810,2760,498541,30487,2021-05-17,1621206000.0
14350,84,3,2021-05-18,1223,4107,499764,34594,2021-05-18,1621292400.0
14351,84,3,2021-05-19,734,3688,500498,38282,2021-05-19,1621378800.0
14352,84,3,2021-05-20,1154,6647,501652,44929,2021-05-20,1621465200.0
14353,84,3,2021-05-21,993,8433,502645,53362,2021-05-21,1621551600.0
14354,84,3,2021-05-22,347,3223,502992,56585,2021-05-22,1621638000.0
14355,84,3,2021-05-23,7,62,502999,56647,2021-05-23,1621724400.0
14356,84,3,2021-05-24,31,323,503030,56970,2021-05-24,1621810800.0
14357,84,3,2021-05-25,477,6333,503507,63303,2021-05-25,1621897200.0
14358,84,3,2021-05-26,406,6067,503913,69370,2021-05-26,1621983600.0
14359,84,3,2021-05-27,559,9585,504472,78955,2021-05-27,1622070000.0
14360,84,3,2021-05-28,705,13368,505177,92323,2021-05-28,1622156400.0
14361,84,3,2021-05-29,284,6401,505461,98724,2021-05-29,1622242800.0
14362,84,3,2021-05-30,30,677,505491,99401,2021-05-30,1622329200.0
14363,84,3,2021-05-31,195,4177,505686,103578,2021-05-31,1622415600.0
14364,84,3,2021-06-01,344,8419,506030,111997,2021-06-01,1622502000.0
14365,84,3,2021-06-02,210,6881,506240,118878,2021-06-02,1622588400.0
14366,84,3,2021-06-03,310,11330,506550,130208,2021-06-03,1622674800.0
14367,84,3,2021-06-04,413,13729,506963,143937,2021-06-04,1622761200.0
14368,84,3,2021-06-05,158,4289,507121,148226,2021-06-05,1622847600.0
14369,84,3,2021-06-06,7,277,507128,148503,2021-06-06,1622934000.0
14370,84,3,2021-06-07,92,3819,507220,152322,2021-06-07,1623020400.0
14371,84,3,2021-06-08,199,6498,507419,158820,2021-06-08,1623106800.0
14372,84,3,2021-06-09,153,5240,507572,164060,2021-06-09,1623193200.0
14373,84,3,2021-06-10,180,8168,507752,172228,2021-06-10,1623279600.0
14374,84,3,2021-06-11,225,12517,507977,184745,2021-06-11,1623366000.0
14375,84,3,2021-06-12,57,3295,508034,188040,2021-06-12,1623452400.0
14376,84,3,2021-06-13,3,247,508037,188287,2021-06-13,1623538800.0
14377,84,3,2021-06-14,75,4681,508112,192968,2021-06-14,1623625200.0
14378,84,3,2021-06-15,122,9777,508234,202745,2021-06-15,1623711600.0
14379,84,3,2021-06-16,103,6969,508337,209714,2021-06-16,1623798000.0
14380,84,3,2021-06-17,133,12274,508470,221988,2021-06-17,1623884400.0
14381,84,3,2021-06-18,193,14128,508663,236116,2021-06-18,1623970800.0
14382,84,3,2021-06-19,89,3645,508752,239761,2021-06-19,1624057200.0
14383,84,3,2021-06-20,3,179,508755,239940,2021-06-20,1624143600.0
14384,84,3,2021-06-21,50,4694,508805,244634,2021-06-21,1624230000.0
14385,84,3,2021-06-22,87,9055,508892,253689,2021-06-22,1624316400.0
14386,84,3,2021-06-23,76,5618,508968,259307,2021-06-23,1624402800.0
14387,84,3,2021-06-24,120,9823,509088,269130,2021-06-24,1624489200.0
14388,84,3,2021-06-25,123,11018,509211,280148,2021-06-25,1624575600.0
14389,84,3,2021-06-26,42,2601,509253,282749,2021-06-26,1624662000.0
14390,84,3,2021-06-27,4,251,509257,283000,2021-06-27,1624748400.0
14391,84,3,2021-06-28,35,3257,509292,286257,2021-06-28,1624834800.0
14392,84,3,2021-06-29,81,6426,509373,292683,2021-06-29,1624921200.0
14393,84,3,2021-06-30,64,4795,509437,297478,2021-06-30,1625007600.0
14394,84,3,2021-07-01,91,7968,509528,305446,2021-07-01,1625094000.0
14395,84,3,2021-07-02,136,10325,509664,315771,2021-07-02,1625180400.0
14396,84,3,2021-07-03,38,2305,509702,318076,2021-07-03,1625266800.0
14397,84,3,2021-07-04,4,257,509706,318333,2021-07-04,1625353200.0
14398,84,3,2021-07-05,39,3549,509745,321882,2021-07-05,1625439600.0
14399,84,3,2021-07-06,99,6467,509844,328349,2021-07-06,1625526000.0
14400,84,4,2020-12-27,0,0,0,0,2020-12-27,1609023600.0
14401,84,4,2020-12-28,0,0,0,0,2020-12-28,1609110000.0
14402,84,4,2020-12-29,0,0,0,0,2020-12-29,1609196400.0
14403,84,4,2020-12-30,0,0,0,0,2020-12-30,1609282800.0
14404,84,4,2020-12-31,0,0,0,0,2020-12-31,1609369200.0
14405,84,4,2021-01-01,0,0,0,0,2021-01-01,1609455600.0
14406,84,4,2021-01-02,0,0,0,0,2021-01-02,1609542000.0
14407,84,4,2021-01-03,0,0,0,0,2021-01-03,1609628400.0
14408,84,4,2021-01-04,0,0,0,0,2021-01-04,1609714800.0
14409,84,4,2021-01-05,0,0,0,0,2021-01-05,1609801200.0
14410,84,4,2021-01-06,0,0,0,0,2021-01-06,1609887600.0
14411,84,4,2021-01-07,0,0,0,0,2021-01-07,1609974000.0
14412,84,4,2021-01-08,0,0,0,0,2021-01-08,1610060400.0
14413,84,4,2021-01-09,0,0,0,0,2021-01-09,1610146800.0
14414,84,4,2021-01-10,0,0,0,0,2021-01-10,1610233200.0
14415,84,4,2021-01-11,0,0,0,0,2021-01-11,1610319600.0
14416,84,4,2021-01-12,0,0,0,0,2021-01-12,1610406000.0
14417,84,4,2021-01-13,0,0,0,0,2021-01-13,1610492400.0
14418,84,4,2021-01-14,0,0,0,0,2021-01-14,1610578800.0
14419,84,4,2021-01-15,0,0,0,0,2021-01-15,1610665200.0
14420,84,4,2021-01-16,0,0,0,0,2021-01-16,1610751600.0
14421,84,4,2021-01-17,0,0,0,0,2021-01-17,1610838000.0
14422,84,4,2021-01-18,0,0,0,0,2021-01-18,1610924400.0
14423,84,4,2021-01-19,0,0,0,0,2021-01-19,1611010800.0
14424,84,4,2021-01-20,0,0,0,0,2021-01-20,1611097200.0
14425,84,4,2021-01-21,0,0,0,0,2021-01-21,1611183600.0
14426,84,4,2021-01-22,0,0,0,0,2021-01-22,1611270000.0
14427,84,4,2021-01-23,0,0,0,0,2021-01-23,1611356400.0
14428,84,4,2021-01-24,0,0,0,0,2021-01-24,1611442800.0
14429,84,4,2021-01-25,0,0,0,0,2021-01-25,1611529200.0
14430,84,4,2021-01-26,0,0,0,0,2021-01-26,1611615600.0
14431,84,4,2021-01-27,0,0,0,0,2021-01-27,1611702000.0
14432,84,4,2021-01-28,0,0,0,0,2021-01-28,1611788400.0
14433,84,4,2021-01-29,0,0,0,0,2021-01-29,1611874800.0
14434,84,4,2021-01-30,0,0,0,0,2021-01-30,1611961200.0
14435,84,4,2021-01-31,0,0,0,0,2021-01-31,1612047600.0
14436,84,4,2021-02-01,0,0,0,0,2021-02-01,1612134000.0
14437,84,4,2021-02-02,0,0,0,0,2021-02-02,1612220400.0
14438,84,4,2021-02-03,0,0,0,0,2021-02-03,1612306800.0
14439,84,4,2021-02-04,0,0,0,0,2021-02-04,1612393200.0
14440,84,4,2021-02-05,0,0,0,0,2021-02-05,1612479600.0
14441,84,4,2021-02-06,0,0,0,0,2021-02-06,1612566000.0
14442,84,4,2021-02-07,0,0,0,0,2021-02-07,1612652400.0
14443,84,4,2021-02-08,0,0,0,0,2021-02-08,1612738800.0
14444,84,4,2021-02-09,0,0,0,0,2021-02-09,1612825200.0
14445,84,4,2021-02-10,0,0,0,0,2021-02-10,1612911600.0
14446,84,4,2021-02-11,0,0,0,0,2021-02-11,1612998000.0
14447,84,4,2021-02-12,0,0,0,0,2021-02-12,1613084400.0
14448,84,4,2021-02-13,0,0,0,0,2021-02-13,1613170800.0
14449,84,4,2021-02-14,0,0,0,0,2021-02-14,1613257200.0
14450,84,4,2021-02-15,0,0,0,0,2021-02-15,1613343600.0
14451,84,4,2021-02-16,0,0,0,0,2021-02-16,1613430000.0
14452,84,4,2021-02-17,0,0,0,0,2021-02-17,1613516400.0
14453,84,4,2021-02-18,0,0,0,0,2021-02-18,1613602800.0
14454,84,4,2021-02-19,0,0,0,0,2021-02-19,1613689200.0
14455,84,4,2021-02-20,0,0,0,0,2021-02-20,1613775600.0
14456,84,4,2021-02-21,0,0,0,0,2021-02-21,1613862000.0
14457,84,4,2021-02-22,0,0,0,0,2021-02-22,1613948400.0
14458,84,4,2021-02-23,0,0,0,0,2021-02-23,1614034800.0
14459,84,4,2021-02-24,0,0,0,0,2021-02-24,1614121200.0
14460,84,4,2021-02-25,0,0,0,0,2021-02-25,1614207600.0
14461,84,4,2021-02-26,0,0,0,0,2021-02-26,1614294000.0
14462,84,4,2021-02-27,0,0,0,0,2021-02-27,1614380400.0
14463,84,4,2021-02-28,0,0,0,0,2021-02-28,1614466800.0
14464,84,4,2021-03-01,0,0,0,0,2021-03-01,1614553200.0
14465,84,4,2021-03-02,0,0,0,0,2021-03-02,1614639600.0
14466,84,4,2021-03-03,0,0,0,0,2021-03-03,1614726000.0
14467,84,4,2021-03-04,0,0,0,0,2021-03-04,1614812400.0
14468,84,4,2021-03-05,0,0,0,0,2021-03-05,1614898800.0
14469,84,4,2021-03-06,0,0,0,0,2021-03-06,1614985200.0
14470,84,4,2021-03-07,0,0,0,0,2021-03-07,1615071600.0
14471,84,4,2021-03-08,0,0,0,0,2021-03-08,1615158000.0
14472,84,4,2021-03-09,0,0,0,0,2021-03-09,1615244400.0
14473,84,4,2021-03-10,0,0,0,0,2021-03-10,1615330800.0
14474,84,4,2021-03-11,0,0,0,0,2021-03-11,1615417200.0
14475,84,4,2021-03-12,0,0,0,0,2021-03-12,1615503600.0
14476,84,4,2021-03-13,0,0,0,0,2021-03-13,1615590000.0
14477,84,4,2021-03-14,0,0,0,0,2021-03-14,1615676400.0
14478,84,4,2021-03-15,0,0,0,0,2021-03-15,1615762800.0
14479,84,4,2021-03-16,0,0,0,0,2021-03-16,1615849200.0
14480,84,4,2021-03-17,0,0,0,0,2021-03-17,1615935600.0
14481,84,4,2021-03-18,0,0,0,0,2021-03-18,1616022000.0
14482,84,4,2021-03-19,0,0,0,0,2021-03-19,1616108400.0
14483,84,4,2021-03-20,0,0,0,0,2021-03-20,1616194800.0
14484,84,4,2021-03-21,0,0,0,0,2021-03-21,1616281200.0
14485,84,4,2021-03-22,0,0,0,0,2021-03-22,1616367600.0
14486,84,4,2021-03-23,0,0,0,0,2021-03-23,1616454000.0
14487,84,4,2021-03-24,0,0,0,0,2021-03-24,1616540400.0
14488,84,4,2021-03-25,0,0,0,0,2021-03-25,1616626800.0
14489,84,4,2021-03-26,0,0,0,0,2021-03-26,1616713200.0
14490,84,4,2021-03-27,0,0,0,0,2021-03-27,1616799600.0
14491,84,4,2021-03-28,0,0,0,0,2021-03-28,1616886000.0
14492,84,4,2021-03-29,0,0,0,0,2021-03-29,1616972400.0
14493,84,4,2021-03-30,0,0,0,0,2021-03-30,1617058800.0
14494,84,4,2021-03-31,0,0,0,0,2021-03-31,1617145200.0
14495,84,4,2021-04-01,0,0,0,0,2021-04-01,1617231600.0
14496,84,4,2021-04-02,0,0,0,0,2021-04-02,1617318000.0
14497,84,4,2021-04-03,0,0,0,0,2021-04-03,1617404400.0
14498,84,4,2021-04-04,0,0,0,0,2021-04-04,1617490800.0
14499,84,4,2021-04-05,0,0,0,0,2021-04-05,1617577200.0
14500,84,4,2021-04-06,0,0,0,0,2021-04-06,1617663600.0
14501,84,4,2021-04-07,0,0,0,0,2021-04-07,1617750000.0
14502,84,4,2021-04-08,0,0,0,0,2021-04-08,1617836400.0
14503,84,4,2021-04-09,0,0,0,0,2021-04-09,1617922800.0
14504,84,4,2021-04-10,0,0,0,0,2021-04-10,1618009200.0
14505,84,4,2021-04-11,0,0,0,0,2021-04-11,1618095600.0
14506,84,4,2021-04-12,0,0,0,0,2021-04-12,1618185600.0
14507,84,4,2021-04-13,0,0,0,0,2021-04-13,1618272000.0
14508,84,4,2021-04-14,0,0,0,0,2021-04-14,1618358400.0
14509,84,4,2021-04-15,0,0,0,0,2021-04-15,1618444800.0
14510,84,4,2021-04-16,0,0,0,0,2021-04-16,1618531200.0
14511,84,4,2021-04-17,0,0,0,0,2021-04-17,1618617600.0
14512,84,4,2021-04-18,0,0,0,0,2021-04-18,1618704000.0
14513,84,4,2021-04-19,0,0,0,0,2021-04-19,1618790400.0
14514,84,4,2021-04-20,0,0,0,0,2021-04-20,1618876800.0
14515,84,4,2021-04-21,0,0,0,0,2021-04-21,1618963200.0
14516,84,4,2021-04-22,0,0,0,0,2021-04-22,1619049600.0
14517,84,4,2021-04-23,90,0,90,0,2021-04-23,1619136000.0
14518,84,4,2021-04-24,80,0,170,0,2021-04-24,1619222400.0
14519,84,4,2021-04-25,0,0,170,0,2021-04-25,1619308800.0
14520,84,4,2021-04-26,245,0,415,0,2021-04-26,1619395200.0
14521,84,4,2021-04-27,1041,0,1456,0,2021-04-27,1619481600.0
14522,84,4,2021-04-28,1053,0,2509,0,2021-04-28,1619568000.0
14523,84,4,2021-04-29,1777,2,4286,2,2021-04-29,1619654400.0
14524,84,4,2021-04-30,2492,2,6778,4,2021-04-30,1619740800.0
14525,84,4,2021-05-01,112,0,6890,4,2021-05-01,1619827200.0
14526,84,4,2021-05-02,28,0,6918,4,2021-05-02,1619913600.0
14527,84,4,2021-05-03,606,1,7524,5,2021-05-03,1620000000.0
14528,84,4,2021-05-04,1181,3,8705,8,2021-05-04,1620086400.0
14529,84,4,2021-05-05,678,0,9383,8,2021-05-05,1620172800.0
14530,84,4,2021-05-06,1425,1,10808,9,2021-05-06,1620259200.0
14531,84,4,2021-05-07,2181,1,12989,10,2021-05-07,1620345600.0
14532,84,4,2021-05-08,237,1,13226,11,2021-05-08,1620432000.0
14533,84,4,2021-05-09,56,0,13282,11,2021-05-09,1620518400.0
14534,84,4,2021-05-10,833,1,14115,12,2021-05-10,1620604800.0
14535,84,4,2021-05-11,1773,1,15888,13,2021-05-11,1620691200.0
14536,84,4,2021-05-12,997,1,16885,14,2021-05-12,1620777600.0
14537,84,4,2021-05-13,119,0,17004,14,2021-05-13,1620864000.0
14538,84,4,2021-05-14,740,1,17744,15,2021-05-14,1620950400.0
14539,84,4,2021-05-15,182,0,17926,15,2021-05-15,1621036800.0
14540,84,4,2021-05-16,24,0,17950,15,2021-05-16,1621123200.0
14541,84,4,2021-05-17,398,0,18348,15,2021-05-17,1621206000.0
14542,84,4,2021-05-18,871,1,19219,16,2021-05-18,1621292400.0
14543,84,4,2021-05-19,571,0,19790,16,2021-05-19,1621378800.0
14544,84,4,2021-05-20,873,0,20663,16,2021-05-20,1621465200.0
14545,84,4,2021-05-21,1186,7,21849,23,2021-05-21,1621551600.0
14546,84,4,2021-05-22,363,3,22212,26,2021-05-22,1621638000.0
14547,84,4,2021-05-23,20,0,22232,26,2021-05-23,1621724400.0
14548,84,4,2021-05-24,69,0,22301,26,2021-05-24,1621810800.0
14549,84,4,2021-05-25,770,1,23071,27,2021-05-25,1621897200.0
14550,84,4,2021-05-26,790,1,23861,28,2021-05-26,1621983600.0
14551,84,4,2021-05-27,1267,3,25128,31,2021-05-27,1622070000.0
14552,84,4,2021-05-28,2702,10,27830,41,2021-05-28,1622156400.0
14553,84,4,2021-05-29,823,1,28653,42,2021-05-29,1622242800.0
14554,84,4,2021-05-30,66,0,28719,42,2021-05-30,1622329200.0
14555,84,4,2021-05-31,1332,7,30051,49,2021-05-31,1622415600.0
14556,84,4,2021-06-01,2399,4,32450,53,2021-06-01,1622502000.0
14557,84,4,2021-06-02,1495,0,33945,53,2021-06-02,1622588400.0
14558,84,4,2021-06-03,2174,7,36119,60,2021-06-03,1622674800.0
14559,84,4,2021-06-04,2300,11,38419,71,2021-06-04,1622761200.0
14560,84,4,2021-06-05,671,4,39090,75,2021-06-05,1622847600.0
14561,84,4,2021-06-06,52,0,39142,75,2021-06-06,1622934000.0
14562,84,4,2021-06-07,910,1,40052,76,2021-06-07,1623020400.0
14563,84,4,2021-06-08,1485,1,41537,77,2021-06-08,1623106800.0
14564,84,4,2021-06-09,1149,2,42686,79,2021-06-09,1623193200.0
14565,84,4,2021-06-10,1456,3,44142,82,2021-06-10,1623279600.0
14566,84,4,2021-06-11,1519,6,45661,88,2021-06-11,1623366000.0
14567,84,4,2021-06-12,536,4,46197,92,2021-06-12,1623452400.0
14568,84,4,2021-06-13,40,0,46237,92,2021-06-13,1623538800.0
14569,84,4,2021-06-14,510,4,46747,96,2021-06-14,1623625200.0
14570,84,4,2021-06-15,963,3,47710,99,2021-06-15,1623711600.0
14571,84,4,2021-06-16,747,2,48457,101,2021-06-16,1623798000.0
14572,84,4,2021-06-17,1013,2,49470,103,2021-06-17,1623884400.0
14573,84,4,2021-06-18,1153,12,50623,115,2021-06-18,1623970800.0
14574,84,4,2021-06-19,364,2,50987,117,2021-06-19,1624057200.0
14575,84,4,2021-06-20,31,0,51018,117,2021-06-20,1624143600.0
14576,84,4,2021-06-21,451,1,51469,118,2021-06-21,1624230000.0
14577,84,4,2021-06-22,736,1,52205,119,2021-06-22,1624316400.0
14578,84,4,2021-06-23,675,3,52880,122,2021-06-23,1624402800.0
14579,84,4,2021-06-24,766,0,53646,122,2021-06-24,1624489200.0
14580,84,4,2021-06-25,1073,10,54719,132,2021-06-25,1624575600.0
14581,84,4,2021-06-26,316,3,55035,135,2021-06-26,1624662000.0
14582,84,4,2021-06-27,27,0,55062,135,2021-06-27,1624748400.0
14583,84,4,2021-06-28,396,1,55458,136,2021-06-28,1624834800.0
14584,84,4,2021-06-29,642,0,56100,136,2021-06-29,1624921200.0
14585,84,4,2021-06-30,498,2,56598,138,2021-06-30,1625007600.0
14586,84,4,2021-07-01,734,0,57332,138,2021-07-01,1625094000.0
14587,84,4,2021-07-02,878,1,58210,139,2021-07-02,1625180400.0
14588,84,4,2021-07-03,327,2,58537,141,2021-07-03,1625266800.0
14589,84,4,2021-07-04,16,0,58553,141,2021-07-04,1625353200.0
14590,84,4,2021-07-05,420,0,58973,141,2021-07-05,1625439600.0
14591,84,4,2021-07-06,677,3,59650,144,2021-07-06,1625526000.0
14592,93,1,2020-12-27,1,0,1,0,2020-12-27,1609023600.0
14593,93,1,2020-12-28,2,0,3,0,2020-12-28,1609110000.0
14594,93,1,2020-12-29,1,0,4,0,2020-12-29,1609196400.0
14595,93,1,2020-12-30,3,0,7,0,2020-12-30,1609282800.0
14596,93,1,2020-12-31,19,0,26,0,2020-12-31,1609369200.0
14597,93,1,2021-01-01,13,0,39,0,2021-01-01,1609455600.0
14598,93,1,2021-01-02,3,0,42,0,2021-01-02,1609542000.0
14599,93,1,2021-01-03,3,0,45,0,2021-01-03,1609628400.0
14600,93,1,2021-01-04,133,0,178,0,2021-01-04,1609714800.0
14601,93,1,2021-01-05,251,0,429,0,2021-01-05,1609801200.0
14602,93,1,2021-01-06,412,0,841,0,2021-01-06,1609887600.0
14603,93,1,2021-01-07,1245,0,2086,0,2021-01-07,1609974000.0
14604,93,1,2021-01-08,1566,0,3652,0,2021-01-08,1610060400.0
14605,93,1,2021-01-09,542,0,4194,0,2021-01-09,1610146800.0
14606,93,1,2021-01-10,74,0,4268,0,2021-01-10,1610233200.0
14607,93,1,2021-01-11,2414,0,6682,0,2021-01-11,1610319600.0
14608,93,1,2021-01-12,5094,0,11776,0,2021-01-12,1610406000.0
14609,93,1,2021-01-13,4473,0,16249,0,2021-01-13,1610492400.0
14610,93,1,2021-01-14,5565,0,21814,0,2021-01-14,1610578800.0
14611,93,1,2021-01-15,4937,0,26751,0,2021-01-15,1610665200.0
14612,93,1,2021-01-16,1659,2,28410,2,2021-01-16,1610751600.0
14613,93,1,2021-01-17,302,1,28712,3,2021-01-17,1610838000.0
14614,93,1,2021-01-18,6728,22,35440,25,2021-01-18,1610924400.0
14615,93,1,2021-01-19,12311,15,47751,40,2021-01-19,1611010800.0
14616,93,1,2021-01-20,11115,13,58866,53,2021-01-20,1611097200.0
14617,93,1,2021-01-21,11143,19,70009,72,2021-01-21,1611183600.0
14618,93,1,2021-01-22,9124,8,79133,80,2021-01-22,1611270000.0
14619,93,1,2021-01-23,3046,1,82179,81,2021-01-23,1611356400.0
14620,93,1,2021-01-24,489,0,82668,81,2021-01-24,1611442800.0
14621,93,1,2021-01-25,6452,17,89120,98,2021-01-25,1611529200.0
14622,93,1,2021-01-26,9159,114,98279,212,2021-01-26,1611615600.0
14623,93,1,2021-01-27,9054,267,107333,479,2021-01-27,1611702000.0
14624,93,1,2021-01-28,13121,776,120454,1255,2021-01-28,1611788400.0
14625,93,1,2021-01-29,9403,942,129857,2197,2021-01-29,1611874800.0
14626,93,1,2021-01-30,2165,151,132022,2348,2021-01-30,1611961200.0
14627,93,1,2021-01-31,304,5,132326,2353,2021-01-31,1612047600.0
14628,93,1,2021-02-01,4651,1505,136977,3858,2021-02-01,1612134000.0
14629,93,1,2021-02-02,5866,2356,142843,6214,2021-02-02,1612220400.0
14630,93,1,2021-02-03,4190,1803,147033,8017,2021-02-03,1612306800.0
14631,93,1,2021-02-04,4699,3150,151732,11167,2021-02-04,1612393200.0
14632,93,1,2021-02-05,5400,4105,157132,15272,2021-02-05,1612479600.0
14633,93,1,2021-02-06,1030,968,158162,16240,2021-02-06,1612566000.0
14634,93,1,2021-02-07,279,81,158441,16321,2021-02-07,1612652400.0
14635,93,1,2021-02-08,3486,3727,161927,20048,2021-02-08,1612738800.0
14636,93,1,2021-02-09,5076,7078,167003,27126,2021-02-09,1612825200.0
14637,93,1,2021-02-10,5119,5836,172122,32962,2021-02-10,1612911600.0
14638,93,1,2021-02-11,5675,6674,177797,39636,2021-02-11,1612998000.0
14639,93,1,2021-02-12,4771,6436,182568,46072,2021-02-12,1613084400.0
14640,93,1,2021-02-13,901,1424,183469,47496,2021-02-13,1613170800.0
14641,93,1,2021-02-14,73,384,183542,47880,2021-02-14,1613257200.0
14642,93,1,2021-02-15,1615,5186,185157,53066,2021-02-15,1613343600.0
14643,93,1,2021-02-16,2469,6859,187626,59925,2021-02-16,1613430000.0
14644,93,1,2021-02-17,2641,7651,190267,67576,2021-02-17,1613516400.0
14645,93,1,2021-02-18,4569,10269,194836,77845,2021-02-18,1613602800.0
14646,93,1,2021-02-19,4192,7604,199028,85449,2021-02-19,1613689200.0
14647,93,1,2021-02-20,580,1444,199608,86893,2021-02-20,1613775600.0
14648,93,1,2021-02-21,68,416,199676,87309,2021-02-21,1613862000.0
14649,93,1,2021-02-22,1768,6113,201444,93422,2021-02-22,1613948400.0
14650,93,1,2021-02-23,2785,6397,204229,99819,2021-02-23,1614034800.0
14651,93,1,2021-02-24,3393,6116,207622,105935,2021-02-24,1614121200.0
14652,93,1,2021-02-25,5444,6014,213066,111949,2021-02-25,1614207600.0
14653,93,1,2021-02-26,4637,5580,217703,117529,2021-02-26,1614294000.0
14654,93,1,2021-02-27,1046,1385,218749,118914,2021-02-27,1614380400.0
14655,93,1,2021-02-28,134,236,218883,119150,2021-02-28,1614466800.0
14656,93,1,2021-03-01,3509,3761,222392,122911,2021-03-01,1614553200.0
14657,93,1,2021-03-02,4579,5068,226971,127979,2021-03-02,1614639600.0
14658,93,1,2021-03-03,5514,5598,232485,133577,2021-03-03,1614726000.0
14659,93,1,2021-03-04,6967,5495,239452,139072,2021-03-04,1614812400.0
14660,93,1,2021-03-05,6008,5173,245460,144245,2021-03-05,1614898800.0
14661,93,1,2021-03-06,8555,873,254015,145118,2021-03-06,1614985200.0
14662,93,1,2021-03-07,7280,430,261295,145548,2021-03-07,1615071600.0
14663,93,1,2021-03-08,6086,4385,267381,149933,2021-03-08,1615158000.0
14664,93,1,2021-03-09,7578,4681,274959,154614,2021-03-09,1615244400.0
14665,93,1,2021-03-10,7537,4346,282496,158960,2021-03-10,1615330800.0
14666,93,1,2021-03-11,9378,5034,291874,163994,2021-03-11,1615417200.0
14667,93,1,2021-03-12,9863,4216,301737,168210,2021-03-12,1615503600.0
14668,93,1,2021-03-13,15288,790,317025,169000,2021-03-13,1615590000.0
14669,93,1,2021-03-14,4874,204,321899,169204,2021-03-14,1615676400.0
14670,93,1,2021-03-15,9915,2382,331814,171586,2021-03-15,1615762800.0
14671,93,1,2021-03-16,10895,2981,342709,174567,2021-03-16,1615849200.0
14672,93,1,2021-03-17,12359,3674,355068,178241,2021-03-17,1615935600.0
14673,93,1,2021-03-18,15029,3561,370097,181802,2021-03-18,1616022000.0
14674,93,1,2021-03-19,13865,3320,383962,185122,2021-03-19,1616108400.0
14675,93,1,2021-03-20,6227,934,390189,186056,2021-03-20,1616194800.0
14676,93,1,2021-03-21,2323,81,392512,186137,2021-03-21,1616281200.0
14677,93,1,2021-03-22,11254,2882,403766,189019,2021-03-22,1616367600.0
14678,93,1,2021-03-23,14066,3001,417832,192020,2021-03-23,1616454000.0
14679,93,1,2021-03-24,13722,4712,431554,196732,2021-03-24,1616540400.0
14680,93,1,2021-03-25,16922,5308,448476,202040,2021-03-25,1616626800.0
14681,93,1,2021-03-26,16724,4000,465200,206040,2021-03-26,1616713200.0
14682,93,1,2021-03-27,7128,1199,472328,207239,2021-03-27,1616799600.0
14683,93,1,2021-03-28,2731,49,475059,207288,2021-03-28,1616886000.0
14684,93,1,2021-03-29,12671,4210,487730,211498,2021-03-29,1616972400.0
14685,93,1,2021-03-30,19841,5582,507571,217080,2021-03-30,1617058800.0
14686,93,1,2021-03-31,20346,5511,527917,222591,2021-03-31,1617145200.0
14687,93,1,2021-04-01,20376,6150,548293,228741,2021-04-01,1617231600.0
14688,93,1,2021-04-02,16522,7323,564815,236064,2021-04-02,1617318000.0
14689,93,1,2021-04-03,6651,4650,571466,240714,2021-04-03,1617404400.0
14690,93,1,2021-04-04,1616,1206,573082,241920,2021-04-04,1617490800.0
14691,93,1,2021-04-05,4320,1329,577402,243249,2021-04-05,1617577200.0
14692,93,1,2021-04-06,18070,8946,595472,252195,2021-04-06,1617663600.0
14693,93,1,2021-04-07,22113,10563,617585,262758,2021-04-07,1617750000.0
14694,93,1,2021-04-08,22402,13566,639987,276324,2021-04-08,1617836400.0
14695,93,1,2021-04-09,24324,12352,664311,288676,2021-04-09,1617922800.0
14696,93,1,2021-04-10,11186,7448,675497,296124,2021-04-10,1618009200.0
14697,93,1,2021-04-11,3147,2762,678644,298886,2021-04-11,1618095600.0
14698,93,1,2021-04-12,15985,10679,694629,309565,2021-04-12,1618185600.0
14699,93,1,2021-04-13,19169,12408,713798,321973,2021-04-13,1618272000.0
14700,93,1,2021-04-14,20000,13443,733798,335416,2021-04-14,1618358400.0
14701,93,1,2021-04-15,20078,13139,753876,348555,2021-04-15,1618444800.0
14702,93,1,2021-04-16,20662,13595,774538,362150,2021-04-16,1618531200.0
14703,93,1,2021-04-17,9899,6380,784437,368530,2021-04-17,1618617600.0
14704,93,1,2021-04-18,4641,2400,789078,370930,2021-04-18,1618704000.0
14705,93,1,2021-04-19,16269,13602,805347,384532,2021-04-19,1618790400.0
14706,93,1,2021-04-20,17722,16290,823069,400822,2021-04-20,1618876800.0
14707,93,1,2021-04-21,18592,16045,841661,416867,2021-04-21,1618963200.0
14708,93,1,2021-04-22,21877,16665,863538,433532,2021-04-22,1619049600.0
14709,93,1,2021-04-23,21588,15116,885126,448648,2021-04-23,1619136000.0
14710,93,1,2021-04-24,9952,6922,895078,455570,2021-04-24,1619222400.0
14711,93,1,2021-04-25,2845,1785,897923,457355,2021-04-25,1619308800.0
14712,93,1,2021-04-26,14327,13611,912250,470966,2021-04-26,1619395200.0
14713,93,1,2021-04-27,16243,16582,928493,487548,2021-04-27,1619481600.0
14714,93,1,2021-04-28,17180,15982,945673,503530,2021-04-28,1619568000.0
14715,93,1,2021-04-29,22086,16163,967759,519693,2021-04-29,1619654400.0
14716,93,1,2021-04-30,21911,14048,989670,533741,2021-04-30,1619740800.0
14717,93,1,2021-05-01,10572,3836,1000242,537577,2021-05-01,1619827200.0
14718,93,1,2021-05-02,3732,1499,1003974,539076,2021-05-02,1619913600.0
14719,93,1,2021-05-03,16656,14733,1020630,553809,2021-05-03,1620000000.0
14720,93,1,2021-05-04,17333,17781,1037963,571590,2021-05-04,1620086400.0
14721,93,1,2021-05-05,16342,17720,1054305,589310,2021-05-05,1620172800.0
14722,93,1,2021-05-06,20601,16432,1074906,605742,2021-05-06,1620259200.0
14723,93,1,2021-05-07,16425,18457,1091331,624199,2021-05-07,1620345600.0
14724,93,1,2021-05-08,12081,5094,1103412,629293,2021-05-08,1620432000.0
14725,93,1,2021-05-09,3075,1692,1106487,630985,2021-05-09,1620518400.0
14726,93,1,2021-05-10,15327,17583,1121814,648568,2021-05-10,1620604800.0
14727,93,1,2021-05-11,18538,18919,1140352,667487,2021-05-11,1620691200.0
14728,93,1,2021-05-12,24697,16137,1165049,683624,2021-05-12,1620777600.0
14729,93,1,2021-05-13,24389,4629,1189438,688253,2021-05-13,1620864000.0
14730,93,1,2021-05-14,29433,10550,1218871,698803,2021-05-14,1620950400.0
14731,93,1,2021-05-15,25179,6107,1244050,704910,2021-05-15,1621036800.0
14732,93,1,2021-05-16,11230,1459,1255280,706369,2021-05-16,1621123200.0
14733,93,1,2021-05-17,21405,12135,1276685,718504,2021-05-17,1621206000.0
14734,93,1,2021-05-18,25252,11082,1301937,729586,2021-05-18,1621292400.0
14735,93,1,2021-05-19,25015,9131,1326952,738717,2021-05-19,1621378800.0
14736,93,1,2021-05-20,27156,9150,1354108,747867,2021-05-20,1621465200.0
14737,93,1,2021-05-21,27030,9040,1381138,756907,2021-05-21,1621551600.0
14738,93,1,2021-05-22,15322,3777,1396460,760684,2021-05-22,1621638000.0
14739,93,1,2021-05-23,5317,1283,1401777,761967,2021-05-23,1621724400.0
14740,93,1,2021-05-24,15943,2702,1417720,764669,2021-05-24,1621810800.0
14741,93,1,2021-05-25,20481,11658,1438201,776327,2021-05-25,1621897200.0
14742,93,1,2021-05-26,20748,13564,1458949,789891,2021-05-26,1621983600.0
14743,93,1,2021-05-27,22947,12893,1481896,802784,2021-05-27,1622070000.0
14744,93,1,2021-05-28,18929,14428,1500825,817212,2021-05-28,1622156400.0
14745,93,1,2021-05-29,10831,6523,1511656,823735,2021-05-29,1622242800.0
14746,93,1,2021-05-30,2473,1849,1514129,825584,2021-05-30,1622329200.0
14747,93,1,2021-05-31,18624,12801,1532753,838385,2021-05-31,1622415600.0
14748,93,1,2021-06-01,20782,14583,1553535,852968,2021-06-01,1622502000.0
14749,93,1,2021-06-02,18957,15023,1572492,867991,2021-06-02,1622588400.0
14750,93,1,2021-06-03,23008,14132,1595500,882123,2021-06-03,1622674800.0
14751,93,1,2021-06-04,22005,15296,1617505,897419,2021-06-04,1622761200.0
14752,93,1,2021-06-05,14002,8477,1631507,905896,2021-06-05,1622847600.0
14753,93,1,2021-06-06,4616,1890,1636123,907786,2021-06-06,1622934000.0
14754,93,1,2021-06-07,15000,16401,1651123,924187,2021-06-07,1623020400.0
14755,93,1,2021-06-08,16756,15142,1667879,939329,2021-06-08,1623106800.0
14756,93,1,2021-06-09,17158,16621,1685037,955950,2021-06-09,1623193200.0
14757,93,1,2021-06-10,17487,14071,1702524,970021,2021-06-10,1623279600.0
14758,93,1,2021-06-11,15123,18185,1717647,988206,2021-06-11,1623366000.0
14759,93,1,2021-06-12,10992,9385,1728639,997591,2021-06-12,1623452400.0
14760,93,1,2021-06-13,2305,2525,1730944,1000116,2021-06-13,1623538800.0
14761,93,1,2021-06-14,11368,19717,1742312,1019833,2021-06-14,1623625200.0
14762,93,1,2021-06-15,13195,18839,1755507,1038672,2021-06-15,1623711600.0
14763,93,1,2021-06-16,14510,15781,1770017,1054453,2021-06-16,1623798000.0
14764,93,1,2021-06-17,13929,15282,1783946,1069735,2021-06-17,1623884400.0
14765,93,1,2021-06-18,12351,15319,1796297,1085054,2021-06-18,1623970800.0
14766,93,1,2021-06-19,8478,10110,1804775,1095164,2021-06-19,1624057200.0
14767,93,1,2021-06-20,2240,2714,1807015,1097878,2021-06-20,1624143600.0
14768,93,1,2021-06-21,8414,21336,1815429,1119214,2021-06-21,1624230000.0
14769,93,1,2021-06-22,9159,23578,1824588,1142792,2021-06-22,1624316400.0
14770,93,1,2021-06-23,9324,21448,1833912,1164240,2021-06-23,1624402800.0
14771,93,1,2021-06-24,9502,22989,1843414,1187229,2021-06-24,1624489200.0
14772,93,1,2021-06-25,8584,26253,1851998,1213482,2021-06-25,1624575600.0
14773,93,1,2021-06-26,5627,15698,1857625,1229180,2021-06-26,1624662000.0
14774,93,1,2021-06-27,1831,4626,1859456,1233806,2021-06-27,1624748400.0
14775,93,1,2021-06-28,6830,24756,1866286,1258562,2021-06-28,1624834800.0
14776,93,1,2021-06-29,7829,24820,1874115,1283382,2021-06-29,1624921200.0
14777,93,1,2021-06-30,8764,23817,1882879,1307199,2021-06-30,1625007600.0
14778,93,1,2021-07-01,10301,21320,1893180,1328519,2021-07-01,1625094000.0
14779,93,1,2021-07-02,9899,23371,1903079,1351890,2021-07-02,1625180400.0
14780,93,1,2021-07-03,6274,17246,1909353,1369136,2021-07-03,1625266800.0
14781,93,1,2021-07-04,1712,3811,1911065,1372947,2021-07-04,1625353200.0
14782,93,1,2021-07-05,8039,21694,1919104,1394641,2021-07-05,1625439600.0
14783,93,1,2021-07-06,9935,21807,1929039,1416448,2021-07-06,1625526000.0
14784,93,2,2020-12-27,0,0,0,0,2020-12-27,1609023600.0
14785,93,2,2020-12-28,0,0,0,0,2020-12-28,1609110000.0
14786,93,2,2020-12-29,0,0,0,0,2020-12-29,1609196400.0
14787,93,2,2020-12-30,0,0,0,0,2020-12-30,1609282800.0
14788,93,2,2020-12-31,0,0,0,0,2020-12-31,1609369200.0
14789,93,2,2021-01-01,0,0,0,0,2021-01-01,1609455600.0
14790,93,2,2021-01-02,0,0,0,0,2021-01-02,1609542000.0
14791,93,2,2021-01-03,0,0,0,0,2021-01-03,1609628400.0
14792,93,2,2021-01-04,0,0,0,0,2021-01-04,1609714800.0
14793,93,2,2021-01-05,0,0,0,0,2021-01-05,1609801200.0
14794,93,2,2021-01-06,0,0,0,0,2021-01-06,1609887600.0
14795,93,2,2021-01-07,0,0,0,0,2021-01-07,1609974000.0
14796,93,2,2021-01-08,0,0,0,0,2021-01-08,1610060400.0
14797,93,2,2021-01-09,0,0,0,0,2021-01-09,1610146800.0
14798,93,2,2021-01-10,0,0,0,0,2021-01-10,1610233200.0
14799,93,2,2021-01-11,0,0,0,0,2021-01-11,1610319600.0
14800,93,2,2021-01-12,0,0,0,0,2021-01-12,1610406000.0
14801,93,2,2021-01-13,0,0,0,0,2021-01-13,1610492400.0
14802,93,2,2021-01-14,17,0,17,0,2021-01-14,1610578800.0
14803,93,2,2021-01-15,3,0,20,0,2021-01-15,1610665200.0
14804,93,2,2021-01-16,22,0,42,0,2021-01-16,1610751600.0
14805,93,2,2021-01-17,0,0,42,0,2021-01-17,1610838000.0
14806,93,2,2021-01-18,433,0,475,0,2021-01-18,1610924400.0
14807,93,2,2021-01-19,1228,0,1703,0,2021-01-19,1611010800.0
14808,93,2,2021-01-20,1163,0,2866,0,2021-01-20,1611097200.0
14809,93,2,2021-01-21,1178,0,4044,0,2021-01-21,1611183600.0
14810,93,2,2021-01-22,1102,0,5146,0,2021-01-22,1611270000.0
14811,93,2,2021-01-23,284,0,5430,0,2021-01-23,1611356400.0
14812,93,2,2021-01-24,48,0,5478,0,2021-01-24,1611442800.0
14813,93,2,2021-01-25,809,0,6287,0,2021-01-25,1611529200.0
14814,93,2,2021-01-26,922,0,7209,0,2021-01-26,1611615600.0
14815,93,2,2021-01-27,641,0,7850,0,2021-01-27,1611702000.0
14816,93,2,2021-01-28,557,0,8407,0,2021-01-28,1611788400.0
14817,93,2,2021-01-29,446,0,8853,0,2021-01-29,1611874800.0
14818,93,2,2021-01-30,75,0,8928,0,2021-01-30,1611961200.0
14819,93,2,2021-01-31,0,0,8928,0,2021-01-31,1612047600.0
14820,93,2,2021-02-01,518,0,9446,0,2021-02-01,1612134000.0
14821,93,2,2021-02-02,782,0,10228,0,2021-02-02,1612220400.0
14822,93,2,2021-02-03,837,0,11065,0,2021-02-03,1612306800.0
14823,93,2,2021-02-04,836,0,11901,0,2021-02-04,1612393200.0
14824,93,2,2021-02-05,713,2,12614,2,2021-02-05,1612479600.0
14825,93,2,2021-02-06,208,1,12822,3,2021-02-06,1612566000.0
14826,93,2,2021-02-07,1,0,12823,3,2021-02-07,1612652400.0
14827,93,2,2021-02-08,806,0,13629,3,2021-02-08,1612738800.0
14828,93,2,2021-02-09,780,1,14409,4,2021-02-09,1612825200.0
14829,93,2,2021-02-10,787,22,15196,26,2021-02-10,1612911600.0
14830,93,2,2021-02-11,801,0,15997,26,2021-02-11,1612998000.0
14831,93,2,2021-02-12,797,12,16794,38,2021-02-12,1613084400.0
14832,93,2,2021-02-13,212,20,17006,58,2021-02-13,1613170800.0
14833,93,2,2021-02-14,0,0,17006,58,2021-02-14,1613257200.0
14834,93,2,2021-02-15,588,436,17594,494,2021-02-15,1613343600.0
14835,93,2,2021-02-16,491,806,18085,1300,2021-02-16,1613430000.0
14836,93,2,2021-02-17,751,824,18836,2124,2021-02-17,1613516400.0
14837,93,2,2021-02-18,1085,1078,19921,3202,2021-02-18,1613602800.0
14838,93,2,2021-02-19,1074,1001,20995,4203,2021-02-19,1613689200.0
14839,93,2,2021-02-20,261,346,21256,4549,2021-02-20,1613775600.0
14840,93,2,2021-02-21,2,0,21258,4549,2021-02-21,1613862000.0
14841,93,2,2021-02-22,886,854,22144,5403,2021-02-22,1613948400.0
14842,93,2,2021-02-23,845,807,22989,6210,2021-02-23,1614034800.0
14843,93,2,2021-02-24,961,649,23950,6859,2021-02-24,1614121200.0
14844,93,2,2021-02-25,566,528,24516,7387,2021-02-25,1614207600.0
14845,93,2,2021-02-26,507,504,25023,7891,2021-02-26,1614294000.0
14846,93,2,2021-02-27,385,66,25408,7957,2021-02-27,1614380400.0
14847,93,2,2021-02-28,0,0,25408,7957,2021-02-28,1614466800.0
14848,93,2,2021-03-01,799,665,26207,8622,2021-03-01,1614553200.0
14849,93,2,2021-03-02,298,764,26505,9386,2021-03-02,1614639600.0
14850,93,2,2021-03-03,369,811,26874,10197,2021-03-03,1614726000.0
14851,93,2,2021-03-04,329,786,27203,10983,2021-03-04,1614812400.0
14852,93,2,2021-03-05,368,788,27571,11771,2021-03-05,1614898800.0
14853,93,2,2021-03-06,157,224,27728,11995,2021-03-06,1614985200.0
14854,93,2,2021-03-07,2,0,27730,11995,2021-03-07,1615071600.0
14855,93,2,2021-03-08,193,738,27923,12733,2021-03-08,1615158000.0
14856,93,2,2021-03-09,334,691,28257,13424,2021-03-09,1615244400.0
14857,93,2,2021-03-10,420,765,28677,14189,2021-03-10,1615330800.0
14858,93,2,2021-03-11,746,807,29423,14996,2021-03-11,1615417200.0
14859,93,2,2021-03-12,664,749,30087,15745,2021-03-12,1615503600.0
14860,93,2,2021-03-13,178,213,30265,15958,2021-03-13,1615590000.0
14861,93,2,2021-03-14,108,0,30373,15958,2021-03-14,1615676400.0
14862,93,2,2021-03-15,676,508,31049,16466,2021-03-15,1615762800.0
14863,93,2,2021-03-16,1723,499,32772,16965,2021-03-16,1615849200.0
14864,93,2,2021-03-17,3577,771,36349,17736,2021-03-17,1615935600.0
14865,93,2,2021-03-18,1902,1012,38251,18748,2021-03-18,1616022000.0
14866,93,2,2021-03-19,2728,997,40979,19745,2021-03-19,1616108400.0
14867,93,2,2021-03-20,967,213,41946,19958,2021-03-20,1616194800.0
14868,93,2,2021-03-21,379,0,42325,19958,2021-03-21,1616281200.0
14869,93,2,2021-03-22,1573,361,43898,20319,2021-03-22,1616367600.0
14870,93,2,2021-03-23,1462,475,45360,20794,2021-03-23,1616454000.0
14871,93,2,2021-03-24,1068,1471,46428,22265,2021-03-24,1616540400.0
14872,93,2,2021-03-25,1141,643,47569,22908,2021-03-25,1616626800.0
14873,93,2,2021-03-26,1872,461,49441,23369,2021-03-26,1616713200.0
14874,93,2,2021-03-27,886,183,50327,23552,2021-03-27,1616799600.0
14875,93,2,2021-03-28,240,0,50567,23552,2021-03-28,1616886000.0
14876,93,2,2021-03-29,1325,712,51892,24264,2021-03-29,1616972400.0
14877,93,2,2021-03-30,1491,400,53383,24664,2021-03-30,1617058800.0
14878,93,2,2021-03-31,3270,458,56653,25122,2021-03-31,1617145200.0
14879,93,2,2021-04-01,3869,478,60522,25600,2021-04-01,1617231600.0
14880,93,2,2021-04-02,4250,402,64772,26002,2021-04-02,1617318000.0
14881,93,2,2021-04-03,1050,84,65822,26086,2021-04-03,1617404400.0
14882,93,2,2021-04-04,139,0,65961,26086,2021-04-04,1617490800.0
14883,93,2,2021-04-05,1448,2,67409,26088,2021-04-05,1617577200.0
14884,93,2,2021-04-06,3322,396,70731,26484,2021-04-06,1617663600.0
14885,93,2,2021-04-07,1571,383,72302,26867,2021-04-07,1617750000.0
14886,93,2,2021-04-08,1653,344,73955,27211,2021-04-08,1617836400.0
14887,93,2,2021-04-09,1922,1106,75877,28317,2021-04-09,1617922800.0
14888,93,2,2021-04-10,732,207,76609,28524,2021-04-10,1618009200.0
14889,93,2,2021-04-11,129,96,76738,28620,2021-04-11,1618095600.0
14890,93,2,2021-04-12,1652,818,78390,29438,2021-04-12,1618185600.0
14891,93,2,2021-04-13,2186,1892,80576,31330,2021-04-13,1618272000.0
14892,93,2,2021-04-14,1531,846,82107,32176,2021-04-14,1618358400.0
14893,93,2,2021-04-15,2664,1457,84771,33633,2021-04-15,1618444800.0
14894,93,2,2021-04-16,2427,1824,87198,35457,2021-04-16,1618531200.0
14895,93,2,2021-04-17,858,882,88056,36339,2021-04-17,1618617600.0
14896,93,2,2021-04-18,203,332,88259,36671,2021-04-18,1618704000.0
14897,93,2,2021-04-19,1634,1546,89893,38217,2021-04-19,1618790400.0
14898,93,2,2021-04-20,1820,1383,91713,39600,2021-04-20,1618876800.0
14899,93,2,2021-04-21,3692,1273,95405,40873,2021-04-21,1618963200.0
14900,93,2,2021-04-22,1601,1446,97006,42319,2021-04-22,1619049600.0
14901,93,2,2021-04-23,1329,1859,98335,44178,2021-04-23,1619136000.0
14902,93,2,2021-04-24,360,1112,98695,45290,2021-04-24,1619222400.0
14903,93,2,2021-04-25,118,237,98813,45527,2021-04-25,1619308800.0
14904,93,2,2021-04-26,1290,1373,100103,46900,2021-04-26,1619395200.0
14905,93,2,2021-04-27,1356,1971,101459,48871,2021-04-27,1619481600.0
14906,93,2,2021-04-28,2725,2329,104184,51200,2021-04-28,1619568000.0
14907,93,2,2021-04-29,2887,2734,107071,53934,2021-04-29,1619654400.0
14908,93,2,2021-04-30,2362,3159,109433,57093,2021-04-30,1619740800.0
14909,93,2,2021-05-01,908,684,110341,57777,2021-05-01,1619827200.0
14910,93,2,2021-05-02,181,114,110522,57891,2021-05-02,1619913600.0
14911,93,2,2021-05-03,2944,1655,113466,59546,2021-05-03,1620000000.0
14912,93,2,2021-05-04,2074,2790,115540,62336,2021-05-04,1620086400.0
14913,93,2,2021-05-05,1955,1479,117495,63815,2021-05-05,1620172800.0
14914,93,2,2021-05-06,2101,1536,119596,65351,2021-05-06,1620259200.0
14915,93,2,2021-05-07,3182,1990,122778,67341,2021-05-07,1620345600.0
14916,93,2,2021-05-08,1342,497,124120,67838,2021-05-08,1620432000.0
14917,93,2,2021-05-09,310,266,124430,68104,2021-05-09,1620518400.0
14918,93,2,2021-05-10,2155,2272,126585,70376,2021-05-10,1620604800.0
14919,93,2,2021-05-11,4603,2072,131188,72448,2021-05-11,1620691200.0
14920,93,2,2021-05-12,6446,1492,137634,73940,2021-05-12,1620777600.0
14921,93,2,2021-05-13,3767,1410,141401,75350,2021-05-13,1620864000.0
14922,93,2,2021-05-14,4936,916,146337,76266,2021-05-14,1620950400.0
14923,93,2,2021-05-15,4202,412,150539,76678,2021-05-15,1621036800.0
14924,93,2,2021-05-16,1430,81,151969,76759,2021-05-16,1621123200.0
14925,93,2,2021-05-17,3508,1121,155477,77880,2021-05-17,1621206000.0
14926,93,2,2021-05-18,4132,625,159609,78505,2021-05-18,1621292400.0
14927,93,2,2021-05-19,4565,885,164174,79390,2021-05-19,1621378800.0
14928,93,2,2021-05-20,4688,623,168862,80013,2021-05-20,1621465200.0
14929,93,2,2021-05-21,5798,670,174660,80683,2021-05-21,1621551600.0
14930,93,2,2021-05-22,2928,224,177588,80907,2021-05-22,1621638000.0
14931,93,2,2021-05-23,533,107,178121,81014,2021-05-23,1621724400.0
14932,93,2,2021-05-24,1898,174,180019,81188,2021-05-24,1621810800.0
14933,93,2,2021-05-25,2198,747,182217,81935,2021-05-25,1621897200.0
14934,93,2,2021-05-26,3212,1180,185429,83115,2021-05-26,1621983600.0
14935,93,2,2021-05-27,2219,913,187648,84028,2021-05-27,1622070000.0
14936,93,2,2021-05-28,2252,1148,189900,85176,2021-05-28,1622156400.0
14937,93,2,2021-05-29,1494,503,191394,85679,2021-05-29,1622242800.0
14938,93,2,2021-05-30,72,68,191466,85747,2021-05-30,1622329200.0
14939,93,2,2021-05-31,1212,1687,192678,87434,2021-05-31,1622415600.0
14940,93,2,2021-06-01,1967,2279,194645,89713,2021-06-01,1622502000.0
14941,93,2,2021-06-02,1863,2521,196508,92234,2021-06-02,1622588400.0
14942,93,2,2021-06-03,2969,2291,199477,94525,2021-06-03,1622674800.0
14943,93,2,2021-06-04,3889,1643,203366,96168,2021-06-04,1622761200.0
14944,93,2,2021-06-05,1644,630,205010,96798,2021-06-05,1622847600.0
14945,93,2,2021-06-06,157,61,205167,96859,2021-06-06,1622934000.0
14946,93,2,2021-06-07,1727,2686,206894,99545,2021-06-07,1623020400.0
14947,93,2,2021-06-08,3032,2053,209926,101598,2021-06-08,1623106800.0
14948,93,2,2021-06-09,2281,2351,212207,103949,2021-06-09,1623193200.0
14949,93,2,2021-06-10,2872,2270,215079,106219,2021-06-10,1623279600.0
14950,93,2,2021-06-11,3174,2706,218253,108925,2021-06-11,1623366000.0
14951,93,2,2021-06-12,1370,1266,219623,110191,2021-06-12,1623452400.0
14952,93,2,2021-06-13,182,201,219805,110392,2021-06-13,1623538800.0
14953,93,2,2021-06-14,1476,3048,221281,113440,2021-06-14,1623625200.0
14954,93,2,2021-06-15,2196,3085,223477,116525,2021-06-15,1623711600.0
14955,93,2,2021-06-16,1720,2691,225197,119216,2021-06-16,1623798000.0
14956,93,2,2021-06-17,2177,3230,227374,122446,2021-06-17,1623884400.0
14957,93,2,2021-06-18,2665,2747,230039,125193,2021-06-18,1623970800.0
14958,93,2,2021-06-19,790,1904,230829,127097,2021-06-19,1624057200.0
14959,93,2,2021-06-20,93,357,230922,127454,2021-06-20,1624143600.0
14960,93,2,2021-06-21,1049,4661,231971,132115,2021-06-21,1624230000.0
14961,93,2,2021-06-22,1607,4542,233578,136657,2021-06-22,1624316400.0
14962,93,2,2021-06-23,1436,5657,235014,142314,2021-06-23,1624402800.0
14963,93,2,2021-06-24,1824,4009,236838,146323,2021-06-24,1624489200.0
14964,93,2,2021-06-25,1855,4384,238693,150707,2021-06-25,1624575600.0
14965,93,2,2021-06-26,661,3327,239354,154034,2021-06-26,1624662000.0
14966,93,2,2021-06-27,108,532,239462,154566,2021-06-27,1624748400.0
14967,93,2,2021-06-28,855,4340,240317,158906,2021-06-28,1624834800.0
14968,93,2,2021-06-29,1404,4107,241721,163013,2021-06-29,1624921200.0
14969,93,2,2021-06-30,1115,4668,242836,167681,2021-06-30,1625007600.0
14970,93,2,2021-07-01,1369,3527,244205,171208,2021-07-01,1625094000.0
14971,93,2,2021-07-02,1743,3835,245948,175043,2021-07-02,1625180400.0
14972,93,2,2021-07-03,676,2158,246624,177201,2021-07-03,1625266800.0
14973,93,2,2021-07-04,89,242,246713,177443,2021-07-04,1625353200.0
14974,93,2,2021-07-05,691,2968,247404,180411,2021-07-05,1625439600.0
14975,93,2,2021-07-06,1206,2742,248610,183153,2021-07-06,1625526000.0
14976,93,3,2020-12-27,0,0,0,0,2020-12-27,1609023600.0
14977,93,3,2020-12-28,0,0,0,0,2020-12-28,1609110000.0
14978,93,3,2020-12-29,0,0,0,0,2020-12-29,1609196400.0
14979,93,3,2020-12-30,0,0,0,0,2020-12-30,1609282800.0
14980,93,3,2020-12-31,0,0,0,0,2020-12-31,1609369200.0
14981,93,3,2021-01-01,0,0,0,0,2021-01-01,1609455600.0
14982,93,3,2021-01-02,0,0,0,0,2021-01-02,1609542000.0
14983,93,3,2021-01-03,0,0,0,0,2021-01-03,1609628400.0
14984,93,3,2021-01-04,0,0,0,0,2021-01-04,1609714800.0
14985,93,3,2021-01-05,0,0,0,0,2021-01-05,1609801200.0
14986,93,3,2021-01-06,0,0,0,0,2021-01-06,1609887600.0
14987,93,3,2021-01-07,0,0,0,0,2021-01-07,1609974000.0
14988,93,3,2021-01-08,0,0,0,0,2021-01-08,1610060400.0
14989,93,3,2021-01-09,0,0,0,0,2021-01-09,1610146800.0
14990,93,3,2021-01-10,0,0,0,0,2021-01-10,1610233200.0
14991,93,3,2021-01-11,0,0,0,0,2021-01-11,1610319600.0
14992,93,3,2021-01-12,0,0,0,0,2021-01-12,1610406000.0
14993,93,3,2021-01-13,0,0,0,0,2021-01-13,1610492400.0
14994,93,3,2021-01-14,0,0,0,0,2021-01-14,1610578800.0
14995,93,3,2021-01-15,0,0,0,0,2021-01-15,1610665200.0
14996,93,3,2021-01-16,0,0,0,0,2021-01-16,1610751600.0
14997,93,3,2021-01-17,0,0,0,0,2021-01-17,1610838000.0
14998,93,3,2021-01-18,0,0,0,0,2021-01-18,1610924400.0
14999,93,3,2021-01-19,0,0,0,0,2021-01-19,1611010800.0
15000,93,3,2021-01-20,0,0,0,0,2021-01-20,1611097200.0
15001,93,3,2021-01-21,0,0,0,0,2021-01-21,1611183600.0
15002,93,3,2021-01-22,0,0,0,0,2021-01-22,1611270000.0
15003,93,3,2021-01-23,0,0,0,0,2021-01-23,1611356400.0
15004,93,3,2021-01-24,0,0,0,0,2021-01-24,1611442800.0
15005,93,3,2021-01-25,0,0,0,0,2021-01-25,1611529200.0
15006,93,3,2021-01-26,0,0,0,0,2021-01-26,1611615600.0
15007,93,3,2021-01-27,0,0,0,0,2021-01-27,1611702000.0
15008,93,3,2021-01-28,0,0,0,0,2021-01-28,1611788400.0
15009,93,3,2021-01-29,0,0,0,0,2021-01-29,1611874800.0
15010,93,3,2021-01-30,0,0,0,0,2021-01-30,1611961200.0
15011,93,3,2021-01-31,0,0,0,0,2021-01-31,1612047600.0
15012,93,3,2021-02-01,0,0,0,0,2021-02-01,1612134000.0
15013,93,3,2021-02-02,0,0,0,0,2021-02-02,1612220400.0
15014,93,3,2021-02-03,0,0,0,0,2021-02-03,1612306800.0
15015,93,3,2021-02-04,0,0,0,0,2021-02-04,1612393200.0
15016,93,3,2021-02-05,0,0,0,0,2021-02-05,1612479600.0
15017,93,3,2021-02-06,9,0,9,0,2021-02-06,1612566000.0
15018,93,3,2021-02-07,0,0,9,0,2021-02-07,1612652400.0
15019,93,3,2021-02-08,17,0,26,0,2021-02-08,1612738800.0
15020,93,3,2021-02-09,34,0,60,0,2021-02-09,1612825200.0
15021,93,3,2021-02-10,52,0,112,0,2021-02-10,1612911600.0
15022,93,3,2021-02-11,127,0,239,0,2021-02-11,1612998000.0
15023,93,3,2021-02-12,161,0,400,0,2021-02-12,1613084400.0
15024,93,3,2021-02-13,15,0,415,0,2021-02-13,1613170800.0
15025,93,3,2021-02-14,0,0,415,0,2021-02-14,1613257200.0
15026,93,3,2021-02-15,212,0,627,0,2021-02-15,1613343600.0
15027,93,3,2021-02-16,234,0,861,0,2021-02-16,1613430000.0
15028,93,3,2021-02-17,213,0,1074,0,2021-02-17,1613516400.0
15029,93,3,2021-02-18,352,0,1426,0,2021-02-18,1613602800.0
15030,93,3,2021-02-19,382,0,1808,0,2021-02-19,1613689200.0
15031,93,3,2021-02-20,40,0,1848,0,2021-02-20,1613775600.0
15032,93,3,2021-02-21,0,0,1848,0,2021-02-21,1613862000.0
15033,93,3,2021-02-22,376,0,2224,0,2021-02-22,1613948400.0
15034,93,3,2021-02-23,337,0,2561,0,2021-02-23,1614034800.0
15035,93,3,2021-02-24,395,0,2956,0,2021-02-24,1614121200.0
15036,93,3,2021-02-25,2248,0,5204,0,2021-02-25,1614207600.0
15037,93,3,2021-02-26,3137,0,8341,0,2021-02-26,1614294000.0
15038,93,3,2021-02-27,1864,2,10205,2,2021-02-27,1614380400.0
15039,93,3,2021-02-28,172,0,10377,2,2021-02-28,1614466800.0
15040,93,3,2021-03-01,1351,0,11728,2,2021-03-01,1614553200.0
15041,93,3,2021-03-02,2364,1,14092,3,2021-03-02,1614639600.0
15042,93,3,2021-03-03,3108,0,17200,3,2021-03-03,1614726000.0
15043,93,3,2021-03-04,4796,0,21996,3,2021-03-04,1614812400.0
15044,93,3,2021-03-05,5835,3,27831,6,2021-03-05,1614898800.0
15045,93,3,2021-03-06,14235,2,42066,8,2021-03-06,1614985200.0
15046,93,3,2021-03-07,10741,4,52807,12,2021-03-07,1615071600.0
15047,93,3,2021-03-08,3976,2,56783,14,2021-03-08,1615158000.0
15048,93,3,2021-03-09,6058,2,62841,16,2021-03-09,1615244400.0
15049,93,3,2021-03-10,6543,5,69384,21,2021-03-10,1615330800.0
15050,93,3,2021-03-11,10302,4,79686,25,2021-03-11,1615417200.0
15051,93,3,2021-03-12,11410,5,91096,30,2021-03-12,1615503600.0
15052,93,3,2021-03-13,9160,7,100256,37,2021-03-13,1615590000.0
15053,93,3,2021-03-14,1495,0,101751,37,2021-03-14,1615676400.0
15054,93,3,2021-03-15,5361,2,107112,39,2021-03-15,1615762800.0
15055,93,3,2021-03-16,108,1,107220,40,2021-03-16,1615849200.0
15056,93,3,2021-03-17,64,1,107284,41,2021-03-17,1615935600.0
15057,93,3,2021-03-18,117,0,107401,41,2021-03-18,1616022000.0
15058,93,3,2021-03-19,4441,8,111842,49,2021-03-19,1616108400.0
15059,93,3,2021-03-20,3798,2,115640,51,2021-03-20,1616194800.0
15060,93,3,2021-03-21,556,0,116196,51,2021-03-21,1616281200.0
15061,93,3,2021-03-22,4284,2,120480,53,2021-03-22,1616367600.0
15062,93,3,2021-03-23,7150,4,127630,57,2021-03-23,1616454000.0
15063,93,3,2021-03-24,7198,8,134828,65,2021-03-24,1616540400.0
15064,93,3,2021-03-25,10984,13,145812,78,2021-03-25,1616626800.0
15065,93,3,2021-03-26,11337,18,157149,96,2021-03-26,1616713200.0
15066,93,3,2021-03-27,4447,2,161596,98,2021-03-27,1616799600.0
15067,93,3,2021-03-28,607,0,162203,98,2021-03-28,1616886000.0
15068,93,3,2021-03-29,4545,8,166748,106,2021-03-29,1616972400.0
15069,93,3,2021-03-30,7200,3,173948,109,2021-03-30,1617058800.0
15070,93,3,2021-03-31,5194,11,179142,120,2021-03-31,1617145200.0
15071,93,3,2021-04-01,6538,13,185680,133,2021-04-01,1617231600.0
15072,93,3,2021-04-02,6177,13,191857,146,2021-04-02,1617318000.0
15073,93,3,2021-04-03,2078,12,193935,158,2021-04-03,1617404400.0
15074,93,3,2021-04-04,368,0,194303,158,2021-04-04,1617490800.0
15075,93,3,2021-04-05,299,0,194602,158,2021-04-05,1617577200.0
15076,93,3,2021-04-06,2061,10,196663,168,2021-04-06,1617663600.0
15077,93,3,2021-04-07,2408,7,199071,175,2021-04-07,1617750000.0
15078,93,3,2021-04-08,4831,23,203902,198,2021-04-08,1617836400.0
15079,93,3,2021-04-09,7433,42,211335,240,2021-04-09,1617922800.0
15080,93,3,2021-04-10,2921,19,214256,259,2021-04-10,1618009200.0
15081,93,3,2021-04-11,361,6,214617,265,2021-04-11,1618095600.0
15082,93,3,2021-04-12,2985,28,217602,293,2021-04-12,1618185600.0
15083,93,3,2021-04-13,4283,46,221885,339,2021-04-13,1618272000.0
15084,93,3,2021-04-14,3691,50,225576,389,2021-04-14,1618358400.0
15085,93,3,2021-04-15,4288,29,229864,418,2021-04-15,1618444800.0
15086,93,3,2021-04-16,4852,30,234716,448,2021-04-16,1618531200.0
15087,93,3,2021-04-17,2093,17,236809,465,2021-04-17,1618617600.0
15088,93,3,2021-04-18,420,5,237229,470,2021-04-18,1618704000.0
15089,93,3,2021-04-19,1205,28,238434,498,2021-04-19,1618790400.0
15090,93,3,2021-04-20,1827,44,240261,542,2021-04-20,1618876800.0
15091,93,3,2021-04-21,1676,32,241937,574,2021-04-21,1618963200.0
15092,93,3,2021-04-22,2419,49,244356,623,2021-04-22,1619049600.0
15093,93,3,2021-04-23,2544,74,246900,697,2021-04-23,1619136000.0
15094,93,3,2021-04-24,1207,100,248107,797,2021-04-24,1619222400.0
15095,93,3,2021-04-25,247,10,248354,807,2021-04-25,1619308800.0
15096,93,3,2021-04-26,772,29,249126,836,2021-04-26,1619395200.0
15097,93,3,2021-04-27,1277,83,250403,919,2021-04-27,1619481600.0
15098,93,3,2021-04-28,1047,93,251450,1012,2021-04-28,1619568000.0
15099,93,3,2021-04-29,1836,361,253286,1373,2021-04-29,1619654400.0
15100,93,3,2021-04-30,1843,710,255129,2083,2021-04-30,1619740800.0
15101,93,3,2021-05-01,177,97,255306,2180,2021-05-01,1619827200.0
15102,93,3,2021-05-02,120,34,255426,2214,2021-05-02,1619913600.0
15103,93,3,2021-05-03,508,279,255934,2493,2021-05-03,1620000000.0
15104,93,3,2021-05-04,871,518,256805,3011,2021-05-04,1620086400.0
15105,93,3,2021-05-05,826,792,257631,3803,2021-05-05,1620172800.0
15106,93,3,2021-05-06,1430,1476,259061,5279,2021-05-06,1620259200.0
15107,93,3,2021-05-07,1622,1994,260683,7273,2021-05-07,1620345600.0
15108,93,3,2021-05-08,151,461,260834,7734,2021-05-08,1620432000.0
15109,93,3,2021-05-09,79,169,260913,7903,2021-05-09,1620518400.0
15110,93,3,2021-05-10,668,1009,261581,8912,2021-05-10,1620604800.0
15111,93,3,2021-05-11,1128,1975,262709,10887,2021-05-11,1620691200.0
15112,93,3,2021-05-12,841,2309,263550,13196,2021-05-12,1620777600.0
15113,93,3,2021-05-13,118,295,263668,13491,2021-05-13,1620864000.0
15114,93,3,2021-05-14,506,2073,264174,15564,2021-05-14,1620950400.0
15115,93,3,2021-05-15,249,1565,264423,17129,2021-05-15,1621036800.0
15116,93,3,2021-05-16,71,189,264494,17318,2021-05-16,1621123200.0
15117,93,3,2021-05-17,490,1874,264984,19192,2021-05-17,1621206000.0
15118,93,3,2021-05-18,532,2147,265516,21339,2021-05-18,1621292400.0
15119,93,3,2021-05-19,475,2437,265991,23776,2021-05-19,1621378800.0
15120,93,3,2021-05-20,667,3814,266658,27590,2021-05-20,1621465200.0
15121,93,3,2021-05-21,601,4779,267259,32369,2021-05-21,1621551600.0
15122,93,3,2021-05-22,314,1980,267573,34349,2021-05-22,1621638000.0
15123,93,3,2021-05-23,50,201,267623,34550,2021-05-23,1621724400.0
15124,93,3,2021-05-24,28,627,267651,35177,2021-05-24,1621810800.0
15125,93,3,2021-05-25,514,5436,268165,40613,2021-05-25,1621897200.0
15126,93,3,2021-05-26,297,4407,268462,45020,2021-05-26,1621983600.0
15127,93,3,2021-05-27,442,6158,268904,51178,2021-05-27,1622070000.0
15128,93,3,2021-05-28,368,7563,269272,58741,2021-05-28,1622156400.0
15129,93,3,2021-05-29,228,5612,269500,64353,2021-05-29,1622242800.0
15130,93,3,2021-05-30,19,1014,269519,65367,2021-05-30,1622329200.0
15131,93,3,2021-05-31,217,4236,269736,69603,2021-05-31,1622415600.0
15132,93,3,2021-06-01,263,5533,269999,75136,2021-06-01,1622502000.0
15133,93,3,2021-06-02,215,5278,270214,80414,2021-06-02,1622588400.0
15134,93,3,2021-06-03,239,6701,270453,87115,2021-06-03,1622674800.0
15135,93,3,2021-06-04,275,7052,270728,94167,2021-06-04,1622761200.0
15136,93,3,2021-06-05,117,3136,270845,97303,2021-06-05,1622847600.0
15137,93,3,2021-06-06,31,393,270876,97696,2021-06-06,1622934000.0
15138,93,3,2021-06-07,113,2646,270989,100342,2021-06-07,1623020400.0
15139,93,3,2021-06-08,165,3776,271154,104118,2021-06-08,1623106800.0
15140,93,3,2021-06-09,129,3547,271283,107665,2021-06-09,1623193200.0
15141,93,3,2021-06-10,141,4941,271424,112606,2021-06-10,1623279600.0
15142,93,3,2021-06-11,154,6403,271578,119009,2021-06-11,1623366000.0
15143,93,3,2021-06-12,74,2775,271652,121784,2021-06-12,1623452400.0
15144,93,3,2021-06-13,15,277,271667,122061,2021-06-13,1623538800.0
15145,93,3,2021-06-14,67,4465,271734,126526,2021-06-14,1623625200.0
15146,93,3,2021-06-15,140,6165,271874,132691,2021-06-15,1623711600.0
15147,93,3,2021-06-16,96,4544,271970,137235,2021-06-16,1623798000.0
15148,93,3,2021-06-17,145,6740,272115,143975,2021-06-17,1623884400.0
15149,93,3,2021-06-18,138,6838,272253,150813,2021-06-18,1623970800.0
15150,93,3,2021-06-19,54,1964,272307,152777,2021-06-19,1624057200.0
15151,93,3,2021-06-20,10,316,272317,153093,2021-06-20,1624143600.0
15152,93,3,2021-06-21,44,2686,272361,155779,2021-06-21,1624230000.0
15153,93,3,2021-06-22,71,4007,272432,159786,2021-06-22,1624316400.0
15154,93,3,2021-06-23,76,2917,272508,162703,2021-06-23,1624402800.0
15155,93,3,2021-06-24,80,4500,272588,167203,2021-06-24,1624489200.0
15156,93,3,2021-06-25,112,4591,272700,171794,2021-06-25,1624575600.0
15157,93,3,2021-06-26,70,1376,272770,173170,2021-06-26,1624662000.0
15158,93,3,2021-06-27,8,316,272778,173486,2021-06-27,1624748400.0
15159,93,3,2021-06-28,55,1804,272833,175290,2021-06-28,1624834800.0
15160,93,3,2021-06-29,79,2719,272912,178009,2021-06-29,1624921200.0
15161,93,3,2021-06-30,66,2441,272978,180450,2021-06-30,1625007600.0
15162,93,3,2021-07-01,103,3419,273081,183869,2021-07-01,1625094000.0
15163,93,3,2021-07-02,96,3618,273177,187487,2021-07-02,1625180400.0
15164,93,3,2021-07-03,34,1074,273211,188561,2021-07-03,1625266800.0
15165,93,3,2021-07-04,11,165,273222,188726,2021-07-04,1625353200.0
15166,93,3,2021-07-05,47,1727,273269,190453,2021-07-05,1625439600.0
15167,93,3,2021-07-06,65,2371,273334,192824,2021-07-06,1625526000.0
15168,93,4,2020-12-27,0,0,0,0,2020-12-27,1609023600.0
15169,93,4,2020-12-28,0,0,0,0,2020-12-28,1609110000.0
15170,93,4,2020-12-29,0,0,0,0,2020-12-29,1609196400.0
15171,93,4,2020-12-30,0,0,0,0,2020-12-30,1609282800.0
15172,93,4,2020-12-31,0,0,0,0,2020-12-31,1609369200.0
15173,93,4,2021-01-01,0,0,0,0,2021-01-01,1609455600.0
15174,93,4,2021-01-02,0,0,0,0,2021-01-02,1609542000.0
15175,93,4,2021-01-03,0,0,0,0,2021-01-03,1609628400.0
15176,93,4,2021-01-04,0,0,0,0,2021-01-04,1609714800.0
15177,93,4,2021-01-05,0,0,0,0,2021-01-05,1609801200.0
15178,93,4,2021-01-06,0,0,0,0,2021-01-06,1609887600.0
15179,93,4,2021-01-07,0,0,0,0,2021-01-07,1609974000.0
15180,93,4,2021-01-08,0,0,0,0,2021-01-08,1610060400.0
15181,93,4,2021-01-09,0,0,0,0,2021-01-09,1610146800.0
15182,93,4,2021-01-10,0,0,0,0,2021-01-10,1610233200.0
15183,93,4,2021-01-11,0,0,0,0,2021-01-11,1610319600.0
15184,93,4,2021-01-12,0,0,0,0,2021-01-12,1610406000.0
15185,93,4,2021-01-13,0,0,0,0,2021-01-13,1610492400.0
15186,93,4,2021-01-14,0,0,0,0,2021-01-14,1610578800.0
15187,93,4,2021-01-15,0,0,0,0,2021-01-15,1610665200.0
15188,93,4,2021-01-16,0,0,0,0,2021-01-16,1610751600.0
15189,93,4,2021-01-17,0,0,0,0,2021-01-17,1610838000.0
15190,93,4,2021-01-18,0,0,0,0,2021-01-18,1610924400.0
15191,93,4,2021-01-19,0,0,0,0,2021-01-19,1611010800.0
15192,93,4,2021-01-20,0,0,0,0,2021-01-20,1611097200.0
15193,93,4,2021-01-21,0,0,0,0,2021-01-21,1611183600.0
15194,93,4,2021-01-22,0,0,0,0,2021-01-22,1611270000.0
15195,93,4,2021-01-23,0,0,0,0,2021-01-23,1611356400.0
15196,93,4,2021-01-24,0,0,0,0,2021-01-24,1611442800.0
15197,93,4,2021-01-25,0,0,0,0,2021-01-25,1611529200.0
15198,93,4,2021-01-26,0,0,0,0,2021-01-26,1611615600.0
15199,93,4,2021-01-27,0,0,0,0,2021-01-27,1611702000.0
15200,93,4,2021-01-28,0,0,0,0,2021-01-28,1611788400.0
15201,93,4,2021-01-29,0,0,0,0,2021-01-29,1611874800.0
15202,93,4,2021-01-30,0,0,0,0,2021-01-30,1611961200.0
15203,93,4,2021-01-31,0,0,0,0,2021-01-31,1612047600.0
15204,93,4,2021-02-01,0,0,0,0,2021-02-01,1612134000.0
15205,93,4,2021-02-02,0,0,0,0,2021-02-02,1612220400.0
15206,93,4,2021-02-03,0,0,0,0,2021-02-03,1612306800.0
15207,93,4,2021-02-04,0,0,0,0,2021-02-04,1612393200.0
15208,93,4,2021-02-05,0,0,0,0,2021-02-05,1612479600.0
15209,93,4,2021-02-06,0,0,0,0,2021-02-06,1612566000.0
15210,93,4,2021-02-07,0,0,0,0,2021-02-07,1612652400.0
15211,93,4,2021-02-08,0,0,0,0,2021-02-08,1612738800.0
15212,93,4,2021-02-09,0,0,0,0,2021-02-09,1612825200.0
15213,93,4,2021-02-10,0,0,0,0,2021-02-10,1612911600.0
15214,93,4,2021-02-11,0,0,0,0,2021-02-11,1612998000.0
15215,93,4,2021-02-12,0,0,0,0,2021-02-12,1613084400.0
15216,93,4,2021-02-13,0,0,0,0,2021-02-13,1613170800.0
15217,93,4,2021-02-14,0,0,0,0,2021-02-14,1613257200.0
15218,93,4,2021-02-15,0,0,0,0,2021-02-15,1613343600.0
15219,93,4,2021-02-16,0,0,0,0,2021-02-16,1613430000.0
15220,93,4,2021-02-17,0,0,0,0,2021-02-17,1613516400.0
15221,93,4,2021-02-18,0,0,0,0,2021-02-18,1613602800.0
15222,93,4,2021-02-19,0,0,0,0,2021-02-19,1613689200.0
15223,93,4,2021-02-20,0,0,0,0,2021-02-20,1613775600.0
15224,93,4,2021-02-21,0,0,0,0,2021-02-21,1613862000.0
15225,93,4,2021-02-22,0,0,0,0,2021-02-22,1613948400.0
15226,93,4,2021-02-23,0,0,0,0,2021-02-23,1614034800.0
15227,93,4,2021-02-24,0,0,0,0,2021-02-24,1614121200.0
15228,93,4,2021-02-25,0,0,0,0,2021-02-25,1614207600.0
15229,93,4,2021-02-26,0,0,0,0,2021-02-26,1614294000.0
15230,93,4,2021-02-27,0,0,0,0,2021-02-27,1614380400.0
15231,93,4,2021-02-28,0,0,0,0,2021-02-28,1614466800.0
15232,93,4,2021-03-01,0,0,0,0,2021-03-01,1614553200.0
15233,93,4,2021-03-02,0,0,0,0,2021-03-02,1614639600.0
15234,93,4,2021-03-03,0,0,0,0,2021-03-03,1614726000.0
15235,93,4,2021-03-04,0,0,0,0,2021-03-04,1614812400.0
15236,93,4,2021-03-05,0,0,0,0,2021-03-05,1614898800.0
15237,93,4,2021-03-06,0,0,0,0,2021-03-06,1614985200.0
15238,93,4,2021-03-07,0,0,0,0,2021-03-07,1615071600.0
15239,93,4,2021-03-08,0,0,0,0,2021-03-08,1615158000.0
15240,93,4,2021-03-09,0,0,0,0,2021-03-09,1615244400.0
15241,93,4,2021-03-10,0,0,0,0,2021-03-10,1615330800.0
15242,93,4,2021-03-11,0,0,0,0,2021-03-11,1615417200.0
15243,93,4,2021-03-12,0,0,0,0,2021-03-12,1615503600.0
15244,93,4,2021-03-13,0,0,0,0,2021-03-13,1615590000.0
15245,93,4,2021-03-14,0,0,0,0,2021-03-14,1615676400.0
15246,93,4,2021-03-15,0,0,0,0,2021-03-15,1615762800.0
15247,93,4,2021-03-16,0,0,0,0,2021-03-16,1615849200.0
15248,93,4,2021-03-17,0,0,0,0,2021-03-17,1615935600.0
15249,93,4,2021-03-18,0,0,0,0,2021-03-18,1616022000.0
15250,93,4,2021-03-19,0,0,0,0,2021-03-19,1616108400.0
15251,93,4,2021-03-20,0,0,0,0,2021-03-20,1616194800.0
15252,93,4,2021-03-21,0,0,0,0,2021-03-21,1616281200.0
15253,93,4,2021-03-22,0,0,0,0,2021-03-22,1616367600.0
15254,93,4,2021-03-23,0,0,0,0,2021-03-23,1616454000.0
15255,93,4,2021-03-24,0,0,0,0,2021-03-24,1616540400.0
15256,93,4,2021-03-25,0,0,0,0,2021-03-25,1616626800.0
15257,93,4,2021-03-26,0,0,0,0,2021-03-26,1616713200.0
15258,93,4,2021-03-27,0,0,0,0,2021-03-27,1616799600.0
15259,93,4,2021-03-28,0,0,0,0,2021-03-28,1616886000.0
15260,93,4,2021-03-29,0,0,0,0,2021-03-29,1616972400.0
15261,93,4,2021-03-30,0,0,0,0,2021-03-30,1617058800.0
15262,93,4,2021-03-31,0,0,0,0,2021-03-31,1617145200.0
15263,93,4,2021-04-01,0,0,0,0,2021-04-01,1617231600.0
15264,93,4,2021-04-02,0,0,0,0,2021-04-02,1617318000.0
15265,93,4,2021-04-03,0,0,0,0,2021-04-03,1617404400.0
15266,93,4,2021-04-04,0,0,0,0,2021-04-04,1617490800.0
15267,93,4,2021-04-05,0,0,0,0,2021-04-05,1617577200.0
15268,93,4,2021-04-06,0,0,0,0,2021-04-06,1617663600.0
15269,93,4,2021-04-07,0,0,0,0,2021-04-07,1617750000.0
15270,93,4,2021-04-08,0,0,0,0,2021-04-08,1617836400.0
15271,93,4,2021-04-09,0,0,0,0,2021-04-09,1617922800.0
15272,93,4,2021-04-10,0,0,0,0,2021-04-10,1618009200.0
15273,93,4,2021-04-11,0,0,0,0,2021-04-11,1618095600.0
15274,93,4,2021-04-12,0,0,0,0,2021-04-12,1618185600.0
15275,93,4,2021-04-13,0,0,0,0,2021-04-13,1618272000.0
15276,93,4,2021-04-14,0,0,0,0,2021-04-14,1618358400.0
15277,93,4,2021-04-15,0,0,0,0,2021-04-15,1618444800.0
15278,93,4,2021-04-16,0,0,0,0,2021-04-16,1618531200.0
15279,93,4,2021-04-17,0,0,0,0,2021-04-17,1618617600.0
15280,93,4,2021-04-18,0,0,0,0,2021-04-18,1618704000.0
15281,93,4,2021-04-19,0,0,0,0,2021-04-19,1618790400.0
15282,93,4,2021-04-20,0,0,0,0,2021-04-20,1618876800.0
15283,93,4,2021-04-21,0,0,0,0,2021-04-21,1618963200.0
15284,93,4,2021-04-22,0,0,0,0,2021-04-22,1619049600.0
15285,93,4,2021-04-23,10,0,10,0,2021-04-23,1619136000.0
15286,93,4,2021-04-24,37,0,47,0,2021-04-24,1619222400.0
15287,93,4,2021-04-25,0,0,47,0,2021-04-25,1619308800.0
15288,93,4,2021-04-26,88,0,135,0,2021-04-26,1619395200.0
15289,93,4,2021-04-27,594,0,729,0,2021-04-27,1619481600.0
15290,93,4,2021-04-28,561,0,1290,0,2021-04-28,1619568000.0
15291,93,4,2021-04-29,1117,0,2407,0,2021-04-29,1619654400.0
15292,93,4,2021-04-30,1228,1,3635,1,2021-04-30,1619740800.0
15293,93,4,2021-05-01,103,1,3738,2,2021-05-01,1619827200.0
15294,93,4,2021-05-02,41,0,3779,2,2021-05-02,1619913600.0
15295,93,4,2021-05-03,435,0,4214,2,2021-05-03,1620000000.0
15296,93,4,2021-05-04,551,1,4765,3,2021-05-04,1620086400.0
15297,93,4,2021-05-05,443,0,5208,3,2021-05-05,1620172800.0
15298,93,4,2021-05-06,731,0,5939,3,2021-05-06,1620259200.0
15299,93,4,2021-05-07,1231,0,7170,3,2021-05-07,1620345600.0
15300,93,4,2021-05-08,116,2,7286,5,2021-05-08,1620432000.0
15301,93,4,2021-05-09,9,0,7295,5,2021-05-09,1620518400.0
15302,93,4,2021-05-10,556,1,7851,6,2021-05-10,1620604800.0
15303,93,4,2021-05-11,1162,3,9013,9,2021-05-11,1620691200.0
15304,93,4,2021-05-12,666,5,9679,14,2021-05-12,1620777600.0
15305,93,4,2021-05-13,60,2,9739,16,2021-05-13,1620864000.0
15306,93,4,2021-05-14,641,0,10380,16,2021-05-14,1620950400.0
15307,93,4,2021-05-15,279,1,10659,17,2021-05-15,1621036800.0
15308,93,4,2021-05-16,62,0,10721,17,2021-05-16,1621123200.0
15309,93,4,2021-05-17,466,0,11187,17,2021-05-17,1621206000.0
15310,93,4,2021-05-18,689,1,11876,18,2021-05-18,1621292400.0
15311,93,4,2021-05-19,416,0,12292,18,2021-05-19,1621378800.0
15312,93,4,2021-05-20,623,0,12915,18,2021-05-20,1621465200.0
15313,93,4,2021-05-21,817,3,13732,21,2021-05-21,1621551600.0
15314,93,4,2021-05-22,296,5,14028,26,2021-05-22,1621638000.0
15315,93,4,2021-05-23,30,2,14058,28,2021-05-23,1621724400.0
15316,93,4,2021-05-24,40,0,14098,28,2021-05-24,1621810800.0
15317,93,4,2021-05-25,610,0,14708,28,2021-05-25,1621897200.0
15318,93,4,2021-05-26,676,3,15384,31,2021-05-26,1621983600.0
15319,93,4,2021-05-27,1025,3,16409,34,2021-05-27,1622070000.0
15320,93,4,2021-05-28,1480,5,17889,39,2021-05-28,1622156400.0
15321,93,4,2021-05-29,622,0,18511,39,2021-05-29,1622242800.0
15322,93,4,2021-05-30,36,0,18547,39,2021-05-30,1622329200.0
15323,93,4,2021-05-31,909,3,19456,42,2021-05-31,1622415600.0
15324,93,4,2021-06-01,1568,6,21024,48,2021-06-01,1622502000.0
15325,93,4,2021-06-02,1290,6,22314,54,2021-06-02,1622588400.0
15326,93,4,2021-06-03,1518,1,23832,55,2021-06-03,1622674800.0
15327,93,4,2021-06-04,1874,9,25706,64,2021-06-04,1622761200.0
15328,93,4,2021-06-05,622,1,26328,65,2021-06-05,1622847600.0
15329,93,4,2021-06-06,94,0,26422,65,2021-06-06,1622934000.0
15330,93,4,2021-06-07,885,8,27307,73,2021-06-07,1623020400.0
15331,93,4,2021-06-08,1118,6,28425,79,2021-06-08,1623106800.0
15332,93,4,2021-06-09,1137,3,29562,82,2021-06-09,1623193200.0
15333,93,4,2021-06-10,1194,5,30756,87,2021-06-10,1623279600.0
15334,93,4,2021-06-11,1328,14,32084,101,2021-06-11,1623366000.0
15335,93,4,2021-06-12,547,0,32631,101,2021-06-12,1623452400.0
15336,93,4,2021-06-13,52,0,32683,101,2021-06-13,1623538800.0
15337,93,4,2021-06-14,625,0,33308,101,2021-06-14,1623625200.0
15338,93,4,2021-06-15,986,6,34294,107,2021-06-15,1623711600.0
15339,93,4,2021-06-16,766,0,35060,107,2021-06-16,1623798000.0
15340,93,4,2021-06-17,892,2,35952,109,2021-06-17,1623884400.0
15341,93,4,2021-06-18,1086,6,37038,115,2021-06-18,1623970800.0
15342,93,4,2021-06-19,365,1,37403,116,2021-06-19,1624057200.0
15343,93,4,2021-06-20,47,0,37450,116,2021-06-20,1624143600.0
15344,93,4,2021-06-21,416,0,37866,116,2021-06-21,1624230000.0
15345,93,4,2021-06-22,701,3,38567,119,2021-06-22,1624316400.0
15346,93,4,2021-06-23,623,11,39190,130,2021-06-23,1624402800.0
15347,93,4,2021-06-24,785,6,39975,136,2021-06-24,1624489200.0
15348,93,4,2021-06-25,867,2,40842,138,2021-06-25,1624575600.0
15349,93,4,2021-06-26,330,3,41172,141,2021-06-26,1624662000.0
15350,93,4,2021-06-27,46,0,41218,141,2021-06-27,1624748400.0
15351,93,4,2021-06-28,486,0,41704,141,2021-06-28,1624834800.0
15352,93,4,2021-06-29,603,0,42307,141,2021-06-29,1624921200.0
15353,93,4,2021-06-30,688,4,42995,145,2021-06-30,1625007600.0
15354,93,4,2021-07-01,697,1,43692,146,2021-07-01,1625094000.0
15355,93,4,2021-07-02,805,5,44497,151,2021-07-02,1625180400.0
15356,93,4,2021-07-03,386,3,44883,154,2021-07-03,1625266800.0
15357,93,4,2021-07-04,31,2,44914,156,2021-07-04,1625353200.0
15358,93,4,2021-07-05,586,5,45500,161,2021-07-05,1625439600.0
15359,93,4,2021-07-06,744,1,46244,162,2021-07-06,1625526000.0
15360,94,1,2020-12-27,0,0,0,0,2020-12-27,1609023600.0
15361,94,1,2020-12-28,0,0,0,0,2020-12-28,1609110000.0
15362,94,1,2020-12-29,0,0,0,0,2020-12-29,1609196400.0
15363,94,1,2020-12-30,0,0,0,0,2020-12-30,1609282800.0
15364,94,1,2020-12-31,0,0,0,0,2020-12-31,1609369200.0
15365,94,1,2021-01-01,0,0,0,0,2021-01-01,1609455600.0
15366,94,1,2021-01-02,0,0,0,0,2021-01-02,1609542000.0
15367,94,1,2021-01-03,0,0,0,0,2021-01-03,1609628400.0
15368,94,1,2021-01-04,2,0,2,0,2021-01-04,1609714800.0
15369,94,1,2021-01-05,0,0,2,0,2021-01-05,1609801200.0
15370,94,1,2021-01-06,53,0,55,0,2021-01-06,1609887600.0
15371,94,1,2021-01-07,333,0,388,0,2021-01-07,1609974000.0
15372,94,1,2021-01-08,310,0,698,0,2021-01-08,1610060400.0
15373,94,1,2021-01-09,78,0,776,0,2021-01-09,1610146800.0
15374,94,1,2021-01-10,34,0,810,0,2021-01-10,1610233200.0
15375,94,1,2021-01-11,151,0,961,0,2021-01-11,1610319600.0
15376,94,1,2021-01-12,209,0,1170,0,2021-01-12,1610406000.0
15377,94,1,2021-01-13,203,0,1373,0,2021-01-13,1610492400.0
15378,94,1,2021-01-14,264,0,1637,0,2021-01-14,1610578800.0
15379,94,1,2021-01-15,405,0,2042,0,2021-01-15,1610665200.0
15380,94,1,2021-01-16,200,1,2242,1,2021-01-16,1610751600.0
15381,94,1,2021-01-17,91,1,2333,2,2021-01-17,1610838000.0
15382,94,1,2021-01-18,471,2,2804,4,2021-01-18,1610924400.0
15383,94,1,2021-01-19,982,0,3786,4,2021-01-19,1611010800.0
15384,94,1,2021-01-20,812,0,4598,4,2021-01-20,1611097200.0
15385,94,1,2021-01-21,808,1,5406,5,2021-01-21,1611183600.0
15386,94,1,2021-01-22,727,0,6133,5,2021-01-22,1611270000.0
15387,94,1,2021-01-23,243,0,6376,5,2021-01-23,1611356400.0
15388,94,1,2021-01-24,147,0,6523,5,2021-01-24,1611442800.0
15389,94,1,2021-01-25,422,2,6945,7,2021-01-25,1611529200.0
15390,94,1,2021-01-26,790,7,7735,14,2021-01-26,1611615600.0
15391,94,1,2021-01-27,663,55,8398,69,2021-01-27,1611702000.0
15392,94,1,2021-01-28,699,230,9097,299,2021-01-28,1611788400.0
15393,94,1,2021-01-29,626,229,9723,528,2021-01-29,1611874800.0
15394,94,1,2021-01-30,204,74,9927,602,2021-01-30,1611961200.0
15395,94,1,2021-01-31,150,11,10077,613,2021-01-31,1612047600.0
15396,94,1,2021-02-01,458,147,10535,760,2021-02-01,1612134000.0
15397,94,1,2021-02-02,643,195,11178,955,2021-02-02,1612220400.0
15398,94,1,2021-02-03,783,166,11961,1121,2021-02-03,1612306800.0
15399,94,1,2021-02-04,714,297,12675,1418,2021-02-04,1612393200.0
15400,94,1,2021-02-05,659,201,13334,1619,2021-02-05,1612479600.0
15401,94,1,2021-02-06,206,75,13540,1694,2021-02-06,1612566000.0
15402,94,1,2021-02-07,126,58,13666,1752,2021-02-07,1612652400.0
15403,94,1,2021-02-08,322,366,13988,2118,2021-02-08,1612738800.0
15404,94,1,2021-02-09,712,612,14700,2730,2021-02-09,1612825200.0
15405,94,1,2021-02-10,642,429,15342,3159,2021-02-10,1612911600.0
15406,94,1,2021-02-11,580,496,15922,3655,2021-02-11,1612998000.0
15407,94,1,2021-02-12,465,428,16387,4083,2021-02-12,1613084400.0
15408,94,1,2021-02-13,134,72,16521,4155,2021-02-13,1613170800.0
15409,94,1,2021-02-14,112,78,16633,4233,2021-02-14,1613257200.0
15410,94,1,2021-02-15,188,308,16821,4541,2021-02-15,1613343600.0
15411,94,1,2021-02-16,316,602,17137,5143,2021-02-16,1613430000.0
15412,94,1,2021-02-17,395,482,17532,5625,2021-02-17,1613516400.0
15413,94,1,2021-02-18,313,544,17845,6169,2021-02-18,1613602800.0
15414,94,1,2021-02-19,297,609,18142,6778,2021-02-19,1613689200.0
15415,94,1,2021-02-20,275,199,18417,6977,2021-02-20,1613775600.0
15416,94,1,2021-02-21,84,84,18501,7061,2021-02-21,1613862000.0
15417,94,1,2021-02-22,185,404,18686,7465,2021-02-22,1613948400.0
15418,94,1,2021-02-23,340,645,19026,8110,2021-02-23,1614034800.0
15419,94,1,2021-02-24,297,608,19323,8718,2021-02-24,1614121200.0
15420,94,1,2021-02-25,276,605,19599,9323,2021-02-25,1614207600.0
15421,94,1,2021-02-26,316,553,19915,9876,2021-02-26,1614294000.0
15422,94,1,2021-02-27,308,151,20223,10027,2021-02-27,1614380400.0
15423,94,1,2021-02-28,59,123,20282,10150,2021-02-28,1614466800.0
15424,94,1,2021-03-01,265,410,20547,10560,2021-03-01,1614553200.0
15425,94,1,2021-03-02,395,651,20942,11211,2021-03-02,1614639600.0
15426,94,1,2021-03-03,295,687,21237,11898,2021-03-03,1614726000.0
15427,94,1,2021-03-04,682,626,21919,12524,2021-03-04,1614812400.0
15428,94,1,2021-03-05,1192,663,23111,13187,2021-03-05,1614898800.0
15429,94,1,2021-03-06,1399,159,24510,13346,2021-03-06,1614985200.0
15430,94,1,2021-03-07,1143,97,25653,13443,2021-03-07,1615071600.0
15431,94,1,2021-03-08,979,318,26632,13761,2021-03-08,1615158000.0
15432,94,1,2021-03-09,816,649,27448,14410,2021-03-09,1615244400.0
15433,94,1,2021-03-10,848,566,28296,14976,2021-03-10,1615330800.0
15434,94,1,2021-03-11,677,520,28973,15496,2021-03-11,1615417200.0
15435,94,1,2021-03-12,855,341,29828,15837,2021-03-12,1615503600.0
15436,94,1,2021-03-13,673,138,30501,15975,2021-03-13,1615590000.0
15437,94,1,2021-03-14,389,97,30890,16072,2021-03-14,1615676400.0
15438,94,1,2021-03-15,678,228,31568,16300,2021-03-15,1615762800.0
15439,94,1,2021-03-16,1057,386,32625,16686,2021-03-16,1615849200.0
15440,94,1,2021-03-17,1225,340,33850,17026,2021-03-17,1615935600.0
15441,94,1,2021-03-18,962,306,34812,17332,2021-03-18,1616022000.0
15442,94,1,2021-03-19,1133,326,35945,17658,2021-03-19,1616108400.0
15443,94,1,2021-03-20,1379,283,37324,17941,2021-03-20,1616194800.0
15444,94,1,2021-03-21,470,73,37794,18014,2021-03-21,1616281200.0
15445,94,1,2021-03-22,772,181,38566,18195,2021-03-22,1616367600.0
15446,94,1,2021-03-23,1117,310,39683,18505,2021-03-23,1616454000.0
15447,94,1,2021-03-24,1133,292,40816,18797,2021-03-24,1616540400.0
15448,94,1,2021-03-25,1022,263,41838,19060,2021-03-25,1616626800.0
15449,94,1,2021-03-26,1224,320,43062,19380,2021-03-26,1616713200.0
15450,94,1,2021-03-27,1379,206,44441,19586,2021-03-27,1616799600.0
15451,94,1,2021-03-28,737,207,45178,19793,2021-03-28,1616886000.0
15452,94,1,2021-03-29,773,295,45951,20088,2021-03-29,1616972400.0
15453,94,1,2021-03-30,1125,542,47076,20630,2021-03-30,1617058800.0
15454,94,1,2021-03-31,1106,463,48182,21093,2021-03-31,1617145200.0
15455,94,1,2021-04-01,1141,652,49323,21745,2021-04-01,1617231600.0
15456,94,1,2021-04-02,1225,1171,50548,22916,2021-04-02,1617318000.0
15457,94,1,2021-04-03,565,1108,51113,24024,2021-04-03,1617404400.0
15458,94,1,2021-04-04,346,832,51459,24856,2021-04-04,1617490800.0
15459,94,1,2021-04-05,324,797,51783,25653,2021-04-05,1617577200.0
15460,94,1,2021-04-06,1414,874,53197,26527,2021-04-06,1617663600.0
15461,94,1,2021-04-07,1892,817,55089,27344,2021-04-07,1617750000.0
15462,94,1,2021-04-08,1923,722,57012,28066,2021-04-08,1617836400.0
15463,94,1,2021-04-09,1931,900,58943,28966,2021-04-09,1617922800.0
15464,94,1,2021-04-10,1603,552,60546,29518,2021-04-10,1618009200.0
15465,94,1,2021-04-11,600,297,61146,29815,2021-04-11,1618095600.0
15466,94,1,2021-04-12,1458,865,62604,30680,2021-04-12,1618185600.0
15467,94,1,2021-04-13,1315,985,63919,31665,2021-04-13,1618272000.0
15468,94,1,2021-04-14,2029,1041,65948,32706,2021-04-14,1618358400.0
15469,94,1,2021-04-15,1818,988,67766,33694,2021-04-15,1618444800.0
15470,94,1,2021-04-16,1752,992,69518,34686,2021-04-16,1618531200.0
15471,94,1,2021-04-17,1724,1098,71242,35784,2021-04-17,1618617600.0
15472,94,1,2021-04-18,1225,645,72467,36429,2021-04-18,1618704000.0
15473,94,1,2021-04-19,1077,743,73544,37172,2021-04-19,1618790400.0
15474,94,1,2021-04-20,1234,1150,74778,38322,2021-04-20,1618876800.0
15475,94,1,2021-04-21,1739,1106,76517,39428,2021-04-21,1618963200.0
15476,94,1,2021-04-22,1753,1107,78270,40535,2021-04-22,1619049600.0
15477,94,1,2021-04-23,1575,1052,79845,41587,2021-04-23,1619136000.0
15478,94,1,2021-04-24,1998,1018,81843,42605,2021-04-24,1619222400.0
15479,94,1,2021-04-25,1230,452,83073,43057,2021-04-25,1619308800.0
15480,94,1,2021-04-26,1002,1101,84075,44158,2021-04-26,1619395200.0
15481,94,1,2021-04-27,1295,1184,85370,45342,2021-04-27,1619481600.0
15482,94,1,2021-04-28,2551,1127,87921,46469,2021-04-28,1619568000.0
15483,94,1,2021-04-29,1913,1130,89834,47599,2021-04-29,1619654400.0
15484,94,1,2021-04-30,2189,1118,92023,48717,2021-04-30,1619740800.0
15485,94,1,2021-05-01,1234,361,93257,49078,2021-05-01,1619827200.0
15486,94,1,2021-05-02,1007,519,94264,49597,2021-05-02,1619913600.0
15487,94,1,2021-05-03,1567,754,95831,50351,2021-05-03,1620000000.0
15488,94,1,2021-05-04,1510,1532,97341,51883,2021-05-04,1620086400.0
15489,94,1,2021-05-05,1704,2083,99045,53966,2021-05-05,1620172800.0
15490,94,1,2021-05-06,2156,1554,101201,55520,2021-05-06,1620259200.0
15491,94,1,2021-05-07,2158,1552,103359,57072,2021-05-07,1620345600.0
15492,94,1,2021-05-08,830,700,104189,57772,2021-05-08,1620432000.0
15493,94,1,2021-05-09,1096,809,105285,58581,2021-05-09,1620518400.0
15494,94,1,2021-05-10,1350,1299,106635,59880,2021-05-10,1620604800.0
15495,94,1,2021-05-11,1544,1303,108179,61183,2021-05-11,1620691200.0
15496,94,1,2021-05-12,1725,1127,109904,62310,2021-05-12,1620777600.0
15497,94,1,2021-05-13,1939,352,111843,62662,2021-05-13,1620864000.0
15498,94,1,2021-05-14,1483,1025,113326,63687,2021-05-14,1620950400.0
15499,94,1,2021-05-15,1438,749,114764,64436,2021-05-15,1621036800.0
15500,94,1,2021-05-16,1024,576,115788,65012,2021-05-16,1621123200.0
15501,94,1,2021-05-17,1566,751,117354,65763,2021-05-17,1621206000.0
15502,94,1,2021-05-18,1565,616,118919,66379,2021-05-18,1621292400.0
15503,94,1,2021-05-19,1532,688,120451,67067,2021-05-19,1621378800.0
15504,94,1,2021-05-20,1260,569,121711,67636,2021-05-20,1621465200.0
15505,94,1,2021-05-21,1160,645,122871,68281,2021-05-21,1621551600.0
15506,94,1,2021-05-22,863,530,123734,68811,2021-05-22,1621638000.0
15507,94,1,2021-05-23,598,272,124332,69083,2021-05-23,1621724400.0
15508,94,1,2021-05-24,133,47,124465,69130,2021-05-24,1621810800.0
15509,94,1,2021-05-25,843,697,125308,69827,2021-05-25,1621897200.0
15510,94,1,2021-05-26,843,1696,126151,71523,2021-05-26,1621983600.0
15511,94,1,2021-05-27,643,1801,126794,73324,2021-05-27,1622070000.0
15512,94,1,2021-05-28,714,1499,127508,74823,2021-05-28,1622156400.0
15513,94,1,2021-05-29,594,1094,128102,75917,2021-05-29,1622242800.0
15514,94,1,2021-05-30,208,534,128310,76451,2021-05-30,1622329200.0
15515,94,1,2021-05-31,449,1039,128759,77490,2021-05-31,1622415600.0
15516,94,1,2021-06-01,591,1453,129350,78943,2021-06-01,1622502000.0
15517,94,1,2021-06-02,479,1669,129829,80612,2021-06-02,1622588400.0
15518,94,1,2021-06-03,599,1327,130428,81939,2021-06-03,1622674800.0
15519,94,1,2021-06-04,488,1994,130916,83933,2021-06-04,1622761200.0
15520,94,1,2021-06-05,442,1665,131358,85598,2021-06-05,1622847600.0
15521,94,1,2021-06-06,159,1002,131517,86600,2021-06-06,1622934000.0
15522,94,1,2021-06-07,331,1457,131848,88057,2021-06-07,1623020400.0
15523,94,1,2021-06-08,559,1668,132407,89725,2021-06-08,1623106800.0
15524,94,1,2021-06-09,696,2237,133103,91962,2021-06-09,1623193200.0
15525,94,1,2021-06-10,555,1528,133658,93490,2021-06-10,1623279600.0
15526,94,1,2021-06-11,536,1931,134194,95421,2021-06-11,1623366000.0
15527,94,1,2021-06-12,204,900,134398,96321,2021-06-12,1623452400.0
15528,94,1,2021-06-13,131,837,134529,97158,2021-06-13,1623538800.0
15529,94,1,2021-06-14,288,1839,134817,98997,2021-06-14,1623625200.0
15530,94,1,2021-06-15,409,1471,135226,100468,2021-06-15,1623711600.0
15531,94,1,2021-06-16,490,1417,135716,101885,2021-06-16,1623798000.0
15532,94,1,2021-06-17,461,1269,136177,103154,2021-06-17,1623884400.0
15533,94,1,2021-06-18,504,1510,136681,104664,2021-06-18,1623970800.0
15534,94,1,2021-06-19,300,883,136981,105547,2021-06-19,1624057200.0
15535,94,1,2021-06-20,161,851,137142,106398,2021-06-20,1624143600.0
15536,94,1,2021-06-21,390,1659,137532,108057,2021-06-21,1624230000.0
15537,94,1,2021-06-22,456,1802,137988,109859,2021-06-22,1624316400.0
15538,94,1,2021-06-23,352,1313,138340,111172,2021-06-23,1624402800.0
15539,94,1,2021-06-24,395,928,138735,112100,2021-06-24,1624489200.0
15540,94,1,2021-06-25,278,1184,139013,113284,2021-06-25,1624575600.0
15541,94,1,2021-06-26,255,1291,139268,114575,2021-06-26,1624662000.0
15542,94,1,2021-06-27,193,954,139461,115529,2021-06-27,1624748400.0
15543,94,1,2021-06-28,459,1454,139920,116983,2021-06-28,1624834800.0
15544,94,1,2021-06-29,431,1473,140351,118456,2021-06-29,1624921200.0
15545,94,1,2021-06-30,542,1245,140893,119701,2021-06-30,1625007600.0
15546,94,1,2021-07-01,339,798,141232,120499,2021-07-01,1625094000.0
15547,94,1,2021-07-02,313,693,141545,121192,2021-07-02,1625180400.0
15548,94,1,2021-07-03,250,825,141795,122017,2021-07-03,1625266800.0
15549,94,1,2021-07-04,167,540,141962,122557,2021-07-04,1625353200.0
15550,94,1,2021-07-05,394,720,142356,123277,2021-07-05,1625439600.0
15551,94,1,2021-07-06,616,761,142972,124038,2021-07-06,1625526000.0
15552,94,2,2020-12-27,0,0,0,0,2020-12-27,1609023600.0
15553,94,2,2020-12-28,0,0,0,0,2020-12-28,1609110000.0
15554,94,2,2020-12-29,0,0,0,0,2020-12-29,1609196400.0
15555,94,2,2020-12-30,0,0,0,0,2020-12-30,1609282800.0
15556,94,2,2020-12-31,0,0,0,0,2020-12-31,1609369200.0
15557,94,2,2021-01-01,0,0,0,0,2021-01-01,1609455600.0
15558,94,2,2021-01-02,0,0,0,0,2021-01-02,1609542000.0
15559,94,2,2021-01-03,0,0,0,0,2021-01-03,1609628400.0
15560,94,2,2021-01-04,0,0,0,0,2021-01-04,1609714800.0
15561,94,2,2021-01-05,0,0,0,0,2021-01-05,1609801200.0
15562,94,2,2021-01-06,0,0,0,0,2021-01-06,1609887600.0
15563,94,2,2021-01-07,0,0,0,0,2021-01-07,1609974000.0
15564,94,2,2021-01-08,0,0,0,0,2021-01-08,1610060400.0
15565,94,2,2021-01-09,0,0,0,0,2021-01-09,1610146800.0
15566,94,2,2021-01-10,0,0,0,0,2021-01-10,1610233200.0
15567,94,2,2021-01-11,0,0,0,0,2021-01-11,1610319600.0
15568,94,2,2021-01-12,0,0,0,0,2021-01-12,1610406000.0
15569,94,2,2021-01-13,0,0,0,0,2021-01-13,1610492400.0
15570,94,2,2021-01-14,0,0,0,0,2021-01-14,1610578800.0
15571,94,2,2021-01-15,1,0,1,0,2021-01-15,1610665200.0
15572,94,2,2021-01-16,0,0,1,0,2021-01-16,1610751600.0
15573,94,2,2021-01-17,0,0,1,0,2021-01-17,1610838000.0
15574,94,2,2021-01-18,0,0,1,0,2021-01-18,1610924400.0
15575,94,2,2021-01-19,0,0,1,0,2021-01-19,1611010800.0
15576,94,2,2021-01-20,0,0,1,0,2021-01-20,1611097200.0
15577,94,2,2021-01-21,0,0,1,0,2021-01-21,1611183600.0
15578,94,2,2021-01-22,1,0,2,0,2021-01-22,1611270000.0
15579,94,2,2021-01-23,0,0,2,0,2021-01-23,1611356400.0
15580,94,2,2021-01-24,0,0,2,0,2021-01-24,1611442800.0
15581,94,2,2021-01-25,0,0,2,0,2021-01-25,1611529200.0
15582,94,2,2021-01-26,0,0,2,0,2021-01-26,1611615600.0
15583,94,2,2021-01-27,0,0,2,0,2021-01-27,1611702000.0
15584,94,2,2021-01-28,0,0,2,0,2021-01-28,1611788400.0
15585,94,2,2021-01-29,1,0,3,0,2021-01-29,1611874800.0
15586,94,2,2021-01-30,0,0,3,0,2021-01-30,1611961200.0
15587,94,2,2021-01-31,0,0,3,0,2021-01-31,1612047600.0
15588,94,2,2021-02-01,0,0,3,0,2021-02-01,1612134000.0
15589,94,2,2021-02-02,0,0,3,0,2021-02-02,1612220400.0
15590,94,2,2021-02-03,0,0,3,0,2021-02-03,1612306800.0
15591,94,2,2021-02-04,0,1,3,1,2021-02-04,1612393200.0
15592,94,2,2021-02-05,0,0,3,1,2021-02-05,1612479600.0
15593,94,2,2021-02-06,0,0,3,1,2021-02-06,1612566000.0
15594,94,2,2021-02-07,0,0,3,1,2021-02-07,1612652400.0
15595,94,2,2021-02-08,0,0,3,1,2021-02-08,1612738800.0
15596,94,2,2021-02-09,0,0,3,1,2021-02-09,1612825200.0
15597,94,2,2021-02-10,1,0,4,1,2021-02-10,1612911600.0
15598,94,2,2021-02-11,98,0,102,1,2021-02-11,1612998000.0
15599,94,2,2021-02-12,176,0,278,1,2021-02-12,1613084400.0
15600,94,2,2021-02-13,167,0,445,1,2021-02-13,1613170800.0
15601,94,2,2021-02-14,83,0,528,1,2021-02-14,1613257200.0
15602,94,2,2021-02-15,166,0,694,1,2021-02-15,1613343600.0
15603,94,2,2021-02-16,251,0,945,1,2021-02-16,1613430000.0
15604,94,2,2021-02-17,183,0,1128,1,2021-02-17,1613516400.0
15605,94,2,2021-02-18,233,0,1361,1,2021-02-18,1613602800.0
15606,94,2,2021-02-19,0,0,1361,1,2021-02-19,1613689200.0
15607,94,2,2021-02-20,0,0,1361,1,2021-02-20,1613775600.0
15608,94,2,2021-02-21,0,0,1361,1,2021-02-21,1613862000.0
15609,94,2,2021-02-22,0,0,1361,1,2021-02-22,1613948400.0
15610,94,2,2021-02-23,0,1,1361,2,2021-02-23,1614034800.0
15611,94,2,2021-02-24,0,0,1361,2,2021-02-24,1614121200.0
15612,94,2,2021-02-25,0,0,1361,2,2021-02-25,1614207600.0
15613,94,2,2021-02-26,0,1,1361,3,2021-02-26,1614294000.0
15614,94,2,2021-02-27,0,0,1361,3,2021-02-27,1614380400.0
15615,94,2,2021-02-28,0,0,1361,3,2021-02-28,1614466800.0
15616,94,2,2021-03-01,0,0,1361,3,2021-03-01,1614553200.0
15617,94,2,2021-03-02,1,0,1362,3,2021-03-02,1614639600.0
15618,94,2,2021-03-03,0,0,1362,3,2021-03-03,1614726000.0
15619,94,2,2021-03-04,0,0,1362,3,2021-03-04,1614812400.0
15620,94,2,2021-03-05,0,0,1362,3,2021-03-05,1614898800.0
15621,94,2,2021-03-06,0,0,1362,3,2021-03-06,1614985200.0
15622,94,2,2021-03-07,0,0,1362,3,2021-03-07,1615071600.0
15623,94,2,2021-03-08,0,0,1362,3,2021-03-08,1615158000.0
15624,94,2,2021-03-09,0,0,1362,3,2021-03-09,1615244400.0
15625,94,2,2021-03-10,0,0,1362,3,2021-03-10,1615330800.0
15626,94,2,2021-03-11,1,103,1363,106,2021-03-11,1615417200.0
15627,94,2,2021-03-12,4,188,1367,294,2021-03-12,1615503600.0
15628,94,2,2021-03-13,24,158,1391,452,2021-03-13,1615590000.0
15629,94,2,2021-03-14,2,86,1393,538,2021-03-14,1615676400.0
15630,94,2,2021-03-15,0,164,1393,702,2021-03-15,1615762800.0
15631,94,2,2021-03-16,2,243,1395,945,2021-03-16,1615849200.0
15632,94,2,2021-03-17,0,176,1395,1121,2021-03-17,1615935600.0
15633,94,2,2021-03-18,28,216,1423,1337,2021-03-18,1616022000.0
15634,94,2,2021-03-19,0,0,1423,1337,2021-03-19,1616108400.0
15635,94,2,2021-03-20,240,0,1663,1337,2021-03-20,1616194800.0
15636,94,2,2021-03-21,644,1,2307,1338,2021-03-21,1616281200.0
15637,94,2,2021-03-22,5,0,2312,1338,2021-03-22,1616367600.0
15638,94,2,2021-03-23,13,0,2325,1338,2021-03-23,1616454000.0
15639,94,2,2021-03-24,187,0,2512,1338,2021-03-24,1616540400.0
15640,94,2,2021-03-25,249,0,2761,1338,2021-03-25,1616626800.0
15641,94,2,2021-03-26,365,1,3126,1339,2021-03-26,1616713200.0
15642,94,2,2021-03-27,674,0,3800,1339,2021-03-27,1616799600.0
15643,94,2,2021-03-28,322,1,4122,1340,2021-03-28,1616886000.0
15644,94,2,2021-03-29,0,0,4122,1340,2021-03-29,1616972400.0
15645,94,2,2021-03-30,0,1,4122,1341,2021-03-30,1617058800.0
15646,94,2,2021-03-31,119,1,4241,1342,2021-03-31,1617145200.0
15647,94,2,2021-04-01,239,0,4480,1342,2021-04-01,1617231600.0
15648,94,2,2021-04-02,383,1,4863,1343,2021-04-02,1617318000.0
15649,94,2,2021-04-03,1279,1,6142,1344,2021-04-03,1617404400.0
15650,94,2,2021-04-04,406,0,6548,1344,2021-04-04,1617490800.0
15651,94,2,2021-04-05,294,0,6842,1344,2021-04-05,1617577200.0
15652,94,2,2021-04-06,106,0,6948,1344,2021-04-06,1617663600.0
15653,94,2,2021-04-07,35,1,6983,1345,2021-04-07,1617750000.0
15654,94,2,2021-04-08,85,0,7068,1345,2021-04-08,1617836400.0
15655,94,2,2021-04-09,42,0,7110,1345,2021-04-09,1617922800.0
15656,94,2,2021-04-10,757,28,7867,1373,2021-04-10,1618009200.0
15657,94,2,2021-04-11,572,0,8439,1373,2021-04-11,1618095600.0
15658,94,2,2021-04-12,7,5,8446,1378,2021-04-12,1618185600.0
15659,94,2,2021-04-13,0,0,8446,1378,2021-04-13,1618272000.0
15660,94,2,2021-04-14,7,4,8453,1382,2021-04-14,1618358400.0
15661,94,2,2021-04-15,0,0,8453,1382,2021-04-15,1618444800.0
15662,94,2,2021-04-16,0,0,8453,1382,2021-04-16,1618531200.0
15663,94,2,2021-04-17,9,246,8462,1628,2021-04-17,1618617600.0
15664,94,2,2021-04-18,9,623,8471,2251,2021-04-18,1618704000.0
15665,94,2,2021-04-19,0,0,8471,2251,2021-04-19,1618790400.0
15666,94,2,2021-04-20,0,0,8471,2251,2021-04-20,1618876800.0
15667,94,2,2021-04-21,3,187,8474,2438,2021-04-21,1618963200.0
15668,94,2,2021-04-22,6,232,8480,2670,2021-04-22,1619049600.0
15669,94,2,2021-04-23,19,298,8499,2968,2021-04-23,1619136000.0
15670,94,2,2021-04-24,12,689,8511,3657,2021-04-24,1619222400.0
15671,94,2,2021-04-25,31,303,8542,3960,2021-04-25,1619308800.0
15672,94,2,2021-04-26,0,18,8542,3978,2021-04-26,1619395200.0
15673,94,2,2021-04-27,0,0,8542,3978,2021-04-27,1619481600.0
15674,94,2,2021-04-28,0,60,8542,4038,2021-04-28,1619568000.0
15675,94,2,2021-04-29,0,0,8542,4038,2021-04-29,1619654400.0
15676,94,2,2021-04-30,1,617,8543,4655,2021-04-30,1619740800.0
15677,94,2,2021-05-01,182,1288,8725,5943,2021-05-01,1619827200.0
15678,94,2,2021-05-02,2,402,8727,6345,2021-05-02,1619913600.0
15679,94,2,2021-05-03,0,251,8727,6596,2021-05-03,1620000000.0
15680,94,2,2021-05-04,0,45,8727,6641,2021-05-04,1620086400.0
15681,94,2,2021-05-05,46,110,8773,6751,2021-05-05,1620172800.0
15682,94,2,2021-05-06,3,88,8776,6839,2021-05-06,1620259200.0
15683,94,2,2021-05-07,0,42,8776,6881,2021-05-07,1620345600.0
15684,94,2,2021-05-08,39,569,8815,7450,2021-05-08,1620432000.0
15685,94,2,2021-05-09,72,475,8887,7925,2021-05-09,1620518400.0
15686,94,2,2021-05-10,0,115,8887,8040,2021-05-10,1620604800.0
15687,94,2,2021-05-11,0,85,8887,8125,2021-05-11,1620691200.0
15688,94,2,2021-05-12,0,22,8887,8147,2021-05-12,1620777600.0
15689,94,2,2021-05-13,0,0,8887,8147,2021-05-13,1620864000.0
15690,94,2,2021-05-14,0,0,8887,8147,2021-05-14,1620950400.0
15691,94,2,2021-05-15,26,34,8913,8181,2021-05-15,1621036800.0
15692,94,2,2021-05-16,0,0,8913,8181,2021-05-16,1621123200.0
15693,94,2,2021-05-17,8,2,8921,8183,2021-05-17,1621206000.0
15694,94,2,2021-05-18,13,1,8934,8184,2021-05-18,1621292400.0
15695,94,2,2021-05-19,11,1,8945,8185,2021-05-19,1621378800.0
15696,94,2,2021-05-20,55,25,9000,8210,2021-05-20,1621465200.0
15697,94,2,2021-05-21,38,32,9038,8242,2021-05-21,1621551600.0
15698,94,2,2021-05-22,133,24,9171,8266,2021-05-22,1621638000.0
15699,94,2,2021-05-23,93,1,9264,8267,2021-05-23,1621724400.0
15700,94,2,2021-05-24,22,1,9286,8268,2021-05-24,1621810800.0
15701,94,2,2021-05-25,99,10,9385,8278,2021-05-25,1621897200.0
15702,94,2,2021-05-26,78,19,9463,8297,2021-05-26,1621983600.0
15703,94,2,2021-05-27,167,6,9630,8303,2021-05-27,1622070000.0
15704,94,2,2021-05-28,73,16,9703,8319,2021-05-28,1622156400.0
15705,94,2,2021-05-29,40,22,9743,8341,2021-05-29,1622242800.0
15706,94,2,2021-05-30,17,6,9760,8347,2021-05-30,1622329200.0
15707,94,2,2021-05-31,84,5,9844,8352,2021-05-31,1622415600.0
15708,94,2,2021-06-01,108,9,9952,8361,2021-06-01,1622502000.0
15709,94,2,2021-06-02,115,6,10067,8367,2021-06-02,1622588400.0
15710,94,2,2021-06-03,159,14,10226,8381,2021-06-03,1622674800.0
15711,94,2,2021-06-04,81,11,10307,8392,2021-06-04,1622761200.0
15712,94,2,2021-06-05,71,78,10378,8470,2021-06-05,1622847600.0
15713,94,2,2021-06-06,56,5,10434,8475,2021-06-06,1622934000.0
15714,94,2,2021-06-07,78,18,10512,8493,2021-06-07,1623020400.0
15715,94,2,2021-06-08,108,12,10620,8505,2021-06-08,1623106800.0
15716,94,2,2021-06-09,79,3,10699,8508,2021-06-09,1623193200.0
15717,94,2,2021-06-10,78,7,10777,8515,2021-06-10,1623279600.0
15718,94,2,2021-06-11,102,41,10879,8556,2021-06-11,1623366000.0
15719,94,2,2021-06-12,120,170,10999,8726,2021-06-12,1623452400.0
15720,94,2,2021-06-13,71,0,11070,8726,2021-06-13,1623538800.0
15721,94,2,2021-06-14,101,9,11171,8735,2021-06-14,1623625200.0
15722,94,2,2021-06-15,89,8,11260,8743,2021-06-15,1623711600.0
15723,94,2,2021-06-16,37,40,11297,8783,2021-06-16,1623798000.0
15724,94,2,2021-06-17,107,17,11404,8800,2021-06-17,1623884400.0
15725,94,2,2021-06-18,45,66,11449,8866,2021-06-18,1623970800.0
15726,94,2,2021-06-19,22,13,11471,8879,2021-06-19,1624057200.0
15727,94,2,2021-06-20,27,7,11498,8886,2021-06-20,1624143600.0
15728,94,2,2021-06-21,33,16,11531,8902,2021-06-21,1624230000.0
15729,94,2,2021-06-22,65,21,11596,8923,2021-06-22,1624316400.0
15730,94,2,2021-06-23,33,6,11629,8929,2021-06-23,1624402800.0
15731,94,2,2021-06-24,45,14,11674,8943,2021-06-24,1624489200.0
15732,94,2,2021-06-25,55,117,11729,9060,2021-06-25,1624575600.0
15733,94,2,2021-06-26,26,67,11755,9127,2021-06-26,1624662000.0
15734,94,2,2021-06-27,6,26,11761,9153,2021-06-27,1624748400.0
15735,94,2,2021-06-28,33,79,11794,9232,2021-06-28,1624834800.0
15736,94,2,2021-06-29,25,90,11819,9322,2021-06-29,1624921200.0
15737,94,2,2021-06-30,31,85,11850,9407,2021-06-30,1625007600.0
15738,94,2,2021-07-01,45,83,11895,9490,2021-07-01,1625094000.0
15739,94,2,2021-07-02,23,96,11918,9586,2021-07-02,1625180400.0
15740,94,2,2021-07-03,27,137,11945,9723,2021-07-03,1625266800.0
15741,94,2,2021-07-04,1,116,11946,9839,2021-07-04,1625353200.0
15742,94,2,2021-07-05,7,95,11953,9934,2021-07-05,1625439600.0
15743,94,2,2021-07-06,37,205,11990,10139,2021-07-06,1625526000.0
15744,94,3,2020-12-27,0,0,0,0,2020-12-27,1609023600.0
15745,94,3,2020-12-28,0,0,0,0,2020-12-28,1609110000.0
15746,94,3,2020-12-29,0,0,0,0,2020-12-29,1609196400.0
15747,94,3,2020-12-30,0,0,0,0,2020-12-30,1609282800.0
15748,94,3,2020-12-31,0,0,0,0,2020-12-31,1609369200.0
15749,94,3,2021-01-01,0,0,0,0,2021-01-01,1609455600.0
15750,94,3,2021-01-02,0,0,0,0,2021-01-02,1609542000.0
15751,94,3,2021-01-03,0,0,0,0,2021-01-03,1609628400.0
15752,94,3,2021-01-04,0,0,0,0,2021-01-04,1609714800.0
15753,94,3,2021-01-05,0,0,0,0,2021-01-05,1609801200.0
15754,94,3,2021-01-06,0,0,0,0,2021-01-06,1609887600.0
15755,94,3,2021-01-07,0,0,0,0,2021-01-07,1609974000.0
15756,94,3,2021-01-08,0,0,0,0,2021-01-08,1610060400.0
15757,94,3,2021-01-09,0,0,0,0,2021-01-09,1610146800.0
15758,94,3,2021-01-10,0,0,0,0,2021-01-10,1610233200.0
15759,94,3,2021-01-11,0,0,0,0,2021-01-11,1610319600.0
15760,94,3,2021-01-12,0,0,0,0,2021-01-12,1610406000.0
15761,94,3,2021-01-13,0,0,0,0,2021-01-13,1610492400.0
15762,94,3,2021-01-14,0,0,0,0,2021-01-14,1610578800.0
15763,94,3,2021-01-15,0,0,0,0,2021-01-15,1610665200.0
15764,94,3,2021-01-16,0,0,0,0,2021-01-16,1610751600.0
15765,94,3,2021-01-17,0,0,0,0,2021-01-17,1610838000.0
15766,94,3,2021-01-18,0,0,0,0,2021-01-18,1610924400.0
15767,94,3,2021-01-19,0,0,0,0,2021-01-19,1611010800.0
15768,94,3,2021-01-20,0,0,0,0,2021-01-20,1611097200.0
15769,94,3,2021-01-21,0,0,0,0,2021-01-21,1611183600.0
15770,94,3,2021-01-22,0,0,0,0,2021-01-22,1611270000.0
15771,94,3,2021-01-23,0,0,0,0,2021-01-23,1611356400.0
15772,94,3,2021-01-24,0,0,0,0,2021-01-24,1611442800.0
15773,94,3,2021-01-25,0,0,0,0,2021-01-25,1611529200.0
15774,94,3,2021-01-26,0,0,0,0,2021-01-26,1611615600.0
15775,94,3,2021-01-27,0,0,0,0,2021-01-27,1611702000.0
15776,94,3,2021-01-28,0,0,0,0,2021-01-28,1611788400.0
15777,94,3,2021-01-29,0,0,0,0,2021-01-29,1611874800.0
15778,94,3,2021-01-30,0,0,0,0,2021-01-30,1611961200.0
15779,94,3,2021-01-31,0,0,0,0,2021-01-31,1612047600.0
15780,94,3,2021-02-01,0,0,0,0,2021-02-01,1612134000.0
15781,94,3,2021-02-02,0,0,0,0,2021-02-02,1612220400.0
15782,94,3,2021-02-03,0,0,0,0,2021-02-03,1612306800.0
15783,94,3,2021-02-04,0,0,0,0,2021-02-04,1612393200.0
15784,94,3,2021-02-05,0,0,0,0,2021-02-05,1612479600.0
15785,94,3,2021-02-06,1,0,1,0,2021-02-06,1612566000.0
15786,94,3,2021-02-07,0,0,1,0,2021-02-07,1612652400.0
15787,94,3,2021-02-08,0,0,1,0,2021-02-08,1612738800.0
15788,94,3,2021-02-09,0,0,1,0,2021-02-09,1612825200.0
15789,94,3,2021-02-10,0,0,1,0,2021-02-10,1612911600.0
15790,94,3,2021-02-11,0,0,1,0,2021-02-11,1612998000.0
15791,94,3,2021-02-12,0,0,1,0,2021-02-12,1613084400.0
15792,94,3,2021-02-13,0,0,1,0,2021-02-13,1613170800.0
15793,94,3,2021-02-14,0,0,1,0,2021-02-14,1613257200.0
15794,94,3,2021-02-15,26,0,27,0,2021-02-15,1613343600.0
15795,94,3,2021-02-16,67,0,94,0,2021-02-16,1613430000.0
15796,94,3,2021-02-17,14,0,108,0,2021-02-17,1613516400.0
15797,94,3,2021-02-18,4,0,112,0,2021-02-18,1613602800.0
15798,94,3,2021-02-19,12,0,124,0,2021-02-19,1613689200.0
15799,94,3,2021-02-20,0,0,124,0,2021-02-20,1613775600.0
15800,94,3,2021-02-21,0,0,124,0,2021-02-21,1613862000.0
15801,94,3,2021-02-22,26,0,150,0,2021-02-22,1613948400.0
15802,94,3,2021-02-23,12,0,162,0,2021-02-23,1614034800.0
15803,94,3,2021-02-24,2,0,164,0,2021-02-24,1614121200.0
15804,94,3,2021-02-25,72,0,236,0,2021-02-25,1614207600.0
15805,94,3,2021-02-26,104,0,340,0,2021-02-26,1614294000.0
15806,94,3,2021-02-27,60,0,400,0,2021-02-27,1614380400.0
15807,94,3,2021-02-28,11,0,411,0,2021-02-28,1614466800.0
15808,94,3,2021-03-01,96,0,507,0,2021-03-01,1614553200.0
15809,94,3,2021-03-02,153,0,660,0,2021-03-02,1614639600.0
15810,94,3,2021-03-03,237,0,897,0,2021-03-03,1614726000.0
15811,94,3,2021-03-04,270,0,1167,0,2021-03-04,1614812400.0
15812,94,3,2021-03-05,392,0,1559,0,2021-03-05,1614898800.0
15813,94,3,2021-03-06,444,0,2003,0,2021-03-06,1614985200.0
15814,94,3,2021-03-07,238,0,2241,0,2021-03-07,1615071600.0
15815,94,3,2021-03-08,249,0,2490,0,2021-03-08,1615158000.0
15816,94,3,2021-03-09,497,0,2987,0,2021-03-09,1615244400.0
15817,94,3,2021-03-10,411,0,3398,0,2021-03-10,1615330800.0
15818,94,3,2021-03-11,629,0,4027,0,2021-03-11,1615417200.0
15819,94,3,2021-03-12,658,0,4685,0,2021-03-12,1615503600.0
15820,94,3,2021-03-13,421,0,5106,0,2021-03-13,1615590000.0
15821,94,3,2021-03-14,146,0,5252,0,2021-03-14,1615676400.0
15822,94,3,2021-03-15,208,0,5460,0,2021-03-15,1615762800.0
15823,94,3,2021-03-16,6,0,5466,0,2021-03-16,1615849200.0
15824,94,3,2021-03-17,0,0,5466,0,2021-03-17,1615935600.0
15825,94,3,2021-03-18,5,0,5471,0,2021-03-18,1616022000.0
15826,94,3,2021-03-19,153,0,5624,0,2021-03-19,1616108400.0
15827,94,3,2021-03-20,113,0,5737,0,2021-03-20,1616194800.0
15828,94,3,2021-03-21,12,0,5749,0,2021-03-21,1616281200.0
15829,94,3,2021-03-22,112,0,5861,0,2021-03-22,1616367600.0
15830,94,3,2021-03-23,172,0,6033,0,2021-03-23,1616454000.0
15831,94,3,2021-03-24,368,0,6401,0,2021-03-24,1616540400.0
15832,94,3,2021-03-25,482,0,6883,0,2021-03-25,1616626800.0
15833,94,3,2021-03-26,442,0,7325,0,2021-03-26,1616713200.0
15834,94,3,2021-03-27,220,0,7545,0,2021-03-27,1616799600.0
15835,94,3,2021-03-28,11,0,7556,0,2021-03-28,1616886000.0
15836,94,3,2021-03-29,252,0,7808,0,2021-03-29,1616972400.0
15837,94,3,2021-03-30,227,0,8035,0,2021-03-30,1617058800.0
15838,94,3,2021-03-31,202,1,8237,1,2021-03-31,1617145200.0
15839,94,3,2021-04-01,258,9,8495,10,2021-04-01,1617231600.0
15840,94,3,2021-04-02,255,0,8750,10,2021-04-02,1617318000.0
15841,94,3,2021-04-03,46,0,8796,10,2021-04-03,1617404400.0
15842,94,3,2021-04-04,19,1,8815,11,2021-04-04,1617490800.0
15843,94,3,2021-04-05,11,0,8826,11,2021-04-05,1617577200.0
15844,94,3,2021-04-06,59,2,8885,13,2021-04-06,1617663600.0
15845,94,3,2021-04-07,83,9,8968,22,2021-04-07,1617750000.0
15846,94,3,2021-04-08,166,1,9134,23,2021-04-08,1617836400.0
15847,94,3,2021-04-09,127,0,9261,23,2021-04-09,1617922800.0
15848,94,3,2021-04-10,42,0,9303,23,2021-04-10,1618009200.0
15849,94,3,2021-04-11,1,0,9304,23,2021-04-11,1618095600.0
15850,94,3,2021-04-12,52,1,9356,24,2021-04-12,1618185600.0
15851,94,3,2021-04-13,69,0,9425,24,2021-04-13,1618272000.0
15852,94,3,2021-04-14,52,0,9477,24,2021-04-14,1618358400.0
15853,94,3,2021-04-15,104,2,9581,26,2021-04-15,1618444800.0
15854,94,3,2021-04-16,25,0,9606,26,2021-04-16,1618531200.0
15855,94,3,2021-04-17,17,0,9623,26,2021-04-17,1618617600.0
15856,94,3,2021-04-18,0,0,9623,26,2021-04-18,1618704000.0
15857,94,3,2021-04-19,14,1,9637,27,2021-04-19,1618790400.0
15858,94,3,2021-04-20,15,0,9652,27,2021-04-20,1618876800.0
15859,94,3,2021-04-21,39,0,9691,27,2021-04-21,1618963200.0
15860,94,3,2021-04-22,73,0,9764,27,2021-04-22,1619049600.0
15861,94,3,2021-04-23,53,11,9817,38,2021-04-23,1619136000.0
15862,94,3,2021-04-24,20,2,9837,40,2021-04-24,1619222400.0
15863,94,3,2021-04-25,0,4,9837,44,2021-04-25,1619308800.0
15864,94,3,2021-04-26,13,1,9850,45,2021-04-26,1619395200.0
15865,94,3,2021-04-27,8,2,9858,47,2021-04-27,1619481600.0
15866,94,3,2021-04-28,26,12,9884,59,2021-04-28,1619568000.0
15867,94,3,2021-04-29,9,12,9893,71,2021-04-29,1619654400.0
15868,94,3,2021-04-30,20,41,9913,112,2021-04-30,1619740800.0
15869,94,3,2021-05-01,7,9,9920,121,2021-05-01,1619827200.0
15870,94,3,2021-05-02,0,2,9920,123,2021-05-02,1619913600.0
15871,94,3,2021-05-03,17,12,9937,135,2021-05-03,1620000000.0
15872,94,3,2021-05-04,33,45,9970,180,2021-05-04,1620086400.0
15873,94,3,2021-05-05,17,82,9987,262,2021-05-05,1620172800.0
15874,94,3,2021-05-06,15,99,10002,361,2021-05-06,1620259200.0
15875,94,3,2021-05-07,29,134,10031,495,2021-05-07,1620345600.0
15876,94,3,2021-05-08,3,62,10034,557,2021-05-08,1620432000.0
15877,94,3,2021-05-09,2,5,10036,562,2021-05-09,1620518400.0
15878,94,3,2021-05-10,2,66,10038,628,2021-05-10,1620604800.0
15879,94,3,2021-05-11,4,93,10042,721,2021-05-11,1620691200.0
15880,94,3,2021-05-12,23,149,10065,870,2021-05-12,1620777600.0
15881,94,3,2021-05-13,1,84,10066,954,2021-05-13,1620864000.0
15882,94,3,2021-05-14,12,147,10078,1101,2021-05-14,1620950400.0
15883,94,3,2021-05-15,3,162,10081,1263,2021-05-15,1621036800.0
15884,94,3,2021-05-16,0,48,10081,1311,2021-05-16,1621123200.0
15885,94,3,2021-05-17,4,159,10085,1470,2021-05-17,1621206000.0
15886,94,3,2021-05-18,1,167,10086,1637,2021-05-18,1621292400.0
15887,94,3,2021-05-19,5,146,10091,1783,2021-05-19,1621378800.0
15888,94,3,2021-05-20,16,235,10107,2018,2021-05-20,1621465200.0
15889,94,3,2021-05-21,9,225,10116,2243,2021-05-21,1621551600.0
15890,94,3,2021-05-22,3,84,10119,2327,2021-05-22,1621638000.0
15891,94,3,2021-05-23,0,33,10119,2360,2021-05-23,1621724400.0
15892,94,3,2021-05-24,0,79,10119,2439,2021-05-24,1621810800.0
15893,94,3,2021-05-25,2,70,10121,2509,2021-05-25,1621897200.0
15894,94,3,2021-05-26,10,175,10131,2684,2021-05-26,1621983600.0
15895,94,3,2021-05-27,10,380,10141,3064,2021-05-27,1622070000.0
15896,94,3,2021-05-28,11,230,10152,3294,2021-05-28,1622156400.0
15897,94,3,2021-05-29,3,97,10155,3391,2021-05-29,1622242800.0
15898,94,3,2021-05-30,1,0,10156,3391,2021-05-30,1622329200.0
15899,94,3,2021-05-31,4,158,10160,3549,2021-05-31,1622415600.0
15900,94,3,2021-06-01,2,230,10162,3779,2021-06-01,1622502000.0
15901,94,3,2021-06-02,3,191,10165,3970,2021-06-02,1622588400.0
15902,94,3,2021-06-03,6,254,10171,4224,2021-06-03,1622674800.0
15903,94,3,2021-06-04,4,285,10175,4509,2021-06-04,1622761200.0
15904,94,3,2021-06-05,2,122,10177,4631,2021-06-05,1622847600.0
15905,94,3,2021-06-06,0,18,10177,4649,2021-06-06,1622934000.0
15906,94,3,2021-06-07,1,81,10178,4730,2021-06-07,1623020400.0
15907,94,3,2021-06-08,1,124,10179,4854,2021-06-08,1623106800.0
15908,94,3,2021-06-09,1,169,10180,5023,2021-06-09,1623193200.0
15909,94,3,2021-06-10,6,170,10186,5193,2021-06-10,1623279600.0
15910,94,3,2021-06-11,9,241,10195,5434,2021-06-11,1623366000.0
15911,94,3,2021-06-12,1,80,10196,5514,2021-06-12,1623452400.0
15912,94,3,2021-06-13,1,1,10197,5515,2021-06-13,1623538800.0
15913,94,3,2021-06-14,4,138,10201,5653,2021-06-14,1623625200.0
15914,94,3,2021-06-15,0,162,10201,5815,2021-06-15,1623711600.0
15915,94,3,2021-06-16,3,171,10204,5986,2021-06-16,1623798000.0
15916,94,3,2021-06-17,4,270,10208,6256,2021-06-17,1623884400.0
15917,94,3,2021-06-18,2,238,10210,6494,2021-06-18,1623970800.0
15918,94,3,2021-06-19,3,80,10213,6574,2021-06-19,1624057200.0
15919,94,3,2021-06-20,0,12,10213,6586,2021-06-20,1624143600.0
15920,94,3,2021-06-21,0,40,10213,6626,2021-06-21,1624230000.0
15921,94,3,2021-06-22,1,74,10214,6700,2021-06-22,1624316400.0
15922,94,3,2021-06-23,1,76,10215,6776,2021-06-23,1624402800.0
15923,94,3,2021-06-24,6,135,10221,6911,2021-06-24,1624489200.0
15924,94,3,2021-06-25,2,185,10223,7096,2021-06-25,1624575600.0
15925,94,3,2021-06-26,2,23,10225,7119,2021-06-26,1624662000.0
15926,94,3,2021-06-27,0,4,10225,7123,2021-06-27,1624748400.0
15927,94,3,2021-06-28,2,55,10227,7178,2021-06-28,1624834800.0
15928,94,3,2021-06-29,0,54,10227,7232,2021-06-29,1624921200.0
15929,94,3,2021-06-30,2,28,10229,7260,2021-06-30,1625007600.0
15930,94,3,2021-07-01,0,35,10229,7295,2021-07-01,1625094000.0
15931,94,3,2021-07-02,0,58,10229,7353,2021-07-02,1625180400.0
15932,94,3,2021-07-03,1,3,10230,7356,2021-07-03,1625266800.0
15933,94,3,2021-07-04,0,0,10230,7356,2021-07-04,1625353200.0
15934,94,3,2021-07-05,0,30,10230,7386,2021-07-05,1625439600.0
15935,94,3,2021-07-06,3,22,10233,7408,2021-07-06,1625526000.0
15936,94,4,2020-12-27,0,0,0,0,2020-12-27,1609023600.0
15937,94,4,2020-12-28,0,0,0,0,2020-12-28,1609110000.0
15938,94,4,2020-12-29,0,0,0,0,2020-12-29,1609196400.0
15939,94,4,2020-12-30,0,0,0,0,2020-12-30,1609282800.0
15940,94,4,2020-12-31,0,0,0,0,2020-12-31,1609369200.0
15941,94,4,2021-01-01,0,0,0,0,2021-01-01,1609455600.0
15942,94,4,2021-01-02,0,0,0,0,2021-01-02,1609542000.0
15943,94,4,2021-01-03,0,0,0,0,2021-01-03,1609628400.0
15944,94,4,2021-01-04,0,0,0,0,2021-01-04,1609714800.0
15945,94,4,2021-01-05,0,0,0,0,2021-01-05,1609801200.0
15946,94,4,2021-01-06,0,0,0,0,2021-01-06,1609887600.0
15947,94,4,2021-01-07,0,0,0,0,2021-01-07,1609974000.0
15948,94,4,2021-01-08,0,0,0,0,2021-01-08,1610060400.0
15949,94,4,2021-01-09,0,0,0,0,2021-01-09,1610146800.0
15950,94,4,2021-01-10,0,0,0,0,2021-01-10,1610233200.0
15951,94,4,2021-01-11,0,0,0,0,2021-01-11,1610319600.0
15952,94,4,2021-01-12,0,0,0,0,2021-01-12,1610406000.0
15953,94,4,2021-01-13,0,0,0,0,2021-01-13,1610492400.0
15954,94,4,2021-01-14,0,0,0,0,2021-01-14,1610578800.0
15955,94,4,2021-01-15,0,0,0,0,2021-01-15,1610665200.0
15956,94,4,2021-01-16,0,0,0,0,2021-01-16,1610751600.0
15957,94,4,2021-01-17,0,0,0,0,2021-01-17,1610838000.0
15958,94,4,2021-01-18,0,0,0,0,2021-01-18,1610924400.0
15959,94,4,2021-01-19,0,0,0,0,2021-01-19,1611010800.0
15960,94,4,2021-01-20,0,0,0,0,2021-01-20,1611097200.0
15961,94,4,2021-01-21,0,0,0,0,2021-01-21,1611183600.0
15962,94,4,2021-01-22,0,0,0,0,2021-01-22,1611270000.0
15963,94,4,2021-01-23,0,0,0,0,2021-01-23,1611356400.0
15964,94,4,2021-01-24,0,0,0,0,2021-01-24,1611442800.0
15965,94,4,2021-01-25,0,0,0,0,2021-01-25,1611529200.0
15966,94,4,2021-01-26,0,0,0,0,2021-01-26,1611615600.0
15967,94,4,2021-01-27,0,0,0,0,2021-01-27,1611702000.0
15968,94,4,2021-01-28,0,0,0,0,2021-01-28,1611788400.0
15969,94,4,2021-01-29,0,0,0,0,2021-01-29,1611874800.0
15970,94,4,2021-01-30,0,0,0,0,2021-01-30,1611961200.0
15971,94,4,2021-01-31,0,0,0,0,2021-01-31,1612047600.0
15972,94,4,2021-02-01,0,0,0,0,2021-02-01,1612134000.0
15973,94,4,2021-02-02,0,0,0,0,2021-02-02,1612220400.0
15974,94,4,2021-02-03,0,0,0,0,2021-02-03,1612306800.0
15975,94,4,2021-02-04,0,0,0,0,2021-02-04,1612393200.0
15976,94,4,2021-02-05,0,0,0,0,2021-02-05,1612479600.0
15977,94,4,2021-02-06,0,0,0,0,2021-02-06,1612566000.0
15978,94,4,2021-02-07,0,0,0,0,2021-02-07,1612652400.0
15979,94,4,2021-02-08,0,0,0,0,2021-02-08,1612738800.0
15980,94,4,2021-02-09,0,0,0,0,2021-02-09,1612825200.0
15981,94,4,2021-02-10,0,0,0,0,2021-02-10,1612911600.0
15982,94,4,2021-02-11,0,0,0,0,2021-02-11,1612998000.0
15983,94,4,2021-02-12,0,0,0,0,2021-02-12,1613084400.0
15984,94,4,2021-02-13,0,0,0,0,2021-02-13,1613170800.0
15985,94,4,2021-02-14,0,0,0,0,2021-02-14,1613257200.0
15986,94,4,2021-02-15,0,0,0,0,2021-02-15,1613343600.0
15987,94,4,2021-02-16,0,0,0,0,2021-02-16,1613430000.0
15988,94,4,2021-02-17,0,0,0,0,2021-02-17,1613516400.0
15989,94,4,2021-02-18,0,0,0,0,2021-02-18,1613602800.0
15990,94,4,2021-02-19,0,0,0,0,2021-02-19,1613689200.0
15991,94,4,2021-02-20,0,0,0,0,2021-02-20,1613775600.0
15992,94,4,2021-02-21,0,0,0,0,2021-02-21,1613862000.0
15993,94,4,2021-02-22,0,0,0,0,2021-02-22,1613948400.0
15994,94,4,2021-02-23,0,0,0,0,2021-02-23,1614034800.0
15995,94,4,2021-02-24,0,0,0,0,2021-02-24,1614121200.0
15996,94,4,2021-02-25,0,0,0,0,2021-02-25,1614207600.0
15997,94,4,2021-02-26,0,0,0,0,2021-02-26,1614294000.0
15998,94,4,2021-02-27,0,0,0,0,2021-02-27,1614380400.0
15999,94,4,2021-02-28,0,0,0,0,2021-02-28,1614466800.0
16000,94,4,2021-03-01,0,0,0,0,2021-03-01,1614553200.0
16001,94,4,2021-03-02,0,0,0,0,2021-03-02,1614639600.0
16002,94,4,2021-03-03,0,0,0,0,2021-03-03,1614726000.0
16003,94,4,2021-03-04,0,0,0,0,2021-03-04,1614812400.0
16004,94,4,2021-03-05,0,0,0,0,2021-03-05,1614898800.0
16005,94,4,2021-03-06,0,0,0,0,2021-03-06,1614985200.0
16006,94,4,2021-03-07,0,0,0,0,2021-03-07,1615071600.0
16007,94,4,2021-03-08,0,0,0,0,2021-03-08,1615158000.0
16008,94,4,2021-03-09,0,0,0,0,2021-03-09,1615244400.0
16009,94,4,2021-03-10,0,0,0,0,2021-03-10,1615330800.0
16010,94,4,2021-03-11,0,0,0,0,2021-03-11,1615417200.0
16011,94,4,2021-03-12,0,0,0,0,2021-03-12,1615503600.0
16012,94,4,2021-03-13,0,0,0,0,2021-03-13,1615590000.0
16013,94,4,2021-03-14,0,0,0,0,2021-03-14,1615676400.0
16014,94,4,2021-03-15,0,0,0,0,2021-03-15,1615762800.0
16015,94,4,2021-03-16,0,0,0,0,2021-03-16,1615849200.0
16016,94,4,2021-03-17,0,0,0,0,2021-03-17,1615935600.0
16017,94,4,2021-03-18,0,0,0,0,2021-03-18,1616022000.0
16018,94,4,2021-03-19,0,0,0,0,2021-03-19,1616108400.0
16019,94,4,2021-03-20,0,0,0,0,2021-03-20,1616194800.0
16020,94,4,2021-03-21,0,0,0,0,2021-03-21,1616281200.0
16021,94,4,2021-03-22,0,0,0,0,2021-03-22,1616367600.0
16022,94,4,2021-03-23,0,0,0,0,2021-03-23,1616454000.0
16023,94,4,2021-03-24,0,0,0,0,2021-03-24,1616540400.0
16024,94,4,2021-03-25,0,0,0,0,2021-03-25,1616626800.0
16025,94,4,2021-03-26,0,0,0,0,2021-03-26,1616713200.0
16026,94,4,2021-03-27,0,0,0,0,2021-03-27,1616799600.0
16027,94,4,2021-03-28,0,0,0,0,2021-03-28,1616886000.0
16028,94,4,2021-03-29,0,0,0,0,2021-03-29,1616972400.0
16029,94,4,2021-03-30,0,0,0,0,2021-03-30,1617058800.0
16030,94,4,2021-03-31,0,0,0,0,2021-03-31,1617145200.0
16031,94,4,2021-04-01,0,0,0,0,2021-04-01,1617231600.0
16032,94,4,2021-04-02,0,0,0,0,2021-04-02,1617318000.0
16033,94,4,2021-04-03,0,0,0,0,2021-04-03,1617404400.0
16034,94,4,2021-04-04,0,0,0,0,2021-04-04,1617490800.0
16035,94,4,2021-04-05,0,0,0,0,2021-04-05,1617577200.0
16036,94,4,2021-04-06,0,0,0,0,2021-04-06,1617663600.0
16037,94,4,2021-04-07,0,0,0,0,2021-04-07,1617750000.0
16038,94,4,2021-04-08,0,0,0,0,2021-04-08,1617836400.0
16039,94,4,2021-04-09,0,0,0,0,2021-04-09,1617922800.0
16040,94,4,2021-04-10,0,0,0,0,2021-04-10,1618009200.0
16041,94,4,2021-04-11,0,0,0,0,2021-04-11,1618095600.0
16042,94,4,2021-04-12,0,0,0,0,2021-04-12,1618185600.0
16043,94,4,2021-04-13,0,0,0,0,2021-04-13,1618272000.0
16044,94,4,2021-04-14,0,0,0,0,2021-04-14,1618358400.0
16045,94,4,2021-04-15,0,0,0,0,2021-04-15,1618444800.0
16046,94,4,2021-04-16,0,0,0,0,2021-04-16,1618531200.0
16047,94,4,2021-04-17,0,0,0,0,2021-04-17,1618617600.0
16048,94,4,2021-04-18,0,0,0,0,2021-04-18,1618704000.0
16049,94,4,2021-04-19,0,0,0,0,2021-04-19,1618790400.0
16050,94,4,2021-04-20,0,0,0,0,2021-04-20,1618876800.0
16051,94,4,2021-04-21,0,0,0,0,2021-04-21,1618963200.0
16052,94,4,2021-04-22,0,0,0,0,2021-04-22,1619049600.0
16053,94,4,2021-04-23,0,0,0,0,2021-04-23,1619136000.0
16054,94,4,2021-04-24,0,0,0,0,2021-04-24,1619222400.0
16055,94,4,2021-04-25,0,0,0,0,2021-04-25,1619308800.0
16056,94,4,2021-04-26,0,0,0,0,2021-04-26,1619395200.0
16057,94,4,2021-04-27,5,0,5,0,2021-04-27,1619481600.0
16058,94,4,2021-04-28,11,0,16,0,2021-04-28,1619568000.0
16059,94,4,2021-04-29,47,0,63,0,2021-04-29,1619654400.0
16060,94,4,2021-04-30,52,0,115,0,2021-04-30,1619740800.0
16061,94,4,2021-05-01,0,0,115,0,2021-05-01,1619827200.0
16062,94,4,2021-05-02,0,0,115,0,2021-05-02,1619913600.0
16063,94,4,2021-05-03,16,0,131,0,2021-05-03,1620000000.0
16064,94,4,2021-05-04,14,0,145,0,2021-05-04,1620086400.0
16065,94,4,2021-05-05,43,0,188,0,2021-05-05,1620172800.0
16066,94,4,2021-05-06,13,0,201,0,2021-05-06,1620259200.0
16067,94,4,2021-05-07,25,0,226,0,2021-05-07,1620345600.0
16068,94,4,2021-05-08,1,0,227,0,2021-05-08,1620432000.0
16069,94,4,2021-05-09,5,0,232,0,2021-05-09,1620518400.0
16070,94,4,2021-05-10,21,0,253,0,2021-05-10,1620604800.0
16071,94,4,2021-05-11,33,1,286,1,2021-05-11,1620691200.0
16072,94,4,2021-05-12,22,0,308,1,2021-05-12,1620777600.0
16073,94,4,2021-05-13,0,0,308,1,2021-05-13,1620864000.0
16074,94,4,2021-05-14,18,0,326,1,2021-05-14,1620950400.0
16075,94,4,2021-05-15,12,0,338,1,2021-05-15,1621036800.0
16076,94,4,2021-05-16,8,0,346,1,2021-05-16,1621123200.0
16077,94,4,2021-05-17,3,0,349,1,2021-05-17,1621206000.0
16078,94,4,2021-05-18,23,0,372,1,2021-05-18,1621292400.0
16079,94,4,2021-05-19,3,0,375,1,2021-05-19,1621378800.0
16080,94,4,2021-05-20,24,0,399,1,2021-05-20,1621465200.0
16081,94,4,2021-05-21,29,0,428,1,2021-05-21,1621551600.0
16082,94,4,2021-05-22,16,0,444,1,2021-05-22,1621638000.0
16083,94,4,2021-05-23,5,0,449,1,2021-05-23,1621724400.0
16084,94,4,2021-05-24,10,0,459,1,2021-05-24,1621810800.0
16085,94,4,2021-05-25,18,0,477,1,2021-05-25,1621897200.0
16086,94,4,2021-05-26,23,0,500,1,2021-05-26,1621983600.0
16087,94,4,2021-05-27,16,0,516,1,2021-05-27,1622070000.0
16088,94,4,2021-05-28,40,0,556,1,2021-05-28,1622156400.0
16089,94,4,2021-05-29,9,0,565,1,2021-05-29,1622242800.0
16090,94,4,2021-05-30,0,0,565,1,2021-05-30,1622329200.0
16091,94,4,2021-05-31,23,0,588,1,2021-05-31,1622415600.0
16092,94,4,2021-06-01,36,0,624,1,2021-06-01,1622502000.0
16093,94,4,2021-06-02,31,0,655,1,2021-06-02,1622588400.0
16094,94,4,2021-06-03,23,0,678,1,2021-06-03,1622674800.0
16095,94,4,2021-06-04,36,0,714,1,2021-06-04,1622761200.0
16096,94,4,2021-06-05,49,0,763,1,2021-06-05,1622847600.0
16097,94,4,2021-06-06,5,0,768,1,2021-06-06,1622934000.0
16098,94,4,2021-06-07,28,0,796,1,2021-06-07,1623020400.0
16099,94,4,2021-06-08,28,0,824,1,2021-06-08,1623106800.0
16100,94,4,2021-06-09,20,1,844,2,2021-06-09,1623193200.0
16101,94,4,2021-06-10,32,0,876,2,2021-06-10,1623279600.0
16102,94,4,2021-06-11,44,0,920,2,2021-06-11,1623366000.0
16103,94,4,2021-06-12,29,0,949,2,2021-06-12,1623452400.0
16104,94,4,2021-06-13,1,0,950,2,2021-06-13,1623538800.0
16105,94,4,2021-06-14,28,0,978,2,2021-06-14,1623625200.0
16106,94,4,2021-06-15,48,0,1026,2,2021-06-15,1623711600.0
16107,94,4,2021-06-16,47,0,1073,2,2021-06-16,1623798000.0
16108,94,4,2021-06-17,40,1,1113,3,2021-06-17,1623884400.0
16109,94,4,2021-06-18,24,0,1137,3,2021-06-18,1623970800.0
16110,94,4,2021-06-19,17,0,1154,3,2021-06-19,1624057200.0
16111,94,4,2021-06-20,0,0,1154,3,2021-06-20,1624143600.0
16112,94,4,2021-06-21,12,0,1166,3,2021-06-21,1624230000.0
16113,94,4,2021-06-22,20,0,1186,3,2021-06-22,1624316400.0
16114,94,4,2021-06-23,15,0,1201,3,2021-06-23,1624402800.0
16115,94,4,2021-06-24,17,0,1218,3,2021-06-24,1624489200.0
16116,94,4,2021-06-25,33,0,1251,3,2021-06-25,1624575600.0
16117,94,4,2021-06-26,17,0,1268,3,2021-06-26,1624662000.0
16118,94,4,2021-06-27,2,0,1270,3,2021-06-27,1624748400.0
16119,94,4,2021-06-28,17,0,1287,3,2021-06-28,1624834800.0
16120,94,4,2021-06-29,15,0,1302,3,2021-06-29,1624921200.0
16121,94,4,2021-06-30,29,0,1331,3,2021-06-30,1625007600.0
16122,94,4,2021-07-01,26,0,1357,3,2021-07-01,1625094000.0
16123,94,4,2021-07-02,23,0,1380,3,2021-07-02,1625180400.0
16124,94,4,2021-07-03,11,0,1391,3,2021-07-03,1625266800.0
16125,94,4,2021-07-04,0,0,1391,3,2021-07-04,1625353200.0
16126,94,4,2021-07-05,13,0,1404,3,2021-07-05,1625439600.0
16127,94,4,2021-07-06,33,0,1437,3,2021-07-06,1625526000.0
16128,1,0,2020-12-27,0,0,0,0,2020-12-27,1609023600.0
16129,1,0,2020-12-28,0,0,0,0,2020-12-28,1609110000.0
16130,1,0,2020-12-29,0,0,0,0,2020-12-29,1609196400.0
16131,1,0,2020-12-30,0,0,0,0,2020-12-30,1609282800.0
16132,1,0,2020-12-31,0,0,0,0,2020-12-31,1609369200.0
16133,1,0,2021-01-01,1,0,1,0,2021-01-01,1609455600.0
16134,1,0,2021-01-02,0,0,1,0,2021-01-02,1609542000.0
16135,1,0,2021-01-03,0,0,1,0,2021-01-03,1609628400.0
16136,1,0,2021-01-04,1,0,2,0,2021-01-04,1609714800.0
16137,1,0,2021-01-05,0,0,2,0,2021-01-05,1609801200.0
16138,1,0,2021-01-06,1,0,3,0,2021-01-06,1609887600.0
16139,1,0,2021-01-07,0,0,3,0,2021-01-07,1609974000.0
16140,1,0,2021-01-08,49,0,52,0,2021-01-08,1610060400.0
16141,1,0,2021-01-09,18,0,70,0,2021-01-09,1610146800.0
16142,1,0,2021-01-10,0,0,70,0,2021-01-10,1610233200.0
16143,1,0,2021-01-11,55,0,125,0,2021-01-11,1610319600.0
16144,1,0,2021-01-12,44,0,169,0,2021-01-12,1610406000.0
16145,1,0,2021-01-13,45,0,214,0,2021-01-13,1610492400.0
16146,1,0,2021-01-14,60,0,274,0,2021-01-14,1610578800.0
16147,1,0,2021-01-15,76,0,350,0,2021-01-15,1610665200.0
16148,1,0,2021-01-16,0,0,350,0,2021-01-16,1610751600.0
16149,1,0,2021-01-17,0,0,350,0,2021-01-17,1610838000.0
16150,1,0,2021-01-18,75,0,425,0,2021-01-18,1610924400.0
16151,1,0,2021-01-19,143,0,568,0,2021-01-19,1611010800.0
16152,1,0,2021-01-20,134,0,702,0,2021-01-20,1611097200.0
16153,1,0,2021-01-21,149,0,851,0,2021-01-21,1611183600.0
16154,1,0,2021-01-22,132,0,983,0,2021-01-22,1611270000.0
16155,1,0,2021-01-23,1,0,984,0,2021-01-23,1611356400.0
16156,1,0,2021-01-24,0,0,984,0,2021-01-24,1611442800.0
16157,1,0,2021-01-25,203,0,1187,0,2021-01-25,1611529200.0
16158,1,0,2021-01-26,210,0,1397,0,2021-01-26,1611615600.0
16159,1,0,2021-01-27,233,0,1630,0,2021-01-27,1611702000.0
16160,1,0,2021-01-28,238,2,1868,2,2021-01-28,1611788400.0
16161,1,0,2021-01-29,197,0,2065,2,2021-01-29,1611874800.0
16162,1,0,2021-01-30,17,0,2082,2,2021-01-30,1611961200.0
16163,1,0,2021-01-31,1,0,2083,2,2021-01-31,1612047600.0
16164,1,0,2021-02-01,222,3,2305,5,2021-02-01,1612134000.0
16165,1,0,2021-02-02,241,24,2546,29,2021-02-02,1612220400.0
16166,1,0,2021-02-03,213,1,2759,30,2021-02-03,1612306800.0
16167,1,0,2021-02-04,299,19,3058,49,2021-02-04,1612393200.0
16168,1,0,2021-02-05,252,32,3310,81,2021-02-05,1612479600.0
16169,1,0,2021-02-06,49,1,3359,82,2021-02-06,1612566000.0
16170,1,0,2021-02-07,0,0,3359,82,2021-02-07,1612652400.0
16171,1,0,2021-02-08,222,20,3581,102,2021-02-08,1612738800.0
16172,1,0,2021-02-09,289,27,3870,129,2021-02-09,1612825200.0
16173,1,0,2021-02-10,221,28,4091,157,2021-02-10,1612911600.0
16174,1,0,2021-02-11,293,108,4384,265,2021-02-11,1612998000.0
16175,1,0,2021-02-12,284,23,4668,288,2021-02-12,1613084400.0
16176,1,0,2021-02-13,50,7,4718,295,2021-02-13,1613170800.0
16177,1,0,2021-02-14,19,36,4737,331,2021-02-14,1613257200.0
16178,1,0,2021-02-15,71,43,4808,374,2021-02-15,1613343600.0
16179,1,0,2021-02-16,16,0,4824,374,2021-02-16,1613430000.0
16180,1,0,2021-02-17,17,0,4841,374,2021-02-17,1613516400.0
16181,1,0,2021-02-18,219,16,5060,390,2021-02-18,1613602800.0
16182,1,0,2021-02-19,229,19,5289,409,2021-02-19,1613689200.0
16183,1,0,2021-02-20,47,0,5336,409,2021-02-20,1613775600.0
16184,1,0,2021-02-21,1,0,5337,409,2021-02-21,1613862000.0
16185,1,0,2021-02-22,157,54,5494,463,2021-02-22,1613948400.0
16186,1,0,2021-02-23,189,70,5683,533,2021-02-23,1614034800.0
16187,1,0,2021-02-24,307,119,5990,652,2021-02-24,1614121200.0
16188,1,0,2021-02-25,370,75,6360,727,2021-02-25,1614207600.0
16189,1,0,2021-02-26,208,81,6568,808,2021-02-26,1614294000.0
16190,1,0,2021-02-27,63,0,6631,808,2021-02-27,1614380400.0
16191,1,0,2021-02-28,1,0,6632,808,2021-02-28,1614466800.0
16192,1,0,2021-03-01,140,80,6772,888,2021-03-01,1614553200.0
16193,1,0,2021-03-02,240,127,7012,1015,2021-03-02,1614639600.0
16194,1,0,2021-03-03,211,118,7223,1133,2021-03-03,1614726000.0
16195,1,0,2021-03-04,303,80,7526,1213,2021-03-04,1614812400.0
16196,1,0,2021-03-05,330,141,7856,1354,2021-03-05,1614898800.0
16197,1,0,2021-03-06,586,1,8442,1355,2021-03-06,1614985200.0
16198,1,0,2021-03-07,1,0,8443,1355,2021-03-07,1615071600.0
16199,1,0,2021-03-08,278,130,8721,1485,2021-03-08,1615158000.0
16200,1,0,2021-03-09,358,149,9079,1634,2021-03-09,1615244400.0
16201,1,0,2021-03-10,368,153,9447,1787,2021-03-10,1615330800.0
16202,1,0,2021-03-11,120,43,9567,1830,2021-03-11,1615417200.0
16203,1,0,2021-03-12,406,205,9973,2035,2021-03-12,1615503600.0
16204,1,0,2021-03-13,132,1,10105,2036,2021-03-13,1615590000.0
16205,1,0,2021-03-14,13,23,10118,2059,2021-03-14,1615676400.0
16206,1,0,2021-03-15,407,37,10525,2096,2021-03-15,1615762800.0
16207,1,0,2021-03-16,449,73,10974,2169,2021-03-16,1615849200.0
16208,1,0,2021-03-17,420,78,11394,2247,2021-03-17,1615935600.0
16209,1,0,2021-03-18,540,99,11934,2346,2021-03-18,1616022000.0
16210,1,0,2021-03-19,523,92,12457,2438,2021-03-19,1616108400.0
16211,1,0,2021-03-20,174,43,12631,2481,2021-03-20,1616194800.0
16212,1,0,2021-03-21,8,0,12639,2481,2021-03-21,1616281200.0
16213,1,0,2021-03-22,335,79,12974,2560,2021-03-22,1616367600.0
16214,1,0,2021-03-23,483,150,13457,2710,2021-03-23,1616454000.0
16215,1,0,2021-03-24,456,103,13913,2813,2021-03-24,1616540400.0
16216,1,0,2021-03-25,730,170,14643,2983,2021-03-25,1616626800.0
16217,1,0,2021-03-26,635,116,15278,3099,2021-03-26,1616713200.0
16218,1,0,2021-03-27,268,42,15546,3141,2021-03-27,1616799600.0
16219,1,0,2021-03-28,7,0,15553,3141,2021-03-28,1616886000.0
16220,1,0,2021-03-29,359,78,15912,3219,2021-03-29,1616972400.0
16221,1,0,2021-03-30,616,154,16528,3373,2021-03-30,1617058800.0
16222,1,0,2021-03-31,526,118,17054,3491,2021-03-31,1617145200.0
16223,1,0,2021-04-01,622,191,17676,3682,2021-04-01,1617231600.0
16224,1,0,2021-04-02,38,35,17714,3717,2021-04-02,1617318000.0
16225,1,0,2021-04-03,43,2,17757,3719,2021-04-03,1617404400.0
16226,1,0,2021-04-04,4,18,17761,3737,2021-04-04,1617490800.0
16227,1,0,2021-04-05,11,0,17772,3737,2021-04-05,1617577200.0
16228,1,0,2021-04-06,436,179,18208,3916,2021-04-06,1617663600.0
16229,1,0,2021-04-07,568,111,18776,4027,2021-04-07,1617750000.0
16230,1,0,2021-04-08,483,152,19259,4179,2021-04-08,1617836400.0
16231,1,0,2021-04-09,481,197,19740,4376,2021-04-09,1617922800.0
16232,1,0,2021-04-10,96,4,19836,4380,2021-04-10,1618009200.0
16233,1,0,2021-04-11,2,25,19838,4405,2021-04-11,1618095600.0
16234,1,0,2021-04-12,282,250,20120,4655,2021-04-12,1618185600.0
16235,1,0,2021-04-13,551,309,20671,4964,2021-04-13,1618272000.0
16236,1,0,2021-04-14,426,217,21097,5181,2021-04-14,1618358400.0
16237,1,0,2021-04-15,550,307,21647,5488,2021-04-15,1618444800.0
16238,1,0,2021-04-16,548,260,22195,5748,2021-04-16,1618531200.0
16239,1,0,2021-04-17,191,2,22386,5750,2021-04-17,1618617600.0
16240,1,0,2021-04-18,4,14,22390,5764,2021-04-18,1618704000.0
16241,1,0,2021-04-19,389,234,22779,5998,2021-04-19,1618790400.0
16242,1,0,2021-04-20,722,325,23501,6323,2021-04-20,1618876800.0
16243,1,0,2021-04-21,617,305,24118,6628,2021-04-21,1618963200.0
16244,1,0,2021-04-22,802,320,24920,6948,2021-04-22,1619049600.0
16245,1,0,2021-04-23,841,232,25761,7180,2021-04-23,1619136000.0
16246,1,0,2021-04-24,373,68,26134,7248,2021-04-24,1619222400.0
16247,1,0,2021-04-25,591,60,26725,7308,2021-04-25,1619308800.0
16248,1,0,2021-04-26,941,195,27666,7503,2021-04-26,1619395200.0
16249,1,0,2021-04-27,644,211,28310,7714,2021-04-27,1619481600.0
16250,1,0,2021-04-28,834,248,29144,7962,2021-04-28,1619568000.0
16251,1,0,2021-04-29,1191,169,30335,8131,2021-04-29,1619654400.0
16252,1,0,2021-04-30,1257,152,31592,8283,2021-04-30,1619740800.0
16253,1,0,2021-05-01,594,37,32186,8320,2021-05-01,1619827200.0
16254,1,0,2021-05-02,343,13,32529,8333,2021-05-02,1619913600.0
16255,1,0,2021-05-03,917,158,33446,8491,2021-05-03,1620000000.0
16256,1,0,2021-05-04,953,183,34399,8674,2021-05-04,1620086400.0
16257,1,0,2021-05-05,1000,224,35399,8898,2021-05-05,1620172800.0
16258,1,0,2021-05-06,1113,143,36512,9041,2021-05-06,1620259200.0
16259,1,0,2021-05-07,1232,234,37744,9275,2021-05-07,1620345600.0
16260,1,0,2021-05-08,316,21,38060,9296,2021-05-08,1620432000.0
16261,1,0,2021-05-09,178,3,38238,9299,2021-05-09,1620518400.0
16262,1,0,2021-05-10,832,188,39070,9487,2021-05-10,1620604800.0
16263,1,0,2021-05-11,941,281,40011,9768,2021-05-11,1620691200.0
16264,1,0,2021-05-12,894,295,40905,10063,2021-05-12,1620777600.0
16265,1,0,2021-05-13,211,75,41116,10138,2021-05-13,1620864000.0
16266,1,0,2021-05-14,859,257,41975,10395,2021-05-14,1620950400.0
16267,1,0,2021-05-15,474,9,42449,10404,2021-05-15,1621036800.0
16268,1,0,2021-05-16,182,30,42631,10434,2021-05-16,1621123200.0
16269,1,0,2021-05-17,708,243,43339,10677,2021-05-17,1621206000.0
16270,1,0,2021-05-18,721,359,44060,11036,2021-05-18,1621292400.0
16271,1,0,2021-05-19,694,504,44754,11540,2021-05-19,1621378800.0
16272,1,0,2021-05-20,776,346,45530,11886,2021-05-20,1621465200.0
16273,1,0,2021-05-21,809,390,46339,12276,2021-05-21,1621551600.0
16274,1,0,2021-05-22,490,211,46829,12487,2021-05-22,1621638000.0
16275,1,0,2021-05-23,201,109,47030,12596,2021-05-23,1621724400.0
16276,1,0,2021-05-24,198,174,47228,12770,2021-05-24,1621810800.0
16277,1,0,2021-05-25,531,654,47759,13424,2021-05-25,1621897200.0
16278,1,0,2021-05-26,576,483,48335,13907,2021-05-26,1621983600.0
16279,1,0,2021-05-27,128,181,48463,14088,2021-05-27,1622070000.0
16280,1,0,2021-05-28,514,505,48977,14593,2021-05-28,1622156400.0
16281,1,0,2021-05-29,226,134,49203,14727,2021-05-29,1622242800.0
16282,1,0,2021-05-30,71,111,49274,14838,2021-05-30,1622329200.0
16283,1,0,2021-05-31,418,528,49692,15366,2021-05-31,1622415600.0
16284,1,0,2021-06-01,533,699,50225,16065,2021-06-01,1622502000.0
16285,1,0,2021-06-02,556,682,50781,16747,2021-06-02,1622588400.0
16286,1,0,2021-06-03,486,547,51267,17294,2021-06-03,1622674800.0
16287,1,0,2021-06-04,698,778,51965,18072,2021-06-04,1622761200.0
16288,1,0,2021-06-05,319,632,52284,18704,2021-06-05,1622847600.0
16289,1,0,2021-06-06,122,522,52406,19226,2021-06-06,1622934000.0
16290,1,0,2021-06-07,411,762,52817,19988,2021-06-07,1623020400.0
16291,1,0,2021-06-08,487,868,53304,20856,2021-06-08,1623106800.0
16292,1,0,2021-06-09,405,847,53709,21703,2021-06-09,1623193200.0
16293,1,0,2021-06-10,473,828,54182,22531,2021-06-10,1623279600.0
16294,1,0,2021-06-11,450,1210,54632,23741,2021-06-11,1623366000.0
16295,1,0,2021-06-12,290,652,54922,24393,2021-06-12,1623452400.0
16296,1,0,2021-06-13,128,311,55050,24704,2021-06-13,1623538800.0
16297,1,0,2021-06-14,350,3789,55400,28493,2021-06-14,1623625200.0
16298,1,0,2021-06-15,445,1987,55845,30480,2021-06-15,1623711600.0
16299,1,0,2021-06-16,447,1463,56292,31943,2021-06-16,1623798000.0
16300,1,0,2021-06-17,417,992,56709,32935,2021-06-17,1623884400.0
16301,1,0,2021-06-18,451,1001,57160,33936,2021-06-18,1623970800.0
16302,1,0,2021-06-19,294,495,57454,34431,2021-06-19,1624057200.0
16303,1,0,2021-06-20,108,224,57562,34655,2021-06-20,1624143600.0
16304,1,0,2021-06-21,317,662,57879,35317,2021-06-21,1624230000.0
16305,1,0,2021-06-22,312,853,58191,36170,2021-06-22,1624316400.0
16306,1,0,2021-06-23,348,867,58539,37037,2021-06-23,1624402800.0
16307,1,0,2021-06-24,378,704,58917,37741,2021-06-24,1624489200.0
16308,1,0,2021-06-25,434,742,59351,38483,2021-06-25,1624575600.0
16309,1,0,2021-06-26,291,504,59642,38987,2021-06-26,1624662000.0
16310,1,0,2021-06-27,106,168,59748,39155,2021-06-27,1624748400.0
16311,1,0,2021-06-28,285,672,60033,39827,2021-06-28,1624834800.0
16312,1,0,2021-06-29,357,742,60390,40569,2021-06-29,1624921200.0
16313,1,0,2021-06-30,402,885,60792,41454,2021-06-30,1625007600.0
16314,1,0,2021-07-01,329,626,61121,42080,2021-07-01,1625094000.0
16315,1,0,2021-07-02,413,654,61534,42734,2021-07-02,1625180400.0
16316,1,0,2021-07-03,266,443,61800,43177,2021-07-03,1625266800.0
16317,1,0,2021-07-04,110,228,61910,43405,2021-07-04,1625353200.0
16318,1,0,2021-07-05,314,487,62224,43892,2021-07-05,1625439600.0
16319,1,0,2021-07-06,352,743,62576,44635,2021-07-06,1625526000.0
16320,2,0,2020-12-27,0,0,0,0,2020-12-27,1609023600.0
16321,2,0,2020-12-28,0,0,0,0,2020-12-28,1609110000.0
16322,2,0,2020-12-29,0,0,0,0,2020-12-29,1609196400.0
16323,2,0,2020-12-30,0,0,0,0,2020-12-30,1609282800.0
16324,2,0,2020-12-31,0,0,0,0,2020-12-31,1609369200.0
16325,2,0,2021-01-01,0,0,0,0,2021-01-01,1609455600.0
16326,2,0,2021-01-02,0,0,0,0,2021-01-02,1609542000.0
16327,2,0,2021-01-03,0,0,0,0,2021-01-03,1609628400.0
16328,2,0,2021-01-04,0,0,0,0,2021-01-04,1609714800.0
16329,2,0,2021-01-05,0,0,0,0,2021-01-05,1609801200.0
16330,2,0,2021-01-06,5,0,5,0,2021-01-06,1609887600.0
16331,2,0,2021-01-07,31,0,36,0,2021-01-07,1609974000.0
16332,2,0,2021-01-08,80,0,116,0,2021-01-08,1610060400.0
16333,2,0,2021-01-09,20,0,136,0,2021-01-09,1610146800.0
16334,2,0,2021-01-10,0,0,136,0,2021-01-10,1610233200.0
16335,2,0,2021-01-11,122,0,258,0,2021-01-11,1610319600.0
16336,2,0,2021-01-12,78,0,336,0,2021-01-12,1610406000.0
16337,2,0,2021-01-13,64,0,400,0,2021-01-13,1610492400.0
16338,2,0,2021-01-14,88,0,488,0,2021-01-14,1610578800.0
16339,2,0,2021-01-15,136,0,624,0,2021-01-15,1610665200.0
16340,2,0,2021-01-16,51,0,675,0,2021-01-16,1610751600.0
16341,2,0,2021-01-17,0,0,675,0,2021-01-17,1610838000.0
16342,2,0,2021-01-18,157,0,832,0,2021-01-18,1610924400.0
16343,2,0,2021-01-19,168,0,1000,0,2021-01-19,1611010800.0
16344,2,0,2021-01-20,164,0,1164,0,2021-01-20,1611097200.0
16345,2,0,2021-01-21,181,0,1345,0,2021-01-21,1611183600.0
16346,2,0,2021-01-22,156,0,1501,0,2021-01-22,1611270000.0
16347,2,0,2021-01-23,58,0,1559,0,2021-01-23,1611356400.0
16348,2,0,2021-01-24,0,0,1559,0,2021-01-24,1611442800.0
16349,2,0,2021-01-25,160,0,1719,0,2021-01-25,1611529200.0
16350,2,0,2021-01-26,137,0,1856,0,2021-01-26,1611615600.0
16351,2,0,2021-01-27,162,5,2018,5,2021-01-27,1611702000.0
16352,2,0,2021-01-28,143,12,2161,17,2021-01-28,1611788400.0
16353,2,0,2021-01-29,143,41,2304,58,2021-01-29,1611874800.0
16354,2,0,2021-01-30,96,16,2400,74,2021-01-30,1611961200.0
16355,2,0,2021-01-31,0,0,2400,74,2021-01-31,1612047600.0
16356,2,0,2021-02-01,119,73,2519,147,2021-02-01,1612134000.0
16357,2,0,2021-02-02,184,95,2703,242,2021-02-02,1612220400.0
16358,2,0,2021-02-03,131,80,2834,322,2021-02-03,1612306800.0
16359,2,0,2021-02-04,158,73,2992,395,2021-02-04,1612393200.0
16360,2,0,2021-02-05,120,97,3112,492,2021-02-05,1612479600.0
16361,2,0,2021-02-06,62,26,3174,518,2021-02-06,1612566000.0
16362,2,0,2021-02-07,1,0,3175,518,2021-02-07,1612652400.0
16363,2,0,2021-02-08,137,78,3312,596,2021-02-08,1612738800.0
16364,2,0,2021-02-09,176,78,3488,674,2021-02-09,1612825200.0
16365,2,0,2021-02-10,138,90,3626,764,2021-02-10,1612911600.0
16366,2,0,2021-02-11,150,103,3776,867,2021-02-11,1612998000.0
16367,2,0,2021-02-12,124,128,3900,995,2021-02-12,1613084400.0
16368,2,0,2021-02-13,38,37,3938,1032,2021-02-13,1613170800.0
16369,2,0,2021-02-14,0,0,3938,1032,2021-02-14,1613257200.0
16370,2,0,2021-02-15,51,67,3989,1099,2021-02-15,1613343600.0
16371,2,0,2021-02-16,0,1,3989,1100,2021-02-16,1613430000.0
16372,2,0,2021-02-17,1,3,3990,1103,2021-02-17,1613516400.0
16373,2,0,2021-02-18,68,127,4058,1230,2021-02-18,1613602800.0
16374,2,0,2021-02-19,69,131,4127,1361,2021-02-19,1613689200.0
16375,2,0,2021-02-20,48,69,4175,1430,2021-02-20,1613775600.0
16376,2,0,2021-02-21,0,0,4175,1430,2021-02-21,1613862000.0
16377,2,0,2021-02-22,102,60,4277,1490,2021-02-22,1613948400.0
16378,2,0,2021-02-23,113,238,4390,1728,2021-02-23,1614034800.0
16379,2,0,2021-02-24,106,223,4496,1951,2021-02-24,1614121200.0
16380,2,0,2021-02-25,89,148,4585,2099,2021-02-25,1614207600.0
16381,2,0,2021-02-26,126,168,4711,2267,2021-02-26,1614294000.0
16382,2,0,2021-02-27,69,52,4780,2319,2021-02-27,1614380400.0
16383,2,0,2021-02-28,0,0,4780,2319,2021-02-28,1614466800.0
16384,2,0,2021-03-01,138,143,4918,2462,2021-03-01,1614553200.0
16385,2,0,2021-03-02,158,78,5076,2540,2021-03-02,1614639600.0
16386,2,0,2021-03-03,178,142,5254,2682,2021-03-03,1614726000.0
16387,2,0,2021-03-04,145,133,5399,2815,2021-03-04,1614812400.0
16388,2,0,2021-03-05,238,127,5637,2942,2021-03-05,1614898800.0
16389,2,0,2021-03-06,119,58,5756,3000,2021-03-06,1614985200.0
16390,2,0,2021-03-07,100,0,5856,3000,2021-03-07,1615071600.0
16391,2,0,2021-03-08,196,129,6052,3129,2021-03-08,1615158000.0
16392,2,0,2021-03-09,269,102,6321,3231,2021-03-09,1615244400.0
16393,2,0,2021-03-10,324,133,6645,3364,2021-03-10,1615330800.0
16394,2,0,2021-03-11,334,77,6979,3441,2021-03-11,1615417200.0
16395,2,0,2021-03-12,398,49,7377,3490,2021-03-12,1615503600.0
16396,2,0,2021-03-13,155,21,7532,3511,2021-03-13,1615590000.0
16397,2,0,2021-03-14,4,1,7536,3512,2021-03-14,1615676400.0
16398,2,0,2021-03-15,276,92,7812,3604,2021-03-15,1615762800.0
16399,2,0,2021-03-16,305,52,8117,3656,2021-03-16,1615849200.0
16400,2,0,2021-03-17,387,41,8504,3697,2021-03-17,1615935600.0
16401,2,0,2021-03-18,435,39,8939,3736,2021-03-18,1616022000.0
16402,2,0,2021-03-19,396,56,9335,3792,2021-03-19,1616108400.0
16403,2,0,2021-03-20,149,47,9484,3839,2021-03-20,1616194800.0
16404,2,0,2021-03-21,25,1,9509,3840,2021-03-21,1616281200.0
16405,2,0,2021-03-22,362,113,9871,3953,2021-03-22,1616367600.0
16406,2,0,2021-03-23,401,116,10272,4069,2021-03-23,1616454000.0
16407,2,0,2021-03-24,427,97,10699,4166,2021-03-24,1616540400.0
16408,2,0,2021-03-25,472,87,11171,4253,2021-03-25,1616626800.0
16409,2,0,2021-03-26,632,86,11803,4339,2021-03-26,1616713200.0
16410,2,0,2021-03-27,152,68,11955,4407,2021-03-27,1616799600.0
16411,2,0,2021-03-28,81,2,12036,4409,2021-03-28,1616886000.0
16412,2,0,2021-03-29,421,157,12457,4566,2021-03-29,1616972400.0
16413,2,0,2021-03-30,469,234,12926,4800,2021-03-30,1617058800.0
16414,2,0,2021-03-31,1143,174,14069,4974,2021-03-31,1617145200.0
16415,2,0,2021-04-01,951,163,15020,5137,2021-04-01,1617231600.0
16416,2,0,2021-04-02,895,3,15915,5140,2021-04-02,1617318000.0
16417,2,0,2021-04-03,788,37,16703,5177,2021-04-03,1617404400.0
16418,2,0,2021-04-04,750,2,17453,5179,2021-04-04,1617490800.0
16419,2,0,2021-04-05,828,9,18281,5188,2021-04-05,1617577200.0
16420,2,0,2021-04-06,883,108,19164,5296,2021-04-06,1617663600.0
16421,2,0,2021-04-07,1435,288,20599,5584,2021-04-07,1617750000.0
16422,2,0,2021-04-08,1306,237,21905,5821,2021-04-08,1617836400.0
16423,2,0,2021-04-09,1239,300,23144,6121,2021-04-09,1617922800.0
16424,2,0,2021-04-10,838,143,23982,6264,2021-04-10,1618009200.0
16425,2,0,2021-04-11,621,4,24603,6268,2021-04-11,1618095600.0
16426,2,0,2021-04-12,868,282,25471,6550,2021-04-12,1618185600.0
16427,2,0,2021-04-13,867,310,26338,6860,2021-04-13,1618272000.0
16428,2,0,2021-04-14,957,314,27295,7174,2021-04-14,1618358400.0
16429,2,0,2021-04-15,958,279,28253,7453,2021-04-15,1618444800.0
16430,2,0,2021-04-16,991,281,29244,7734,2021-04-16,1618531200.0
16431,2,0,2021-04-17,528,149,29772,7883,2021-04-17,1618617600.0
16432,2,0,2021-04-18,339,49,30111,7932,2021-04-18,1618704000.0
16433,2,0,2021-04-19,668,327,30779,8259,2021-04-19,1618790400.0
16434,2,0,2021-04-20,869,294,31648,8553,2021-04-20,1618876800.0
16435,2,0,2021-04-21,999,339,32647,8892,2021-04-21,1618963200.0
16436,2,0,2021-04-22,602,293,33249,9185,2021-04-22,1619049600.0
16437,2,0,2021-04-23,606,447,33855,9632,2021-04-23,1619136000.0
16438,2,0,2021-04-24,360,189,34215,9821,2021-04-24,1619222400.0
16439,2,0,2021-04-25,168,198,34383,10019,2021-04-25,1619308800.0
16440,2,0,2021-04-26,515,530,34898,10549,2021-04-26,1619395200.0
16441,2,0,2021-04-27,563,602,35461,11151,2021-04-27,1619481600.0
16442,2,0,2021-04-28,449,683,35910,11834,2021-04-28,1619568000.0
16443,2,0,2021-04-29,651,622,36561,12456,2021-04-29,1619654400.0
16444,2,0,2021-04-30,771,666,37332,13122,2021-04-30,1619740800.0
16445,2,0,2021-05-01,243,244,37575,13366,2021-05-01,1619827200.0
16446,2,0,2021-05-02,226,504,37801,13870,2021-05-02,1619913600.0
16447,2,0,2021-05-03,569,759,38370,14629,2021-05-03,1620000000.0
16448,2,0,2021-05-04,524,660,38894,15289,2021-05-04,1620086400.0
16449,2,0,2021-05-05,541,887,39435,16176,2021-05-05,1620172800.0
16450,2,0,2021-05-06,546,769,39981,16945,2021-05-06,1620259200.0
16451,2,0,2021-05-07,629,998,40610,17943,2021-05-07,1620345600.0
16452,2,0,2021-05-08,224,516,40834,18459,2021-05-08,1620432000.0
16453,2,0,2021-05-09,174,505,41008,18964,2021-05-09,1620518400.0
16454,2,0,2021-05-10,519,839,41527,19803,2021-05-10,1620604800.0
16455,2,0,2021-05-11,477,866,42004,20669,2021-05-11,1620691200.0
16456,2,0,2021-05-12,556,880,42560,21549,2021-05-12,1620777600.0
16457,2,0,2021-05-13,273,520,42833,22069,2021-05-13,1620864000.0
16458,2,0,2021-05-14,388,737,43221,22806,2021-05-14,1620950400.0
16459,2,0,2021-05-15,233,576,43454,23382,2021-05-15,1621036800.0
16460,2,0,2021-05-16,155,437,43609,23819,2021-05-16,1621123200.0
16461,2,0,2021-05-17,472,741,44081,24560,2021-05-17,1621206000.0
16462,2,0,2021-05-18,446,665,44527,25225,2021-05-18,1621292400.0
16463,2,0,2021-05-19,451,717,44978,25942,2021-05-19,1621378800.0
16464,2,0,2021-05-20,593,477,45571,26419,2021-05-20,1621465200.0
16465,2,0,2021-05-21,545,689,46116,27108,2021-05-21,1621551600.0
16466,2,0,2021-05-22,185,361,46301,27469,2021-05-22,1621638000.0
16467,2,0,2021-05-23,110,179,46411,27648,2021-05-23,1621724400.0
16468,2,0,2021-05-24,135,234,46546,27882,2021-05-24,1621810800.0
16469,2,0,2021-05-25,350,693,46896,28575,2021-05-25,1621897200.0
16470,2,0,2021-05-26,380,690,47276,29265,2021-05-26,1621983600.0
16471,2,0,2021-05-27,264,641,47540,29906,2021-05-27,1622070000.0
16472,2,0,2021-05-28,275,806,47815,30712,2021-05-28,1622156400.0
16473,2,0,2021-05-29,152,507,47967,31219,2021-05-29,1622242800.0
16474,2,0,2021-05-30,16,30,47983,31249,2021-05-30,1622329200.0
16475,2,0,2021-05-31,342,657,48325,31906,2021-05-31,1622415600.0
16476,2,0,2021-06-01,295,523,48620,32429,2021-06-01,1622502000.0
16477,2,0,2021-06-02,319,544,48939,32973,2021-06-02,1622588400.0
16478,2,0,2021-06-03,246,425,49185,33398,2021-06-03,1622674800.0
16479,2,0,2021-06-04,349,621,49534,34019,2021-06-04,1622761200.0
16480,2,0,2021-06-05,256,328,49790,34347,2021-06-05,1622847600.0
16481,2,0,2021-06-06,22,31,49812,34378,2021-06-06,1622934000.0
16482,2,0,2021-06-07,258,729,50070,35107,2021-06-07,1623020400.0
16483,2,0,2021-06-08,253,573,50323,35680,2021-06-08,1623106800.0
16484,2,0,2021-06-09,296,676,50619,36356,2021-06-09,1623193200.0
16485,2,0,2021-06-10,302,436,50921,36792,2021-06-10,1623279600.0
16486,2,0,2021-06-11,334,521,51255,37313,2021-06-11,1623366000.0
16487,2,0,2021-06-12,243,307,51498,37620,2021-06-12,1623452400.0
16488,2,0,2021-06-13,32,28,51530,37648,2021-06-13,1623538800.0
16489,2,0,2021-06-14,363,517,51893,38165,2021-06-14,1623625200.0
16490,2,0,2021-06-15,407,436,52300,38601,2021-06-15,1623711600.0
16491,2,0,2021-06-16,411,403,52711,39004,2021-06-16,1623798000.0
16492,2,0,2021-06-17,346,548,53057,39552,2021-06-17,1623884400.0
16493,2,0,2021-06-18,420,518,53477,40070,2021-06-18,1623970800.0
16494,2,0,2021-06-19,225,178,53702,40248,2021-06-19,1624057200.0
16495,2,0,2021-06-20,25,17,53727,40265,2021-06-20,1624143600.0
16496,2,0,2021-06-21,317,563,54044,40828,2021-06-21,1624230000.0
16497,2,0,2021-06-22,288,434,54332,41262,2021-06-22,1624316400.0
16498,2,0,2021-06-23,406,525,54738,41787,2021-06-23,1624402800.0
16499,2,0,2021-06-24,312,405,55050,42192,2021-06-24,1624489200.0
16500,2,0,2021-06-25,306,352,55356,42544,2021-06-25,1624575600.0
16501,2,0,2021-06-26,215,188,55571,42732,2021-06-26,1624662000.0
16502,2,0,2021-06-27,15,20,55586,42752,2021-06-27,1624748400.0
16503,2,0,2021-06-28,317,388,55903,43140,2021-06-28,1624834800.0
16504,2,0,2021-06-29,317,387,56220,43527,2021-06-29,1624921200.0
16505,2,0,2021-06-30,426,376,56646,43903,2021-06-30,1625007600.0
16506,2,0,2021-07-01,333,355,56979,44258,2021-07-01,1625094000.0
16507,2,0,2021-07-02,121,181,57100,44439,2021-07-02,1625180400.0
16508,2,0,2021-07-03,97,114,57197,44553,2021-07-03,1625266800.0
16509,2,0,2021-07-04,24,34,57221,44587,2021-07-04,1625353200.0
16510,2,0,2021-07-05,480,538,57701,45125,2021-07-05,1625439600.0
16511,2,0,2021-07-06,422,365,58123,45490,2021-07-06,1625526000.0
16512,3,0,2020-12-27,0,0,0,0,2020-12-27,1609023600.0
16513,3,0,2020-12-28,0,0,0,0,2020-12-28,1609110000.0
16514,3,0,2020-12-29,0,0,0,0,2020-12-29,1609196400.0
16515,3,0,2020-12-30,0,0,0,0,2020-12-30,1609282800.0
16516,3,0,2020-12-31,0,0,0,0,2020-12-31,1609369200.0
16517,3,0,2021-01-01,0,0,0,0,2021-01-01,1609455600.0
16518,3,0,2021-01-02,2,0,2,0,2021-01-02,1609542000.0
16519,3,0,2021-01-03,0,0,2,0,2021-01-03,1609628400.0
16520,3,0,2021-01-04,0,0,2,0,2021-01-04,1609714800.0
16521,3,0,2021-01-05,0,0,2,0,2021-01-05,1609801200.0
16522,3,0,2021-01-06,0,0,2,0,2021-01-06,1609887600.0
16523,3,0,2021-01-07,0,0,2,0,2021-01-07,1609974000.0
16524,3,0,2021-01-08,0,0,2,0,2021-01-08,1610060400.0
16525,3,0,2021-01-09,0,0,2,0,2021-01-09,1610146800.0
16526,3,0,2021-01-10,0,0,2,0,2021-01-10,1610233200.0
16527,3,0,2021-01-11,0,0,2,0,2021-01-11,1610319600.0
16528,3,0,2021-01-12,0,0,2,0,2021-01-12,1610406000.0
16529,3,0,2021-01-13,30,0,32,0,2021-01-13,1610492400.0
16530,3,0,2021-01-14,46,0,78,0,2021-01-14,1610578800.0
16531,3,0,2021-01-15,35,0,113,0,2021-01-15,1610665200.0
16532,3,0,2021-01-16,18,0,131,0,2021-01-16,1610751600.0
16533,3,0,2021-01-17,0,0,131,0,2021-01-17,1610838000.0
16534,3,0,2021-01-18,63,0,194,0,2021-01-18,1610924400.0
16535,3,0,2021-01-19,149,0,343,0,2021-01-19,1611010800.0
16536,3,0,2021-01-20,133,0,476,0,2021-01-20,1611097200.0
16537,3,0,2021-01-21,118,0,594,0,2021-01-21,1611183600.0
16538,3,0,2021-01-22,76,0,670,0,2021-01-22,1611270000.0
16539,3,0,2021-01-23,0,0,670,0,2021-01-23,1611356400.0
16540,3,0,2021-01-24,0,0,670,0,2021-01-24,1611442800.0
16541,3,0,2021-01-25,56,0,726,0,2021-01-25,1611529200.0
16542,3,0,2021-01-26,100,0,826,0,2021-01-26,1611615600.0
16543,3,0,2021-01-27,109,0,935,0,2021-01-27,1611702000.0
16544,3,0,2021-01-28,96,2,1031,2,2021-01-28,1611788400.0
16545,3,0,2021-01-29,104,2,1135,4,2021-01-29,1611874800.0
16546,3,0,2021-01-30,0,0,1135,4,2021-01-30,1611961200.0
16547,3,0,2021-01-31,0,0,1135,4,2021-01-31,1612047600.0
16548,3,0,2021-02-01,54,0,1189,4,2021-02-01,1612134000.0
16549,3,0,2021-02-02,122,4,1311,8,2021-02-02,1612220400.0
16550,3,0,2021-02-03,116,7,1427,15,2021-02-03,1612306800.0
16551,3,0,2021-02-04,79,26,1506,41,2021-02-04,1612393200.0
16552,3,0,2021-02-05,65,7,1571,48,2021-02-05,1612479600.0
16553,3,0,2021-02-06,0,0,1571,48,2021-02-06,1612566000.0
16554,3,0,2021-02-07,0,0,1571,48,2021-02-07,1612652400.0
16555,3,0,2021-02-08,52,13,1623,61,2021-02-08,1612738800.0
16556,3,0,2021-02-09,92,38,1715,99,2021-02-09,1612825200.0
16557,3,0,2021-02-10,101,41,1816,140,2021-02-10,1612911600.0
16558,3,0,2021-02-11,105,93,1921,233,2021-02-11,1612998000.0
16559,3,0,2021-02-12,87,62,2008,295,2021-02-12,1613084400.0
16560,3,0,2021-02-13,0,0,2008,295,2021-02-13,1613170800.0
16561,3,0,2021-02-14,0,0,2008,295,2021-02-14,1613257200.0
16562,3,0,2021-02-15,27,65,2035,360,2021-02-15,1613343600.0
16563,3,0,2021-02-16,123,51,2158,411,2021-02-16,1613430000.0
16564,3,0,2021-02-17,145,115,2303,526,2021-02-17,1613516400.0
16565,3,0,2021-02-18,103,141,2406,667,2021-02-18,1613602800.0
16566,3,0,2021-02-19,122,72,2528,739,2021-02-19,1613689200.0
16567,3,0,2021-02-20,0,0,2528,739,2021-02-20,1613775600.0
16568,3,0,2021-02-21,0,0,2528,739,2021-02-21,1613862000.0
16569,3,0,2021-02-22,78,48,2606,787,2021-02-22,1613948400.0
16570,3,0,2021-02-23,158,98,2764,885,2021-02-23,1614034800.0
16571,3,0,2021-02-24,190,119,2954,1004,2021-02-24,1614121200.0
16572,3,0,2021-02-25,258,86,3212,1090,2021-02-25,1614207600.0
16573,3,0,2021-02-26,264,67,3476,1157,2021-02-26,1614294000.0
16574,3,0,2021-02-27,121,1,3597,1158,2021-02-27,1614380400.0
16575,3,0,2021-02-28,0,0,3597,1158,2021-02-28,1614466800.0
16576,3,0,2021-03-01,180,84,3777,1242,2021-03-01,1614553200.0
16577,3,0,2021-03-02,255,106,4032,1348,2021-03-02,1614639600.0
16578,3,0,2021-03-03,255,124,4287,1472,2021-03-03,1614726000.0
16579,3,0,2021-03-04,281,75,4568,1547,2021-03-04,1614812400.0
16580,3,0,2021-03-05,271,40,4839,1587,2021-03-05,1614898800.0
16581,3,0,2021-03-06,116,0,4955,1587,2021-03-06,1614985200.0
16582,3,0,2021-03-07,0,0,4955,1587,2021-03-07,1615071600.0
16583,3,0,2021-03-08,187,37,5142,1624,2021-03-08,1615158000.0
16584,3,0,2021-03-09,350,86,5492,1710,2021-03-09,1615244400.0
16585,3,0,2021-03-10,357,95,5849,1805,2021-03-10,1615330800.0
16586,3,0,2021-03-11,270,114,6119,1919,2021-03-11,1615417200.0
16587,3,0,2021-03-12,287,90,6406,2009,2021-03-12,1615503600.0
16588,3,0,2021-03-13,110,2,6516,2011,2021-03-13,1615590000.0
16589,3,0,2021-03-14,0,0,6516,2011,2021-03-14,1615676400.0
16590,3,0,2021-03-15,180,23,6696,2034,2021-03-15,1615762800.0
16591,3,0,2021-03-16,241,135,6937,2169,2021-03-16,1615849200.0
16592,3,0,2021-03-17,273,121,7210,2290,2021-03-17,1615935600.0
16593,3,0,2021-03-18,249,145,7459,2435,2021-03-18,1616022000.0
16594,3,0,2021-03-19,284,110,7743,2545,2021-03-19,1616108400.0
16595,3,0,2021-03-20,255,12,7998,2557,2021-03-20,1616194800.0
16596,3,0,2021-03-21,119,0,8117,2557,2021-03-21,1616281200.0
16597,3,0,2021-03-22,219,102,8336,2659,2021-03-22,1616367600.0
16598,3,0,2021-03-23,274,177,8610,2836,2021-03-23,1616454000.0
16599,3,0,2021-03-24,235,195,8845,3031,2021-03-24,1616540400.0
16600,3,0,2021-03-25,167,169,9012,3200,2021-03-25,1616626800.0
16601,3,0,2021-03-26,189,294,9201,3494,2021-03-26,1616713200.0
16602,3,0,2021-03-27,56,88,9257,3582,2021-03-27,1616799600.0
16603,3,0,2021-03-28,0,0,9257,3582,2021-03-28,1616886000.0
16604,3,0,2021-03-29,175,232,9432,3814,2021-03-29,1616972400.0
16605,3,0,2021-03-30,445,212,9877,4026,2021-03-30,1617058800.0
16606,3,0,2021-03-31,318,270,10195,4296,2021-03-31,1617145200.0
16607,3,0,2021-04-01,444,239,10639,4535,2021-04-01,1617231600.0
16608,3,0,2021-04-02,306,265,10945,4800,2021-04-02,1617318000.0
16609,3,0,2021-04-03,152,113,11097,4913,2021-04-03,1617404400.0
16610,3,0,2021-04-04,0,0,11097,4913,2021-04-04,1617490800.0
16611,3,0,2021-04-05,118,8,11215,4921,2021-04-05,1617577200.0
16612,3,0,2021-04-06,438,302,11653,5223,2021-04-06,1617663600.0
16613,3,0,2021-04-07,501,316,12154,5539,2021-04-07,1617750000.0
16614,3,0,2021-04-08,511,233,12665,5772,2021-04-08,1617836400.0
16615,3,0,2021-04-09,496,206,13161,5978,2021-04-09,1617922800.0
16616,3,0,2021-04-10,146,86,13307,6064,2021-04-10,1618009200.0
16617,3,0,2021-04-11,2,0,13309,6064,2021-04-11,1618095600.0
16618,3,0,2021-04-12,552,237,13861,6301,2021-04-12,1618185600.0
16619,3,0,2021-04-13,671,204,14532,6505,2021-04-13,1618272000.0
16620,3,0,2021-04-14,718,256,15250,6761,2021-04-14,1618358400.0
16621,3,0,2021-04-15,773,201,16023,6962,2021-04-15,1618444800.0
16622,3,0,2021-04-16,752,245,16775,7207,2021-04-16,1618531200.0
16623,3,0,2021-04-17,499,98,17274,7305,2021-04-17,1618617600.0
16624,3,0,2021-04-18,499,8,17773,7313,2021-04-18,1618704000.0
16625,3,0,2021-04-19,713,195,18486,7508,2021-04-19,1618790400.0
16626,3,0,2021-04-20,604,235,19090,7743,2021-04-20,1618876800.0
16627,3,0,2021-04-21,865,165,19955,7908,2021-04-21,1618963200.0
16628,3,0,2021-04-22,723,173,20678,8081,2021-04-22,1619049600.0
16629,3,0,2021-04-23,704,173,21382,8254,2021-04-23,1619136000.0
16630,3,0,2021-04-24,525,57,21907,8311,2021-04-24,1619222400.0
16631,3,0,2021-04-25,612,4,22519,8315,2021-04-25,1619308800.0
16632,3,0,2021-04-26,777,170,23296,8485,2021-04-26,1619395200.0
16633,3,0,2021-04-27,784,244,24080,8729,2021-04-27,1619481600.0
16634,3,0,2021-04-28,692,258,24772,8987,2021-04-28,1619568000.0
16635,3,0,2021-04-29,621,233,25393,9220,2021-04-29,1619654400.0
16636,3,0,2021-04-30,673,214,26066,9434,2021-04-30,1619740800.0
16637,3,0,2021-05-01,210,6,26276,9440,2021-05-01,1619827200.0
16638,3,0,2021-05-02,602,28,26878,9468,2021-05-02,1619913600.0
16639,3,0,2021-05-03,553,343,27431,9811,2021-05-03,1620000000.0
16640,3,0,2021-05-04,617,279,28048,10090,2021-05-04,1620086400.0
16641,3,0,2021-05-05,657,408,28705,10498,2021-05-05,1620172800.0
16642,3,0,2021-05-06,650,419,29355,10917,2021-05-06,1620259200.0
16643,3,0,2021-05-07,546,419,29901,11336,2021-05-07,1620345600.0
16644,3,0,2021-05-08,341,43,30242,11379,2021-05-08,1620432000.0
16645,3,0,2021-05-09,262,58,30504,11437,2021-05-09,1620518400.0
16646,3,0,2021-05-10,418,579,30922,12016,2021-05-10,1620604800.0
16647,3,0,2021-05-11,392,460,31314,12476,2021-05-11,1620691200.0
16648,3,0,2021-05-12,502,592,31816,13068,2021-05-12,1620777600.0
16649,3,0,2021-05-13,333,62,32149,13130,2021-05-13,1620864000.0
16650,3,0,2021-05-14,473,505,32622,13635,2021-05-14,1620950400.0
16651,3,0,2021-05-15,254,325,32876,13960,2021-05-15,1621036800.0
16652,3,0,2021-05-16,207,200,33083,14160,2021-05-16,1621123200.0
16653,3,0,2021-05-17,444,546,33527,14706,2021-05-17,1621206000.0
16654,3,0,2021-05-18,559,504,34086,15210,2021-05-18,1621292400.0
16655,3,0,2021-05-19,525,507,34611,15717,2021-05-19,1621378800.0
16656,3,0,2021-05-20,636,396,35247,16113,2021-05-20,1621465200.0
16657,3,0,2021-05-21,490,573,35737,16686,2021-05-21,1621551600.0
16658,3,0,2021-05-22,168,486,35905,17172,2021-05-22,1621638000.0
16659,3,0,2021-05-23,269,454,36174,17626,2021-05-23,1621724400.0
16660,3,0,2021-05-24,560,209,36734,17835,2021-05-24,1621810800.0
16661,3,0,2021-05-25,495,681,37229,18516,2021-05-25,1621897200.0
16662,3,0,2021-05-26,433,655,37662,19171,2021-05-26,1621983600.0
16663,3,0,2021-05-27,690,451,38352,19622,2021-05-27,1622070000.0
16664,3,0,2021-05-28,546,517,38898,20139,2021-05-28,1622156400.0
16665,3,0,2021-05-29,239,341,39137,20480,2021-05-29,1622242800.0
16666,3,0,2021-05-30,151,394,39288,20874,2021-05-30,1622329200.0
16667,3,0,2021-05-31,341,550,39629,21424,2021-05-31,1622415600.0
16668,3,0,2021-06-01,394,416,40023,21840,2021-06-01,1622502000.0
16669,3,0,2021-06-02,523,518,40546,22358,2021-06-02,1622588400.0
16670,3,0,2021-06-03,475,424,41021,22782,2021-06-03,1622674800.0
16671,3,0,2021-06-04,542,450,41563,23232,2021-06-04,1622761200.0
16672,3,0,2021-06-05,271,270,41834,23502,2021-06-05,1622847600.0
16673,3,0,2021-06-06,211,285,42045,23787,2021-06-06,1622934000.0
16674,3,0,2021-06-07,464,407,42509,24194,2021-06-07,1623020400.0
16675,3,0,2021-06-08,518,271,43027,24465,2021-06-08,1623106800.0
16676,3,0,2021-06-09,493,339,43520,24804,2021-06-09,1623193200.0
16677,3,0,2021-06-10,344,251,43864,25055,2021-06-10,1623279600.0
16678,3,0,2021-06-11,408,434,44272,25489,2021-06-11,1623366000.0
16679,3,0,2021-06-12,166,269,44438,25758,2021-06-12,1623452400.0
16680,3,0,2021-06-13,200,247,44638,26005,2021-06-13,1623538800.0
16681,3,0,2021-06-14,352,519,44990,26524,2021-06-14,1623625200.0
16682,3,0,2021-06-15,355,405,45345,26929,2021-06-15,1623711600.0
16683,3,0,2021-06-16,394,407,45739,27336,2021-06-16,1623798000.0
16684,3,0,2021-06-17,364,540,46103,27876,2021-06-17,1623884400.0
16685,3,0,2021-06-18,338,536,46441,28412,2021-06-18,1623970800.0
16686,3,0,2021-06-19,230,237,46671,28649,2021-06-19,1624057200.0
16687,3,0,2021-06-20,123,263,46794,28912,2021-06-20,1624143600.0
16688,3,0,2021-06-21,264,556,47058,29468,2021-06-21,1624230000.0
16689,3,0,2021-06-22,306,427,47364,29895,2021-06-22,1624316400.0
16690,3,0,2021-06-23,272,495,47636,30390,2021-06-23,1624402800.0
16691,3,0,2021-06-24,387,460,48023,30850,2021-06-24,1624489200.0
16692,3,0,2021-06-25,377,505,48400,31355,2021-06-25,1624575600.0
16693,3,0,2021-06-26,164,309,48564,31664,2021-06-26,1624662000.0
16694,3,0,2021-06-27,117,161,48681,31825,2021-06-27,1624748400.0
16695,3,0,2021-06-28,281,551,48962,32376,2021-06-28,1624834800.0
16696,3,0,2021-06-29,325,463,49287,32839,2021-06-29,1624921200.0
16697,3,0,2021-06-30,268,628,49555,33467,2021-06-30,1625007600.0
16698,3,0,2021-07-01,311,368,49866,33835,2021-07-01,1625094000.0
16699,3,0,2021-07-02,347,471,50213,34306,2021-07-02,1625180400.0
16700,3,0,2021-07-03,203,244,50416,34550,2021-07-03,1625266800.0
16701,3,0,2021-07-04,85,226,50501,34776,2021-07-04,1625353200.0
16702,3,0,2021-07-05,291,505,50792,35281,2021-07-05,1625439600.0
16703,3,0,2021-07-06,291,424,51083,35705,2021-07-06,1625526000.0
16704,4,0,2020-12-27,0,0,0,0,2020-12-27,1609023600.0
16705,4,0,2020-12-28,0,0,0,0,2020-12-28,1609110000.0
16706,4,0,2020-12-29,0,0,0,0,2020-12-29,1609196400.0
16707,4,0,2020-12-30,0,0,0,0,2020-12-30,1609282800.0
16708,4,0,2020-12-31,0,0,0,0,2020-12-31,1609369200.0
16709,4,0,2021-01-01,1,0,1,0,2021-01-01,1609455600.0
16710,4,0,2021-01-02,0,0,1,0,2021-01-02,1609542000.0
16711,4,0,2021-01-03,0,0,1,0,2021-01-03,1609628400.0
16712,4,0,2021-01-04,0,0,1,0,2021-01-04,1609714800.0
16713,4,0,2021-01-05,2,0,3,0,2021-01-05,1609801200.0
16714,4,0,2021-01-06,0,0,3,0,2021-01-06,1609887600.0
16715,4,0,2021-01-07,0,0,3,0,2021-01-07,1609974000.0
16716,4,0,2021-01-08,0,0,3,0,2021-01-08,1610060400.0
16717,4,0,2021-01-09,1,0,4,0,2021-01-09,1610146800.0
16718,4,0,2021-01-10,0,0,4,0,2021-01-10,1610233200.0
16719,4,0,2021-01-11,0,0,4,0,2021-01-11,1610319600.0
16720,4,0,2021-01-12,0,0,4,0,2021-01-12,1610406000.0
16721,4,0,2021-01-13,0,0,4,0,2021-01-13,1610492400.0
16722,4,0,2021-01-14,0,0,4,0,2021-01-14,1610578800.0
16723,4,0,2021-01-15,332,0,336,0,2021-01-15,1610665200.0
16724,4,0,2021-01-16,27,0,363,0,2021-01-16,1610751600.0
16725,4,0,2021-01-17,0,0,363,0,2021-01-17,1610838000.0
16726,4,0,2021-01-18,49,0,412,0,2021-01-18,1610924400.0
16727,4,0,2021-01-19,393,0,805,0,2021-01-19,1611010800.0
16728,4,0,2021-01-20,481,0,1286,0,2021-01-20,1611097200.0
16729,4,0,2021-01-21,614,1,1900,1,2021-01-21,1611183600.0
16730,4,0,2021-01-22,409,0,2309,1,2021-01-22,1611270000.0
16731,4,0,2021-01-23,75,0,2384,1,2021-01-23,1611356400.0
16732,4,0,2021-01-24,0,0,2384,1,2021-01-24,1611442800.0
16733,4,0,2021-01-25,272,0,2656,1,2021-01-25,1611529200.0
16734,4,0,2021-01-26,429,0,3085,1,2021-01-26,1611615600.0
16735,4,0,2021-01-27,317,0,3402,1,2021-01-27,1611702000.0
16736,4,0,2021-01-28,407,0,3809,1,2021-01-28,1611788400.0
16737,4,0,2021-01-29,421,3,4230,4,2021-01-29,1611874800.0
16738,4,0,2021-01-30,419,0,4649,4,2021-01-30,1611961200.0
16739,4,0,2021-01-31,0,0,4649,4,2021-01-31,1612047600.0
16740,4,0,2021-02-01,372,3,5021,7,2021-02-01,1612134000.0
16741,4,0,2021-02-02,499,4,5520,11,2021-02-02,1612220400.0
16742,4,0,2021-02-03,602,13,6122,24,2021-02-03,1612306800.0
16743,4,0,2021-02-04,626,21,6748,45,2021-02-04,1612393200.0
16744,4,0,2021-02-05,564,98,7312,143,2021-02-05,1612479600.0
16745,4,0,2021-02-06,501,4,7813,147,2021-02-06,1612566000.0
16746,4,0,2021-02-07,0,8,7813,155,2021-02-07,1612652400.0
16747,4,0,2021-02-08,472,34,8285,189,2021-02-08,1612738800.0
16748,4,0,2021-02-09,784,90,9069,279,2021-02-09,1612825200.0
16749,4,0,2021-02-10,820,85,9889,364,2021-02-10,1612911600.0
16750,4,0,2021-02-11,796,85,10685,449,2021-02-11,1612998000.0
16751,4,0,2021-02-12,637,95,11322,544,2021-02-12,1613084400.0
16752,4,0,2021-02-13,651,74,11973,618,2021-02-13,1613170800.0
16753,4,0,2021-02-14,1,0,11974,618,2021-02-14,1613257200.0
16754,4,0,2021-02-15,524,124,12498,742,2021-02-15,1613343600.0
16755,4,0,2021-02-16,651,534,13149,1276,2021-02-16,1613430000.0
16756,4,0,2021-02-17,592,328,13741,1604,2021-02-17,1613516400.0
16757,4,0,2021-02-18,493,414,14234,2018,2021-02-18,1613602800.0
16758,4,0,2021-02-19,496,320,14730,2338,2021-02-19,1613689200.0
16759,4,0,2021-02-20,576,116,15306,2454,2021-02-20,1613775600.0
16760,4,0,2021-02-21,0,0,15306,2454,2021-02-21,1613862000.0
16761,4,0,2021-02-22,402,236,15708,2690,2021-02-22,1613948400.0
16762,4,0,2021-02-23,607,236,16315,2926,2021-02-23,1614034800.0
16763,4,0,2021-02-24,583,253,16898,3179,2021-02-24,1614121200.0
16764,4,0,2021-02-25,645,294,17543,3473,2021-02-25,1614207600.0
16765,4,0,2021-02-26,483,470,18026,3943,2021-02-26,1614294000.0
16766,4,0,2021-02-27,386,470,18412,4413,2021-02-27,1614380400.0
16767,4,0,2021-02-28,0,0,18412,4413,2021-02-28,1614466800.0
16768,4,0,2021-03-01,290,391,18702,4804,2021-03-01,1614553200.0
16769,4,0,2021-03-02,486,500,19188,5304,2021-03-02,1614639600.0
16770,4,0,2021-03-03,755,554,19943,5858,2021-03-03,1614726000.0
16771,4,0,2021-03-04,775,538,20718,6396,2021-03-04,1614812400.0
16772,4,0,2021-03-05,727,532,21445,6928,2021-03-05,1614898800.0
16773,4,0,2021-03-06,812,529,22257,7457,2021-03-06,1614985200.0
16774,4,0,2021-03-07,0,0,22257,7457,2021-03-07,1615071600.0
16775,4,0,2021-03-08,435,590,22692,8047,2021-03-08,1615158000.0
16776,4,0,2021-03-09,670,774,23362,8821,2021-03-09,1615244400.0
16777,4,0,2021-03-10,644,849,24006,9670,2021-03-10,1615330800.0
16778,4,0,2021-03-11,699,642,24705,10312,2021-03-11,1615417200.0
16779,4,0,2021-03-12,729,661,25434,10973,2021-03-12,1615503600.0
16780,4,0,2021-03-13,668,609,26102,11582,2021-03-13,1615590000.0
16781,4,0,2021-03-14,2,0,26104,11582,2021-03-14,1615676400.0
16782,4,0,2021-03-15,504,506,26608,12088,2021-03-15,1615762800.0
16783,4,0,2021-03-16,680,708,27288,12796,2021-03-16,1615849200.0
16784,4,0,2021-03-17,846,537,28134,13333,2021-03-17,1615935600.0
16785,4,0,2021-03-18,1021,551,29155,13884,2021-03-18,1616022000.0
16786,4,0,2021-03-19,784,541,29939,14425,2021-03-19,1616108400.0
16787,4,0,2021-03-20,576,595,30515,15020,2021-03-20,1616194800.0
16788,4,0,2021-03-21,0,0,30515,15020,2021-03-21,1616281200.0
16789,4,0,2021-03-22,565,478,31080,15498,2021-03-22,1616367600.0
16790,4,0,2021-03-23,780,634,31860,16132,2021-03-23,1616454000.0
16791,4,0,2021-03-24,792,667,32652,16799,2021-03-24,1616540400.0
16792,4,0,2021-03-25,929,549,33581,17348,2021-03-25,1616626800.0
16793,4,0,2021-03-26,921,441,34502,17789,2021-03-26,1616713200.0
16794,4,0,2021-03-27,782,337,35284,18126,2021-03-27,1616799600.0
16795,4,0,2021-03-28,1,0,35285,18126,2021-03-28,1616886000.0
16796,4,0,2021-03-29,961,269,36246,18395,2021-03-29,1616972400.0
16797,4,0,2021-03-30,883,498,37129,18893,2021-03-30,1617058800.0
16798,4,0,2021-03-31,740,669,37869,19562,2021-03-31,1617145200.0
16799,4,0,2021-04-01,716,707,38585,20269,2021-04-01,1617231600.0
16800,4,0,2021-04-02,688,758,39273,21027,2021-04-02,1617318000.0
16801,4,0,2021-04-03,699,699,39972,21726,2021-04-03,1617404400.0
16802,4,0,2021-04-04,0,0,39972,21726,2021-04-04,1617490800.0
16803,4,0,2021-04-05,0,2,39972,21728,2021-04-05,1617577200.0
16804,4,0,2021-04-06,795,634,40767,22362,2021-04-06,1617663600.0
16805,4,0,2021-04-07,1369,777,42136,23139,2021-04-07,1617750000.0
16806,4,0,2021-04-08,1792,775,43928,23914,2021-04-08,1617836400.0
16807,4,0,2021-04-09,1508,779,45436,24693,2021-04-09,1617922800.0
16808,4,0,2021-04-10,1137,649,46573,25342,2021-04-10,1618009200.0
16809,4,0,2021-04-11,2,0,46575,25342,2021-04-11,1618095600.0
16810,4,0,2021-04-12,1238,542,47813,25884,2021-04-12,1618185600.0
16811,4,0,2021-04-13,1440,745,49253,26629,2021-04-13,1618272000.0
16812,4,0,2021-04-14,2069,770,51322,27399,2021-04-14,1618358400.0
16813,4,0,2021-04-15,2504,939,53826,28338,2021-04-15,1618444800.0
16814,4,0,2021-04-16,1932,766,55758,29104,2021-04-16,1618531200.0
16815,4,0,2021-04-17,1289,595,57047,29699,2021-04-17,1618617600.0
16816,4,0,2021-04-18,0,0,57047,29699,2021-04-18,1618704000.0
16817,4,0,2021-04-19,1377,561,58424,30260,2021-04-19,1618790400.0
16818,4,0,2021-04-20,1649,792,60073,31052,2021-04-20,1618876800.0
16819,4,0,2021-04-21,2127,598,62200,31650,2021-04-21,1618963200.0
16820,4,0,2021-04-22,2946,780,65146,32430,2021-04-22,1619049600.0
16821,4,0,2021-04-23,2309,796,67455,33226,2021-04-23,1619136000.0
16822,4,0,2021-04-24,1102,790,68557,34016,2021-04-24,1619222400.0
16823,4,0,2021-04-25,2,0,68559,34016,2021-04-25,1619308800.0
16824,4,0,2021-04-26,1164,908,69723,34924,2021-04-26,1619395200.0
16825,4,0,2021-04-27,1683,1014,71406,35938,2021-04-27,1619481600.0
16826,4,0,2021-04-28,2897,716,74303,36654,2021-04-28,1619568000.0
16827,4,0,2021-04-29,3946,797,78249,37451,2021-04-29,1619654400.0
16828,4,0,2021-04-30,3432,879,81681,38330,2021-04-30,1619740800.0
16829,4,0,2021-05-01,2106,202,83787,38532,2021-05-01,1619827200.0
16830,4,0,2021-05-02,2,0,83789,38532,2021-05-02,1619913600.0
16831,4,0,2021-05-03,1865,542,85654,39074,2021-05-03,1620000000.0
16832,4,0,2021-05-04,2127,1072,87781,40146,2021-05-04,1620086400.0
16833,4,0,2021-05-05,3118,1607,90899,41753,2021-05-05,1620172800.0
16834,4,0,2021-05-06,4005,1562,94904,43315,2021-05-06,1620259200.0
16835,4,0,2021-05-07,3228,1502,98132,44817,2021-05-07,1620345600.0
16836,4,0,2021-05-08,1566,481,99698,45298,2021-05-08,1620432000.0
16837,4,0,2021-05-09,1,0,99699,45298,2021-05-09,1620518400.0
16838,4,0,2021-05-10,2411,976,102110,46274,2021-05-10,1620604800.0
16839,4,0,2021-05-11,3650,1583,105760,47857,2021-05-11,1620691200.0
16840,4,0,2021-05-12,4722,2310,110482,50167,2021-05-12,1620777600.0
16841,4,0,2021-05-13,3554,544,114036,50711,2021-05-13,1620864000.0
16842,4,0,2021-05-14,5267,2350,119303,53061,2021-05-14,1620950400.0
16843,4,0,2021-05-15,3161,1477,122464,54538,2021-05-15,1621036800.0
16844,4,0,2021-05-16,15,6,122479,54544,2021-05-16,1621123200.0
16845,4,0,2021-05-17,2999,1372,125478,55916,2021-05-17,1621206000.0
16846,4,0,2021-05-18,3754,1552,129232,57468,2021-05-18,1621292400.0
16847,4,0,2021-05-19,4680,2162,133912,59630,2021-05-19,1621378800.0
16848,4,0,2021-05-20,5140,2648,139052,62278,2021-05-20,1621465200.0
16849,4,0,2021-05-21,4988,2414,144040,64692,2021-05-21,1621551600.0
16850,4,0,2021-05-22,3367,1112,147407,65804,2021-05-22,1621638000.0
16851,4,0,2021-05-23,5,0,147412,65804,2021-05-23,1621724400.0
16852,4,0,2021-05-24,3642,966,151054,66770,2021-05-24,1621810800.0
16853,4,0,2021-05-25,4246,1511,155300,68281,2021-05-25,1621897200.0
16854,4,0,2021-05-26,4979,2604,160279,70885,2021-05-26,1621983600.0
16855,4,0,2021-05-27,4612,3689,164891,74574,2021-05-27,1622070000.0
16856,4,0,2021-05-28,4374,3497,169265,78071,2021-05-28,1622156400.0
16857,4,0,2021-05-29,2553,2256,171818,80327,2021-05-29,1622242800.0
16858,4,0,2021-05-30,7,13,171825,80340,2021-05-30,1622329200.0
16859,4,0,2021-05-31,2349,1988,174174,82328,2021-05-31,1622415600.0
16860,4,0,2021-06-01,3296,2342,177470,84670,2021-06-01,1622502000.0
16861,4,0,2021-06-02,3961,3046,181431,87716,2021-06-02,1622588400.0
16862,4,0,2021-06-03,4040,3326,185471,91042,2021-06-03,1622674800.0
16863,4,0,2021-06-04,3846,3410,189317,94452,2021-06-04,1622761200.0
16864,4,0,2021-06-05,2209,1799,191526,96251,2021-06-05,1622847600.0
16865,4,0,2021-06-06,1070,74,192596,96325,2021-06-06,1622934000.0
16866,4,0,2021-06-07,2009,2324,194605,98649,2021-06-07,1623020400.0
16867,4,0,2021-06-08,2536,3047,197141,101696,2021-06-08,1623106800.0
16868,4,0,2021-06-09,2956,4548,200097,106244,2021-06-09,1623193200.0
16869,4,0,2021-06-10,3351,4211,203448,110455,2021-06-10,1623279600.0
16870,4,0,2021-06-11,2832,4400,206280,114855,2021-06-11,1623366000.0
16871,4,0,2021-06-12,1712,3203,207992,118058,2021-06-12,1623452400.0
16872,4,0,2021-06-13,1314,184,209306,118242,2021-06-13,1623538800.0
16873,4,0,2021-06-14,1480,3029,210786,121271,2021-06-14,1623625200.0
16874,4,0,2021-06-15,2037,3330,212823,124601,2021-06-15,1623711600.0
16875,4,0,2021-06-16,2714,4393,215537,128994,2021-06-16,1623798000.0
16876,4,0,2021-06-17,2498,4701,218035,133695,2021-06-17,1623884400.0
16877,4,0,2021-06-18,2559,4674,220594,138369,2021-06-18,1623970800.0
16878,4,0,2021-06-19,1295,3407,221889,141776,2021-06-19,1624057200.0
16879,4,0,2021-06-20,625,235,222514,142011,2021-06-20,1624143600.0
16880,4,0,2021-06-21,1255,3087,223769,145098,2021-06-21,1624230000.0
16881,4,0,2021-06-22,1603,3538,225372,148636,2021-06-22,1624316400.0
16882,4,0,2021-06-23,2227,4786,227599,153422,2021-06-23,1624402800.0
16883,4,0,2021-06-24,2272,3874,229871,157296,2021-06-24,1624489200.0
16884,4,0,2021-06-25,2173,3918,232044,161214,2021-06-25,1624575600.0
16885,4,0,2021-06-26,1386,2598,233430,163812,2021-06-26,1624662000.0
16886,4,0,2021-06-27,655,200,234085,164012,2021-06-27,1624748400.0
16887,4,0,2021-06-28,1297,2351,235382,166363,2021-06-28,1624834800.0
16888,4,0,2021-06-29,1726,2637,237108,169000,2021-06-29,1624921200.0
16889,4,0,2021-06-30,2537,3613,239645,172613,2021-06-30,1625007600.0
16890,4,0,2021-07-01,2654,3613,242299,176226,2021-07-01,1625094000.0
16891,4,0,2021-07-02,2481,3467,244780,179693,2021-07-02,1625180400.0
16892,4,0,2021-07-03,1597,2310,246377,182003,2021-07-03,1625266800.0
16893,4,0,2021-07-04,871,966,247248,182969,2021-07-04,1625353200.0
16894,4,0,2021-07-05,1669,2036,248917,185005,2021-07-05,1625439600.0
16895,4,0,2021-07-06,2378,2284,251295,187289,2021-07-06,1625526000.0
16896,5,0,2020-12-27,0,0,0,0,2020-12-27,1609023600.0
16897,5,0,2020-12-28,0,0,0,0,2020-12-28,1609110000.0
16898,5,0,2020-12-29,0,0,0,0,2020-12-29,1609196400.0
16899,5,0,2020-12-30,0,0,0,0,2020-12-30,1609282800.0
16900,5,0,2020-12-31,0,0,0,0,2020-12-31,1609369200.0
16901,5,0,2021-01-01,0,0,0,0,2021-01-01,1609455600.0
16902,5,0,2021-01-02,0,0,0,0,2021-01-02,1609542000.0
16903,5,0,2021-01-03,0,0,0,0,2021-01-03,1609628400.0
16904,5,0,2021-01-04,0,0,0,0,2021-01-04,1609714800.0
16905,5,0,2021-01-05,0,0,0,0,2021-01-05,1609801200.0
16906,5,0,2021-01-06,0,0,0,0,2021-01-06,1609887600.0
16907,5,0,2021-01-07,0,0,0,0,2021-01-07,1609974000.0
16908,5,0,2021-01-08,0,0,0,0,2021-01-08,1610060400.0
16909,5,0,2021-01-09,0,0,0,0,2021-01-09,1610146800.0
16910,5,0,2021-01-10,0,0,0,0,2021-01-10,1610233200.0
16911,5,0,2021-01-11,0,0,0,0,2021-01-11,1610319600.0
16912,5,0,2021-01-12,0,0,0,0,2021-01-12,1610406000.0
16913,5,0,2021-01-13,0,0,0,0,2021-01-13,1610492400.0
16914,5,0,2021-01-14,0,0,0,0,2021-01-14,1610578800.0
16915,5,0,2021-01-15,0,0,0,0,2021-01-15,1610665200.0
16916,5,0,2021-01-16,0,0,0,0,2021-01-16,1610751600.0
16917,5,0,2021-01-17,0,0,0,0,2021-01-17,1610838000.0
16918,5,0,2021-01-18,0,0,0,0,2021-01-18,1610924400.0
16919,5,0,2021-01-19,0,0,0,0,2021-01-19,1611010800.0
16920,5,0,2021-01-20,0,0,0,0,2021-01-20,1611097200.0
16921,5,0,2021-01-21,0,0,0,0,2021-01-21,1611183600.0
16922,5,0,2021-01-22,0,0,0,0,2021-01-22,1611270000.0
16923,5,0,2021-01-23,0,0,0,0,2021-01-23,1611356400.0
16924,5,0,2021-01-24,0,0,0,0,2021-01-24,1611442800.0
16925,5,0,2021-01-25,0,0,0,0,2021-01-25,1611529200.0
16926,5,0,2021-01-26,0,0,0,0,2021-01-26,1611615600.0
16927,5,0,2021-01-27,0,0,0,0,2021-01-27,1611702000.0
16928,5,0,2021-01-28,0,0,0,0,2021-01-28,1611788400.0
16929,5,0,2021-01-29,0,0,0,0,2021-01-29,1611874800.0
16930,5,0,2021-01-30,0,0,0,0,2021-01-30,1611961200.0
16931,5,0,2021-01-31,0,0,0,0,2021-01-31,1612047600.0
16932,5,0,2021-02-01,0,0,0,0,2021-02-01,1612134000.0
16933,5,0,2021-02-02,0,0,0,0,2021-02-02,1612220400.0
16934,5,0,2021-02-03,0,0,0,0,2021-02-03,1612306800.0
16935,5,0,2021-02-04,0,0,0,0,2021-02-04,1612393200.0
16936,5,0,2021-02-05,0,0,0,0,2021-02-05,1612479600.0
16937,5,0,2021-02-06,0,0,0,0,2021-02-06,1612566000.0
16938,5,0,2021-02-07,0,0,0,0,2021-02-07,1612652400.0
16939,5,0,2021-02-08,0,0,0,0,2021-02-08,1612738800.0
16940,5,0,2021-02-09,0,0,0,0,2021-02-09,1612825200.0
16941,5,0,2021-02-10,0,0,0,0,2021-02-10,1612911600.0
16942,5,0,2021-02-11,0,0,0,0,2021-02-11,1612998000.0
16943,5,0,2021-02-12,0,0,0,0,2021-02-12,1613084400.0
16944,5,0,2021-02-13,0,0,0,0,2021-02-13,1613170800.0
16945,5,0,2021-02-14,0,0,0,0,2021-02-14,1613257200.0
16946,5,0,2021-02-15,0,0,0,0,2021-02-15,1613343600.0
16947,5,0,2021-02-16,0,0,0,0,2021-02-16,1613430000.0
16948,5,0,2021-02-17,0,0,0,0,2021-02-17,1613516400.0
16949,5,0,2021-02-18,0,0,0,0,2021-02-18,1613602800.0
16950,5,0,2021-02-19,0,0,0,0,2021-02-19,1613689200.0
16951,5,0,2021-02-20,0,0,0,0,2021-02-20,1613775600.0
16952,5,0,2021-02-21,0,0,0,0,2021-02-21,1613862000.0
16953,5,0,2021-02-22,0,0,0,0,2021-02-22,1613948400.0
16954,5,0,2021-02-23,0,0,0,0,2021-02-23,1614034800.0
16955,5,0,2021-02-24,0,0,0,0,2021-02-24,1614121200.0
16956,5,0,2021-02-25,0,0,0,0,2021-02-25,1614207600.0
16957,5,0,2021-02-26,0,0,0,0,2021-02-26,1614294000.0
16958,5,0,2021-02-27,0,0,0,0,2021-02-27,1614380400.0
16959,5,0,2021-02-28,0,0,0,0,2021-02-28,1614466800.0
16960,5,0,2021-03-01,0,0,0,0,2021-03-01,1614553200.0
16961,5,0,2021-03-02,0,0,0,0,2021-03-02,1614639600.0
16962,5,0,2021-03-03,0,0,0,0,2021-03-03,1614726000.0
16963,5,0,2021-03-04,0,0,0,0,2021-03-04,1614812400.0
16964,5,0,2021-03-05,0,0,0,0,2021-03-05,1614898800.0
16965,5,0,2021-03-06,0,0,0,0,2021-03-06,1614985200.0
16966,5,0,2021-03-07,0,0,0,0,2021-03-07,1615071600.0
16967,5,0,2021-03-08,0,0,0,0,2021-03-08,1615158000.0
16968,5,0,2021-03-09,0,0,0,0,2021-03-09,1615244400.0
16969,5,0,2021-03-10,0,0,0,0,2021-03-10,1615330800.0
16970,5,0,2021-03-11,0,0,0,0,2021-03-11,1615417200.0
16971,5,0,2021-03-12,0,0,0,0,2021-03-12,1615503600.0
16972,5,0,2021-03-13,0,0,0,0,2021-03-13,1615590000.0
16973,5,0,2021-03-14,0,0,0,0,2021-03-14,1615676400.0
16974,5,0,2021-03-15,0,0,0,0,2021-03-15,1615762800.0
16975,5,0,2021-03-16,0,0,0,0,2021-03-16,1615849200.0
16976,5,0,2021-03-17,0,0,0,0,2021-03-17,1615935600.0
16977,5,0,2021-03-18,0,0,0,0,2021-03-18,1616022000.0
16978,5,0,2021-03-19,0,0,0,0,2021-03-19,1616108400.0
16979,5,0,2021-03-20,0,0,0,0,2021-03-20,1616194800.0
16980,5,0,2021-03-21,0,0,0,0,2021-03-21,1616281200.0
16981,5,0,2021-03-22,0,0,0,0,2021-03-22,1616367600.0
16982,5,0,2021-03-23,0,0,0,0,2021-03-23,1616454000.0
16983,5,0,2021-03-24,0,0,0,0,2021-03-24,1616540400.0
16984,5,0,2021-03-25,0,0,0,0,2021-03-25,1616626800.0
16985,5,0,2021-03-26,0,0,0,0,2021-03-26,1616713200.0
16986,5,0,2021-03-27,0,0,0,0,2021-03-27,1616799600.0
16987,5,0,2021-03-28,0,0,0,0,2021-03-28,1616886000.0
16988,5,0,2021-03-29,2,0,2,0,2021-03-29,1616972400.0
16989,5,0,2021-03-30,0,0,2,0,2021-03-30,1617058800.0
16990,5,0,2021-03-31,0,0,2,0,2021-03-31,1617145200.0
16991,5,0,2021-04-01,0,0,2,0,2021-04-01,1617231600.0
16992,5,0,2021-04-02,0,0,2,0,2021-04-02,1617318000.0
16993,5,0,2021-04-03,0,0,2,0,2021-04-03,1617404400.0
16994,5,0,2021-04-04,0,0,2,0,2021-04-04,1617490800.0
16995,5,0,2021-04-05,0,0,2,0,2021-04-05,1617577200.0
16996,5,0,2021-04-06,0,0,2,0,2021-04-06,1617663600.0
16997,5,0,2021-04-07,0,0,2,0,2021-04-07,1617750000.0
16998,5,0,2021-04-08,1,0,3,0,2021-04-08,1617836400.0
16999,5,0,2021-04-09,0,0,3,0,2021-04-09,1617922800.0
17000,5,0,2021-04-10,0,0,3,0,2021-04-10,1618009200.0
17001,5,0,2021-04-11,0,0,3,0,2021-04-11,1618095600.0
17002,5,0,2021-04-12,0,0,3,0,2021-04-12,1618185600.0
17003,5,0,2021-04-13,0,0,3,0,2021-04-13,1618272000.0
17004,5,0,2021-04-14,0,0,3,0,2021-04-14,1618358400.0
17005,5,0,2021-04-15,0,0,3,0,2021-04-15,1618444800.0
17006,5,0,2021-04-16,0,0,3,0,2021-04-16,1618531200.0
17007,5,0,2021-04-17,0,0,3,0,2021-04-17,1618617600.0
17008,5,0,2021-04-18,0,0,3,0,2021-04-18,1618704000.0
17009,5,0,2021-04-19,0,0,3,0,2021-04-19,1618790400.0
17010,5,0,2021-04-20,0,0,3,0,2021-04-20,1618876800.0
17011,5,0,2021-04-21,0,0,3,0,2021-04-21,1618963200.0
17012,5,0,2021-04-22,0,0,3,0,2021-04-22,1619049600.0
17013,5,0,2021-04-23,0,0,3,0,2021-04-23,1619136000.0
17014,5,0,2021-04-24,0,0,3,0,2021-04-24,1619222400.0
17015,5,0,2021-04-25,0,0,3,0,2021-04-25,1619308800.0
17016,5,0,2021-04-26,0,0,3,0,2021-04-26,1619395200.0
17017,5,0,2021-04-27,0,0,3,0,2021-04-27,1619481600.0
17018,5,0,2021-04-28,0,0,3,0,2021-04-28,1619568000.0
17019,5,0,2021-04-29,0,0,3,0,2021-04-29,1619654400.0
17020,5,0,2021-04-30,0,0,3,0,2021-04-30,1619740800.0
17021,5,0,2021-05-01,0,0,3,0,2021-05-01,1619827200.0
17022,5,0,2021-05-02,0,0,3,0,2021-05-02,1619913600.0
17023,5,0,2021-05-03,0,0,3,0,2021-05-03,1620000000.0
17024,5,0,2021-05-04,0,0,3,0,2021-05-04,1620086400.0
17025,5,0,2021-05-05,0,0,3,0,2021-05-05,1620172800.0
17026,5,0,2021-05-06,0,0,3,0,2021-05-06,1620259200.0
17027,5,0,2021-05-07,0,0,3,0,2021-05-07,1620345600.0
17028,5,0,2021-05-08,0,0,3,0,2021-05-08,1620432000.0
17029,5,0,2021-05-09,0,0,3,0,2021-05-09,1620518400.0
17030,5,0,2021-05-10,0,0,3,0,2021-05-10,1620604800.0
17031,5,0,2021-05-11,0,0,3,0,2021-05-11,1620691200.0
17032,5,0,2021-05-12,0,0,3,0,2021-05-12,1620777600.0
17033,5,0,2021-05-13,0,0,3,0,2021-05-13,1620864000.0
17034,5,0,2021-05-14,0,0,3,0,2021-05-14,1620950400.0
17035,5,0,2021-05-15,0,0,3,0,2021-05-15,1621036800.0
17036,5,0,2021-05-16,0,0,3,0,2021-05-16,1621123200.0
17037,5,0,2021-05-17,0,0,3,0,2021-05-17,1621206000.0
17038,5,0,2021-05-18,0,0,3,0,2021-05-18,1621292400.0
17039,5,0,2021-05-19,0,0,3,0,2021-05-19,1621378800.0
17040,5,0,2021-05-20,0,0,3,0,2021-05-20,1621465200.0
17041,5,0,2021-05-21,0,0,3,0,2021-05-21,1621551600.0
17042,5,0,2021-05-22,0,0,3,0,2021-05-22,1621638000.0
17043,5,0,2021-05-23,0,0,3,0,2021-05-23,1621724400.0
17044,5,0,2021-05-24,0,0,3,0,2021-05-24,1621810800.0
17045,5,0,2021-05-25,0,0,3,0,2021-05-25,1621897200.0
17046,5,0,2021-05-26,0,0,3,0,2021-05-26,1621983600.0
17047,5,0,2021-05-27,0,0,3,0,2021-05-27,1622070000.0
17048,5,0,2021-05-28,0,0,3,0,2021-05-28,1622156400.0
17049,5,0,2021-05-29,0,2,3,2,2021-05-29,1622242800.0
17050,5,0,2021-05-30,0,0,3,2,2021-05-30,1622329200.0
17051,5,0,2021-05-31,0,0,3,2,2021-05-31,1622415600.0
17052,5,0,2021-06-01,0,0,3,2,2021-06-01,1622502000.0
17053,5,0,2021-06-02,0,0,3,2,2021-06-02,1622588400.0
17054,5,0,2021-06-03,0,0,3,2,2021-06-03,1622674800.0
17055,5,0,2021-06-04,0,0,3,2,2021-06-04,1622761200.0
17056,5,0,2021-06-05,0,0,3,2,2021-06-05,1622847600.0
17057,5,0,2021-06-06,0,0,3,2,2021-06-06,1622934000.0
17058,5,0,2021-06-07,0,0,3,2,2021-06-07,1623020400.0
17059,5,0,2021-06-08,0,0,3,2,2021-06-08,1623106800.0
17060,5,0,2021-06-09,0,0,3,2,2021-06-09,1623193200.0
17061,5,0,2021-06-10,0,0,3,2,2021-06-10,1623279600.0
17062,5,0,2021-06-11,0,0,3,2,2021-06-11,1623366000.0
17063,5,0,2021-06-12,0,0,3,2,2021-06-12,1623452400.0
17064,5,0,2021-06-13,0,0,3,2,2021-06-13,1623538800.0
17065,5,0,2021-06-14,0,0,3,2,2021-06-14,1623625200.0
17066,5,0,2021-06-15,0,0,3,2,2021-06-15,1623711600.0
17067,5,0,2021-06-16,0,0,3,2,2021-06-16,1623798000.0
17068,5,0,2021-06-17,0,0,3,2,2021-06-17,1623884400.0
17069,5,0,2021-06-18,0,0,3,2,2021-06-18,1623970800.0
17070,5,0,2021-06-19,0,0,3,2,2021-06-19,1624057200.0
17071,5,0,2021-06-20,0,0,3,2,2021-06-20,1624143600.0
17072,5,0,2021-06-21,0,0,3,2,2021-06-21,1624230000.0
17073,5,0,2021-06-22,0,0,3,2,2021-06-22,1624316400.0
17074,5,0,2021-06-23,0,0,3,2,2021-06-23,1624402800.0
17075,5,0,2021-06-24,0,0,3,2,2021-06-24,1624489200.0
17076,5,0,2021-06-25,0,0,3,2,2021-06-25,1624575600.0
17077,5,0,2021-06-26,0,0,3,2,2021-06-26,1624662000.0
17078,5,0,2021-06-27,0,0,3,2,2021-06-27,1624748400.0
17079,5,0,2021-06-28,0,0,3,2,2021-06-28,1624834800.0
17080,5,0,2021-06-29,0,0,3,2,2021-06-29,1624921200.0
17081,5,0,2021-06-30,0,0,3,2,2021-06-30,1625007600.0
17082,5,0,2021-07-01,0,0,3,2,2021-07-01,1625094000.0
17083,5,0,2021-07-02,0,0,3,2,2021-07-02,1625180400.0
17084,5,0,2021-07-03,0,0,3,2,2021-07-03,1625266800.0
17085,5,0,2021-07-04,0,0,3,2,2021-07-04,1625353200.0
17086,5,0,2021-07-05,0,0,3,2,2021-07-05,1625439600.0
17087,5,0,2021-07-06,0,0,3,2,2021-07-06,1625526000.0
17088,6,0,2020-12-27,0,0,0,0,2020-12-27,1609023600.0
17089,6,0,2020-12-28,0,0,0,0,2020-12-28,1609110000.0
17090,6,0,2020-12-29,0,0,0,0,2020-12-29,1609196400.0
17091,6,0,2020-12-30,0,0,0,0,2020-12-30,1609282800.0
17092,6,0,2020-12-31,0,0,0,0,2020-12-31,1609369200.0
17093,6,0,2021-01-01,0,0,0,0,2021-01-01,1609455600.0
17094,6,0,2021-01-02,0,0,0,0,2021-01-02,1609542000.0
17095,6,0,2021-01-03,0,0,0,0,2021-01-03,1609628400.0
17096,6,0,2021-01-04,0,0,0,0,2021-01-04,1609714800.0
17097,6,0,2021-01-05,0,0,0,0,2021-01-05,1609801200.0
17098,6,0,2021-01-06,0,0,0,0,2021-01-06,1609887600.0
17099,6,0,2021-01-07,0,0,0,0,2021-01-07,1609974000.0
17100,6,0,2021-01-08,0,0,0,0,2021-01-08,1610060400.0
17101,6,0,2021-01-09,0,0,0,0,2021-01-09,1610146800.0
17102,6,0,2021-01-10,0,0,0,0,2021-01-10,1610233200.0
17103,6,0,2021-01-11,9,0,9,0,2021-01-11,1610319600.0
17104,6,0,2021-01-12,0,0,9,0,2021-01-12,1610406000.0
17105,6,0,2021-01-13,0,0,9,0,2021-01-13,1610492400.0
17106,6,0,2021-01-14,0,0,9,0,2021-01-14,1610578800.0
17107,6,0,2021-01-15,1,0,10,0,2021-01-15,1610665200.0
17108,6,0,2021-01-16,1,0,11,0,2021-01-16,1610751600.0
17109,6,0,2021-01-17,0,0,11,0,2021-01-17,1610838000.0
17110,6,0,2021-01-18,1,0,12,0,2021-01-18,1610924400.0
17111,6,0,2021-01-19,0,0,12,0,2021-01-19,1611010800.0
17112,6,0,2021-01-20,0,0,12,0,2021-01-20,1611097200.0
17113,6,0,2021-01-21,0,0,12,0,2021-01-21,1611183600.0
17114,6,0,2021-01-22,0,0,12,0,2021-01-22,1611270000.0
17115,6,0,2021-01-23,1,0,13,0,2021-01-23,1611356400.0
17116,6,0,2021-01-24,0,0,13,0,2021-01-24,1611442800.0
17117,6,0,2021-01-25,141,0,154,0,2021-01-25,1611529200.0
17118,6,0,2021-01-26,165,0,319,0,2021-01-26,1611615600.0
17119,6,0,2021-01-27,250,0,569,0,2021-01-27,1611702000.0
17120,6,0,2021-01-28,102,5,671,5,2021-01-28,1611788400.0
17121,6,0,2021-01-29,231,1,902,6,2021-01-29,1611874800.0
17122,6,0,2021-01-30,285,2,1187,8,2021-01-30,1611961200.0
17123,6,0,2021-01-31,1,0,1188,8,2021-01-31,1612047600.0
17124,6,0,2021-02-01,160,0,1348,8,2021-02-01,1612134000.0
17125,6,0,2021-02-02,330,0,1678,8,2021-02-02,1612220400.0
17126,6,0,2021-02-03,228,0,1906,8,2021-02-03,1612306800.0
17127,6,0,2021-02-04,215,3,2121,11,2021-02-04,1612393200.0
17128,6,0,2021-02-05,214,0,2335,11,2021-02-05,1612479600.0
17129,6,0,2021-02-06,83,10,2418,21,2021-02-06,1612566000.0
17130,6,0,2021-02-07,0,0,2418,21,2021-02-07,1612652400.0
17131,6,0,2021-02-08,82,2,2500,23,2021-02-08,1612738800.0
17132,6,0,2021-02-09,194,0,2694,23,2021-02-09,1612825200.0
17133,6,0,2021-02-10,187,1,2881,24,2021-02-10,1612911600.0
17134,6,0,2021-02-11,236,0,3117,24,2021-02-11,1612998000.0
17135,6,0,2021-02-12,287,1,3404,25,2021-02-12,1613084400.0
17136,6,0,2021-02-13,56,0,3460,25,2021-02-13,1613170800.0
17137,6,0,2021-02-14,1,0,3461,25,2021-02-14,1613257200.0
17138,6,0,2021-02-15,359,1,3820,26,2021-02-15,1613343600.0
17139,6,0,2021-02-16,266,3,4086,29,2021-02-16,1613430000.0
17140,6,0,2021-02-17,167,0,4253,29,2021-02-17,1613516400.0
17141,6,0,2021-02-18,217,1,4470,30,2021-02-18,1613602800.0
17142,6,0,2021-02-19,235,14,4705,44,2021-02-19,1613689200.0
17143,6,0,2021-02-20,139,4,4844,48,2021-02-20,1613775600.0
17144,6,0,2021-02-21,0,0,4844,48,2021-02-21,1613862000.0
17145,6,0,2021-02-22,130,118,4974,166,2021-02-22,1613948400.0
17146,6,0,2021-02-23,185,149,5159,315,2021-02-23,1614034800.0
17147,6,0,2021-02-24,176,140,5335,455,2021-02-24,1614121200.0
17148,6,0,2021-02-25,227,280,5562,735,2021-02-25,1614207600.0
17149,6,0,2021-02-26,242,257,5804,992,2021-02-26,1614294000.0
17150,6,0,2021-02-27,0,0,5804,992,2021-02-27,1614380400.0
17151,6,0,2021-02-28,0,0,5804,992,2021-02-28,1614466800.0
17152,6,0,2021-03-01,145,258,5949,1250,2021-03-01,1614553200.0
17153,6,0,2021-03-02,228,255,6177,1505,2021-03-02,1614639600.0
17154,6,0,2021-03-03,202,183,6379,1688,2021-03-03,1614726000.0
17155,6,0,2021-03-04,205,136,6584,1824,2021-03-04,1614812400.0
17156,6,0,2021-03-05,224,109,6808,1933,2021-03-05,1614898800.0
17157,6,0,2021-03-06,1,0,6809,1933,2021-03-06,1614985200.0
17158,6,0,2021-03-07,0,0,6809,1933,2021-03-07,1615071600.0
17159,6,0,2021-03-08,189,124,6998,2057,2021-03-08,1615158000.0
17160,6,0,2021-03-09,390,139,7388,2196,2021-03-09,1615244400.0
17161,6,0,2021-03-10,180,175,7568,2371,2021-03-10,1615330800.0
17162,6,0,2021-03-11,167,204,7735,2575,2021-03-11,1615417200.0
17163,6,0,2021-03-12,238,287,7973,2862,2021-03-12,1615503600.0
17164,6,0,2021-03-13,2,0,7975,2862,2021-03-13,1615590000.0
17165,6,0,2021-03-14,0,0,7975,2862,2021-03-14,1615676400.0
17166,6,0,2021-03-15,157,287,8132,3149,2021-03-15,1615762800.0
17167,6,0,2021-03-16,236,207,8368,3356,2021-03-16,1615849200.0
17168,6,0,2021-03-17,264,130,8632,3486,2021-03-17,1615935600.0
17169,6,0,2021-03-18,172,216,8804,3702,2021-03-18,1616022000.0
17170,6,0,2021-03-19,172,278,8976,3980,2021-03-19,1616108400.0
17171,6,0,2021-03-20,0,0,8976,3980,2021-03-20,1616194800.0
17172,6,0,2021-03-21,0,0,8976,3980,2021-03-21,1616281200.0
17173,6,0,2021-03-22,97,125,9073,4105,2021-03-22,1616367600.0
17174,6,0,2021-03-23,136,234,9209,4339,2021-03-23,1616454000.0
17175,6,0,2021-03-24,160,125,9369,4464,2021-03-24,1616540400.0
17176,6,0,2021-03-25,186,192,9555,4656,2021-03-25,1616626800.0
17177,6,0,2021-03-26,160,204,9715,4860,2021-03-26,1616713200.0
17178,6,0,2021-03-27,18,0,9733,4860,2021-03-27,1616799600.0
17179,6,0,2021-03-28,0,0,9733,4860,2021-03-28,1616886000.0
17180,6,0,2021-03-29,0,2,9733,4862,2021-03-29,1616972400.0
17181,6,0,2021-03-30,272,301,10005,5163,2021-03-30,1617058800.0
17182,6,0,2021-03-31,225,112,10230,5275,2021-03-31,1617145200.0
17183,6,0,2021-04-01,243,86,10473,5361,2021-04-01,1617231600.0
17184,6,0,2021-04-02,286,232,10759,5593,2021-04-02,1617318000.0
17185,6,0,2021-04-03,906,243,11665,5836,2021-04-03,1617404400.0
17186,6,0,2021-04-04,1,0,11666,5836,2021-04-04,1617490800.0
17187,6,0,2021-04-05,1,0,11667,5836,2021-04-05,1617577200.0
17188,6,0,2021-04-06,160,261,11827,6097,2021-04-06,1617663600.0
17189,6,0,2021-04-07,237,241,12064,6338,2021-04-07,1617750000.0
17190,6,0,2021-04-08,286,116,12350,6454,2021-04-08,1617836400.0
17191,6,0,2021-04-09,248,147,12598,6601,2021-04-09,1617922800.0
17192,6,0,2021-04-10,181,87,12779,6688,2021-04-10,1618009200.0
17193,6,0,2021-04-11,7,0,12786,6688,2021-04-11,1618095600.0
17194,6,0,2021-04-12,0,19,12786,6707,2021-04-12,1618185600.0
17195,6,0,2021-04-13,393,318,13179,7025,2021-04-13,1618272000.0
17196,6,0,2021-04-14,239,186,13418,7211,2021-04-14,1618358400.0
17197,6,0,2021-04-15,207,91,13625,7302,2021-04-15,1618444800.0
17198,6,0,2021-04-16,214,103,13839,7405,2021-04-16,1618531200.0
17199,6,0,2021-04-17,226,107,14065,7512,2021-04-17,1618617600.0
17200,6,0,2021-04-18,1,0,14066,7512,2021-04-18,1618704000.0
17201,6,0,2021-04-19,7,1,14073,7513,2021-04-19,1618790400.0
17202,6,0,2021-04-20,368,192,14441,7705,2021-04-20,1618876800.0
17203,6,0,2021-04-21,412,109,14853,7814,2021-04-21,1618963200.0
17204,6,0,2021-04-22,410,110,15263,7924,2021-04-22,1619049600.0
17205,6,0,2021-04-23,367,120,15630,8044,2021-04-23,1619136000.0
17206,6,0,2021-04-24,413,88,16043,8132,2021-04-24,1619222400.0
17207,6,0,2021-04-25,2,0,16045,8132,2021-04-25,1619308800.0
17208,6,0,2021-04-26,54,0,16099,8132,2021-04-26,1619395200.0
17209,6,0,2021-04-27,351,255,16450,8387,2021-04-27,1619481600.0
17210,6,0,2021-04-28,355,472,16805,8859,2021-04-28,1619568000.0
17211,6,0,2021-04-29,558,293,17363,9152,2021-04-29,1619654400.0
17212,6,0,2021-04-30,403,195,17766,9347,2021-04-30,1619740800.0
17213,6,0,2021-05-01,670,209,18436,9556,2021-05-01,1619827200.0
17214,6,0,2021-05-02,0,0,18436,9556,2021-05-02,1619913600.0
17215,6,0,2021-05-03,139,0,18575,9556,2021-05-03,1620000000.0
17216,6,0,2021-05-04,353,380,18928,9936,2021-05-04,1620086400.0
17217,6,0,2021-05-05,447,255,19375,10191,2021-05-05,1620172800.0
17218,6,0,2021-05-06,320,156,19695,10347,2021-05-06,1620259200.0
17219,6,0,2021-05-07,341,90,20036,10437,2021-05-07,1620345600.0
17220,6,0,2021-05-08,300,115,20336,10552,2021-05-08,1620432000.0
17221,6,0,2021-05-09,0,0,20336,10552,2021-05-09,1620518400.0
17222,6,0,2021-05-10,8,9,20344,10561,2021-05-10,1620604800.0
17223,6,0,2021-05-11,359,429,20703,10990,2021-05-11,1620691200.0
17224,6,0,2021-05-12,332,252,21035,11242,2021-05-12,1620777600.0
17225,6,0,2021-05-13,127,71,21162,11313,2021-05-13,1620864000.0
17226,6,0,2021-05-14,0,0,21162,11313,2021-05-14,1620950400.0
17227,6,0,2021-05-15,484,192,21646,11505,2021-05-15,1621036800.0
17228,6,0,2021-05-16,0,0,21646,11505,2021-05-16,1621123200.0
17229,6,0,2021-05-17,122,29,21768,11534,2021-05-17,1621206000.0
17230,6,0,2021-05-18,515,354,22283,11888,2021-05-18,1621292400.0
17231,6,0,2021-05-19,650,565,22933,12453,2021-05-19,1621378800.0
17232,6,0,2021-05-20,1055,350,23988,12803,2021-05-20,1621465200.0
17233,6,0,2021-05-21,1046,195,25034,12998,2021-05-21,1621551600.0
17234,6,0,2021-05-22,1241,173,26275,13171,2021-05-22,1621638000.0
17235,6,0,2021-05-23,0,0,26275,13171,2021-05-23,1621724400.0
17236,6,0,2021-05-24,1,0,26276,13171,2021-05-24,1621810800.0
17237,6,0,2021-05-25,883,522,27159,13693,2021-05-25,1621897200.0
17238,6,0,2021-05-26,1035,716,28194,14409,2021-05-26,1621983600.0
17239,6,0,2021-05-27,1310,351,29504,14760,2021-05-27,1622070000.0
17240,6,0,2021-05-28,952,231,30456,14991,2021-05-28,1622156400.0
17241,6,0,2021-05-29,1130,227,31586,15218,2021-05-29,1622242800.0
17242,6,0,2021-05-30,0,1,31586,15219,2021-05-30,1622329200.0
17243,6,0,2021-05-31,104,3,31690,15222,2021-05-31,1622415600.0
17244,6,0,2021-06-01,1147,487,32837,15709,2021-06-01,1622502000.0
17245,6,0,2021-06-02,1198,295,34035,16004,2021-06-02,1622588400.0
17246,6,0,2021-06-03,804,195,34839,16199,2021-06-03,1622674800.0
17247,6,0,2021-06-04,993,180,35832,16379,2021-06-04,1622761200.0
17248,6,0,2021-06-05,673,210,36505,16589,2021-06-05,1622847600.0
17249,6,0,2021-06-06,1,0,36506,16589,2021-06-06,1622934000.0
17250,6,0,2021-06-07,84,5,36590,16594,2021-06-07,1623020400.0
17251,6,0,2021-06-08,928,320,37518,16914,2021-06-08,1623106800.0
17252,6,0,2021-06-09,958,421,38476,17335,2021-06-09,1623193200.0
17253,6,0,2021-06-10,664,139,39140,17474,2021-06-10,1623279600.0
17254,6,0,2021-06-11,831,252,39971,17726,2021-06-11,1623366000.0
17255,6,0,2021-06-12,565,214,40536,17940,2021-06-12,1623452400.0
17256,6,0,2021-06-13,0,0,40536,17940,2021-06-13,1623538800.0
17257,6,0,2021-06-14,178,84,40714,18024,2021-06-14,1623625200.0
17258,6,0,2021-06-15,399,764,41113,18788,2021-06-15,1623711600.0
17259,6,0,2021-06-16,880,1306,41993,20094,2021-06-16,1623798000.0
17260,6,0,2021-06-17,757,578,42750,20672,2021-06-17,1623884400.0
17261,6,0,2021-06-18,686,524,43436,21196,2021-06-18,1623970800.0
17262,6,0,2021-06-19,527,591,43963,21787,2021-06-19,1624057200.0
17263,6,0,2021-06-20,0,0,43963,21787,2021-06-20,1624143600.0
17264,6,0,2021-06-21,124,115,44087,21902,2021-06-21,1624230000.0
17265,6,0,2021-06-22,424,1084,44511,22986,2021-06-22,1624316400.0
17266,6,0,2021-06-23,647,1103,45158,24089,2021-06-23,1624402800.0
17267,6,0,2021-06-24,456,494,45614,24583,2021-06-24,1624489200.0
17268,6,0,2021-06-25,523,413,46137,24996,2021-06-25,1624575600.0
17269,6,0,2021-06-26,382,641,46519,25637,2021-06-26,1624662000.0
17270,6,0,2021-06-27,0,0,46519,25637,2021-06-27,1624748400.0
17271,6,0,2021-06-28,99,175,46618,25812,2021-06-28,1624834800.0
17272,6,0,2021-06-29,610,919,47228,26731,2021-06-29,1624921200.0
17273,6,0,2021-06-30,630,879,47858,27610,2021-06-30,1625007600.0
17274,6,0,2021-07-01,541,493,48399,28103,2021-07-01,1625094000.0
17275,6,0,2021-07-02,430,381,48829,28484,2021-07-02,1625180400.0
17276,6,0,2021-07-03,434,371,49263,28855,2021-07-03,1625266800.0
17277,6,0,2021-07-04,0,0,49263,28855,2021-07-04,1625353200.0
17278,6,0,2021-07-05,64,208,49327,29063,2021-07-05,1625439600.0
17279,6,0,2021-07-06,493,796,49820,29859,2021-07-06,1625526000.0
17280,7,0,2020-12-27,0,0,0,0,2020-12-27,1609023600.0
17281,7,0,2020-12-28,0,0,0,0,2020-12-28,1609110000.0
17282,7,0,2020-12-29,0,0,0,0,2020-12-29,1609196400.0
17283,7,0,2020-12-30,0,0,0,0,2020-12-30,1609282800.0
17284,7,0,2020-12-31,0,0,0,0,2020-12-31,1609369200.0
17285,7,0,2021-01-01,0,0,0,0,2021-01-01,1609455600.0
17286,7,0,2021-01-02,0,0,0,0,2021-01-02,1609542000.0
17287,7,0,2021-01-03,0,0,0,0,2021-01-03,1609628400.0
17288,7,0,2021-01-04,0,0,0,0,2021-01-04,1609714800.0
17289,7,0,2021-01-05,0,0,0,0,2021-01-05,1609801200.0
17290,7,0,2021-01-06,0,0,0,0,2021-01-06,1609887600.0
17291,7,0,2021-01-07,0,0,0,0,2021-01-07,1609974000.0
17292,7,0,2021-01-08,0,0,0,0,2021-01-08,1610060400.0
17293,7,0,2021-01-09,0,0,0,0,2021-01-09,1610146800.0
17294,7,0,2021-01-10,0,0,0,0,2021-01-10,1610233200.0
17295,7,0,2021-01-11,0,0,0,0,2021-01-11,1610319600.0
17296,7,0,2021-01-12,0,0,0,0,2021-01-12,1610406000.0
17297,7,0,2021-01-13,0,0,0,0,2021-01-13,1610492400.0
17298,7,0,2021-01-14,0,0,0,0,2021-01-14,1610578800.0
17299,7,0,2021-01-15,0,0,0,0,2021-01-15,1610665200.0
17300,7,0,2021-01-16,0,0,0,0,2021-01-16,1610751600.0
17301,7,0,2021-01-17,0,0,0,0,2021-01-17,1610838000.0
17302,7,0,2021-01-18,1,0,1,0,2021-01-18,1610924400.0
17303,7,0,2021-01-19,0,0,1,0,2021-01-19,1611010800.0
17304,7,0,2021-01-20,0,0,1,0,2021-01-20,1611097200.0
17305,7,0,2021-01-21,12,0,13,0,2021-01-21,1611183600.0
17306,7,0,2021-01-22,12,0,25,0,2021-01-22,1611270000.0
17307,7,0,2021-01-23,0,0,25,0,2021-01-23,1611356400.0
17308,7,0,2021-01-24,0,0,25,0,2021-01-24,1611442800.0
17309,7,0,2021-01-25,0,0,25,0,2021-01-25,1611529200.0
17310,7,0,2021-01-26,0,0,25,0,2021-01-26,1611615600.0
17311,7,0,2021-01-27,12,0,37,0,2021-01-27,1611702000.0
17312,7,0,2021-01-28,1,0,38,0,2021-01-28,1611788400.0
17313,7,0,2021-01-29,6,0,44,0,2021-01-29,1611874800.0
17314,7,0,2021-01-30,0,0,44,0,2021-01-30,1611961200.0
17315,7,0,2021-01-31,0,0,44,0,2021-01-31,1612047600.0
17316,7,0,2021-02-01,0,0,44,0,2021-02-01,1612134000.0
17317,7,0,2021-02-02,0,0,44,0,2021-02-02,1612220400.0
17318,7,0,2021-02-03,11,0,55,0,2021-02-03,1612306800.0
17319,7,0,2021-02-04,12,0,67,0,2021-02-04,1612393200.0
17320,7,0,2021-02-05,11,0,78,0,2021-02-05,1612479600.0
17321,7,0,2021-02-06,0,0,78,0,2021-02-06,1612566000.0
17322,7,0,2021-02-07,0,0,78,0,2021-02-07,1612652400.0
17323,7,0,2021-02-08,0,0,78,0,2021-02-08,1612738800.0
17324,7,0,2021-02-09,13,0,91,0,2021-02-09,1612825200.0
17325,7,0,2021-02-10,0,0,91,0,2021-02-10,1612911600.0
17326,7,0,2021-02-11,17,0,108,0,2021-02-11,1612998000.0
17327,7,0,2021-02-12,45,0,153,0,2021-02-12,1613084400.0
17328,7,0,2021-02-13,0,0,153,0,2021-02-13,1613170800.0
17329,7,0,2021-02-14,0,0,153,0,2021-02-14,1613257200.0
17330,7,0,2021-02-15,0,0,153,0,2021-02-15,1613343600.0
17331,7,0,2021-02-16,0,0,153,0,2021-02-16,1613430000.0
17332,7,0,2021-02-17,0,0,153,0,2021-02-17,1613516400.0
17333,7,0,2021-02-18,18,0,171,0,2021-02-18,1613602800.0
17334,7,0,2021-02-19,34,0,205,0,2021-02-19,1613689200.0
17335,7,0,2021-02-20,0,0,205,0,2021-02-20,1613775600.0
17336,7,0,2021-02-21,0,0,205,0,2021-02-21,1613862000.0
17337,7,0,2021-02-22,0,0,205,0,2021-02-22,1613948400.0
17338,7,0,2021-02-23,0,22,205,22,2021-02-23,1614034800.0
17339,7,0,2021-02-24,0,0,205,22,2021-02-24,1614121200.0
17340,7,0,2021-02-25,15,10,220,32,2021-02-25,1614207600.0
17341,7,0,2021-02-26,33,19,253,51,2021-02-26,1614294000.0
17342,7,0,2021-02-27,0,0,253,51,2021-02-27,1614380400.0
17343,7,0,2021-02-28,0,0,253,51,2021-02-28,1614466800.0
17344,7,0,2021-03-01,0,0,253,51,2021-03-01,1614553200.0
17345,7,0,2021-03-02,17,11,270,62,2021-03-02,1614639600.0
17346,7,0,2021-03-03,0,0,270,62,2021-03-03,1614726000.0
17347,7,0,2021-03-04,16,11,286,73,2021-03-04,1614812400.0
17348,7,0,2021-03-05,33,19,319,92,2021-03-05,1614898800.0
17349,7,0,2021-03-06,0,0,319,92,2021-03-06,1614985200.0
17350,7,0,2021-03-07,0,0,319,92,2021-03-07,1615071600.0
17351,7,0,2021-03-08,0,0,319,92,2021-03-08,1615158000.0
17352,7,0,2021-03-09,1,0,320,92,2021-03-09,1615244400.0
17353,7,0,2021-03-10,0,0,320,92,2021-03-10,1615330800.0
17354,7,0,2021-03-11,20,30,340,122,2021-03-11,1615417200.0
17355,7,0,2021-03-12,62,42,402,164,2021-03-12,1615503600.0
17356,7,0,2021-03-13,0,0,402,164,2021-03-13,1615590000.0
17357,7,0,2021-03-14,0,0,402,164,2021-03-14,1615676400.0
17358,7,0,2021-03-15,0,0,402,164,2021-03-15,1615762800.0
17359,7,0,2021-03-16,30,9,432,173,2021-03-16,1615849200.0
17360,7,0,2021-03-17,0,0,432,173,2021-03-17,1615935600.0
17361,7,0,2021-03-18,29,16,461,189,2021-03-18,1616022000.0
17362,7,0,2021-03-19,56,31,517,220,2021-03-19,1616108400.0
17363,7,0,2021-03-20,0,0,517,220,2021-03-20,1616194800.0
17364,7,0,2021-03-21,0,0,517,220,2021-03-21,1616281200.0
17365,7,0,2021-03-22,0,0,517,220,2021-03-22,1616367600.0
17366,7,0,2021-03-23,0,0,517,220,2021-03-23,1616454000.0
17367,7,0,2021-03-24,0,0,517,220,2021-03-24,1616540400.0
17368,7,0,2021-03-25,65,13,582,233,2021-03-25,1616626800.0
17369,7,0,2021-03-26,73,24,655,257,2021-03-26,1616713200.0
17370,7,0,2021-03-27,0,0,655,257,2021-03-27,1616799600.0
17371,7,0,2021-03-28,0,0,655,257,2021-03-28,1616886000.0
17372,7,0,2021-03-29,0,0,655,257,2021-03-29,1616972400.0
17373,7,0,2021-03-30,40,17,695,274,2021-03-30,1617058800.0
17374,7,0,2021-03-31,26,14,721,288,2021-03-31,1617145200.0
17375,7,0,2021-04-01,25,30,746,318,2021-04-01,1617231600.0
17376,7,0,2021-04-02,0,0,746,318,2021-04-02,1617318000.0
17377,7,0,2021-04-03,0,0,746,318,2021-04-03,1617404400.0
17378,7,0,2021-04-04,0,0,746,318,2021-04-04,1617490800.0
17379,7,0,2021-04-05,9,0,755,318,2021-04-05,1617577200.0
17380,7,0,2021-04-06,0,0,755,318,2021-04-06,1617663600.0
17381,7,0,2021-04-07,0,0,755,318,2021-04-07,1617750000.0
17382,7,0,2021-04-08,57,46,812,364,2021-04-08,1617836400.0
17383,7,0,2021-04-09,59,31,871,395,2021-04-09,1617922800.0
17384,7,0,2021-04-10,0,0,871,395,2021-04-10,1618009200.0
17385,7,0,2021-04-11,0,0,871,395,2021-04-11,1618095600.0
17386,7,0,2021-04-12,0,0,871,395,2021-04-12,1618185600.0
17387,7,0,2021-04-13,0,0,871,395,2021-04-13,1618272000.0
17388,7,0,2021-04-14,5,6,876,401,2021-04-14,1618358400.0
17389,7,0,2021-04-15,56,67,932,468,2021-04-15,1618444800.0
17390,7,0,2021-04-16,90,33,1022,501,2021-04-16,1618531200.0
17391,7,0,2021-04-17,0,1,1022,502,2021-04-17,1618617600.0
17392,7,0,2021-04-18,0,0,1022,502,2021-04-18,1618704000.0
17393,7,0,2021-04-19,1,0,1023,502,2021-04-19,1618790400.0
17394,7,0,2021-04-20,335,53,1358,555,2021-04-20,1618876800.0
17395,7,0,2021-04-21,337,11,1695,566,2021-04-21,1618963200.0
17396,7,0,2021-04-22,284,27,1979,593,2021-04-22,1619049600.0
17397,7,0,2021-04-23,258,38,2237,631,2021-04-23,1619136000.0
17398,7,0,2021-04-24,231,1,2468,632,2021-04-24,1619222400.0
17399,7,0,2021-04-25,0,0,2468,632,2021-04-25,1619308800.0
17400,7,0,2021-04-26,283,9,2751,641,2021-04-26,1619395200.0
17401,7,0,2021-04-27,224,41,2975,682,2021-04-27,1619481600.0
17402,7,0,2021-04-28,192,9,3167,691,2021-04-28,1619568000.0
17403,7,0,2021-04-29,170,14,3337,705,2021-04-29,1619654400.0
17404,7,0,2021-04-30,172,12,3509,717,2021-04-30,1619740800.0
17405,7,0,2021-05-01,201,9,3710,726,2021-05-01,1619827200.0
17406,7,0,2021-05-02,0,0,3710,726,2021-05-02,1619913600.0
17407,7,0,2021-05-03,135,6,3845,732,2021-05-03,1620000000.0
17408,7,0,2021-05-04,161,36,4006,768,2021-05-04,1620086400.0
17409,7,0,2021-05-05,221,10,4227,778,2021-05-05,1620172800.0
17410,7,0,2021-05-06,175,25,4402,803,2021-05-06,1620259200.0
17411,7,0,2021-05-07,149,21,4551,824,2021-05-07,1620345600.0
17412,7,0,2021-05-08,1,0,4552,824,2021-05-08,1620432000.0
17413,7,0,2021-05-09,0,2,4552,826,2021-05-09,1620518400.0
17414,7,0,2021-05-10,0,0,4552,826,2021-05-10,1620604800.0
17415,7,0,2021-05-11,2,41,4554,867,2021-05-11,1620691200.0
17416,7,0,2021-05-12,6,36,4560,903,2021-05-12,1620777600.0
17417,7,0,2021-05-13,0,0,4560,903,2021-05-13,1620864000.0
17418,7,0,2021-05-14,28,97,4588,1000,2021-05-14,1620950400.0
17419,7,0,2021-05-15,0,0,4588,1000,2021-05-15,1621036800.0
17420,7,0,2021-05-16,1,0,4589,1000,2021-05-16,1621123200.0
17421,7,0,2021-05-17,1,13,4590,1013,2021-05-17,1621206000.0
17422,7,0,2021-05-18,17,28,4607,1041,2021-05-18,1621292400.0
17423,7,0,2021-05-19,0,1,4607,1042,2021-05-19,1621378800.0
17424,7,0,2021-05-20,0,8,4607,1050,2021-05-20,1621465200.0
17425,7,0,2021-05-21,12,30,4619,1080,2021-05-21,1621551600.0
17426,7,0,2021-05-22,0,0,4619,1080,2021-05-22,1621638000.0
17427,7,0,2021-05-23,0,0,4619,1080,2021-05-23,1621724400.0
17428,7,0,2021-05-24,0,0,4619,1080,2021-05-24,1621810800.0
17429,7,0,2021-05-25,50,327,4669,1407,2021-05-25,1621897200.0
17430,7,0,2021-05-26,54,349,4723,1756,2021-05-26,1621983600.0
17431,7,0,2021-05-27,34,316,4757,2072,2021-05-27,1622070000.0
17432,7,0,2021-05-28,27,251,4784,2323,2021-05-28,1622156400.0
17433,7,0,2021-05-29,35,371,4819,2694,2021-05-29,1622242800.0
17434,7,0,2021-05-30,0,0,4819,2694,2021-05-30,1622329200.0
17435,7,0,2021-05-31,45,213,4864,2907,2021-05-31,1622415600.0
17436,7,0,2021-06-01,47,223,4911,3130,2021-06-01,1622502000.0
17437,7,0,2021-06-02,69,262,4980,3392,2021-06-02,1622588400.0
17438,7,0,2021-06-03,41,243,5021,3635,2021-06-03,1622674800.0
17439,7,0,2021-06-04,74,262,5095,3897,2021-06-04,1622761200.0
17440,7,0,2021-06-05,1,0,5096,3897,2021-06-05,1622847600.0
17441,7,0,2021-06-06,0,0,5096,3897,2021-06-06,1622934000.0
17442,7,0,2021-06-07,1,1,5097,3898,2021-06-07,1623020400.0
17443,7,0,2021-06-08,3,2,5100,3900,2021-06-08,1623106800.0
17444,7,0,2021-06-09,0,3,5100,3903,2021-06-09,1623193200.0
17445,7,0,2021-06-10,8,1,5108,3904,2021-06-10,1623279600.0
17446,7,0,2021-06-11,3,6,5111,3910,2021-06-11,1623366000.0
17447,7,0,2021-06-12,16,56,5127,3966,2021-06-12,1623452400.0
17448,7,0,2021-06-13,0,0,5127,3966,2021-06-13,1623538800.0
17449,7,0,2021-06-14,0,0,5127,3966,2021-06-14,1623625200.0
17450,7,0,2021-06-15,0,1,5127,3967,2021-06-15,1623711600.0
17451,7,0,2021-06-16,0,0,5127,3967,2021-06-16,1623798000.0
17452,7,0,2021-06-17,2,6,5129,3973,2021-06-17,1623884400.0
17453,7,0,2021-06-18,0,2,5129,3975,2021-06-18,1623970800.0
17454,7,0,2021-06-19,25,47,5154,4022,2021-06-19,1624057200.0
17455,7,0,2021-06-20,0,0,5154,4022,2021-06-20,1624143600.0
17456,7,0,2021-06-21,0,2,5154,4024,2021-06-21,1624230000.0
17457,7,0,2021-06-22,8,0,5162,4024,2021-06-22,1624316400.0
17458,7,0,2021-06-23,15,2,5177,4026,2021-06-23,1624402800.0
17459,7,0,2021-06-24,10,5,5187,4031,2021-06-24,1624489200.0
17460,7,0,2021-06-25,0,0,5187,4031,2021-06-25,1624575600.0
17461,7,0,2021-06-26,28,39,5215,4070,2021-06-26,1624662000.0
17462,7,0,2021-06-27,0,0,5215,4070,2021-06-27,1624748400.0
17463,7,0,2021-06-28,0,1,5215,4071,2021-06-28,1624834800.0
17464,7,0,2021-06-29,0,0,5215,4071,2021-06-29,1624921200.0
17465,7,0,2021-06-30,0,0,5215,4071,2021-06-30,1625007600.0
17466,7,0,2021-07-01,26,22,5241,4093,2021-07-01,1625094000.0
17467,7,0,2021-07-02,26,22,5267,4115,2021-07-02,1625180400.0
17468,7,0,2021-07-03,27,206,5294,4321,2021-07-03,1625266800.0
17469,7,0,2021-07-04,0,0,5294,4321,2021-07-04,1625353200.0
17470,7,0,2021-07-05,4,8,5298,4329,2021-07-05,1625439600.0
17471,7,0,2021-07-06,0,0,5298,4329,2021-07-06,1625526000.0
17472,8,0,2020-12-27,0,0,0,0,2020-12-27,1609023600.0
17473,8,0,2020-12-28,0,0,0,0,2020-12-28,1609110000.0
17474,8,0,2020-12-29,0,0,0,0,2020-12-29,1609196400.0
17475,8,0,2020-12-30,0,0,0,0,2020-12-30,1609282800.0
17476,8,0,2020-12-31,0,0,0,0,2020-12-31,1609369200.0
17477,8,0,2021-01-01,0,0,0,0,2021-01-01,1609455600.0
17478,8,0,2021-01-02,0,0,0,0,2021-01-02,1609542000.0
17479,8,0,2021-01-03,0,0,0,0,2021-01-03,1609628400.0
17480,8,0,2021-01-04,0,0,0,0,2021-01-04,1609714800.0
17481,8,0,2021-01-05,0,0,0,0,2021-01-05,1609801200.0
17482,8,0,2021-01-06,0,0,0,0,2021-01-06,1609887600.0
17483,8,0,2021-01-07,0,0,0,0,2021-01-07,1609974000.0
17484,8,0,2021-01-08,0,0,0,0,2021-01-08,1610060400.0
17485,8,0,2021-01-09,0,0,0,0,2021-01-09,1610146800.0
17486,8,0,2021-01-10,0,0,0,0,2021-01-10,1610233200.0
17487,8,0,2021-01-11,0,0,0,0,2021-01-11,1610319600.0
17488,8,0,2021-01-12,0,0,0,0,2021-01-12,1610406000.0
17489,8,0,2021-01-13,10,0,10,0,2021-01-13,1610492400.0
17490,8,0,2021-01-14,12,0,22,0,2021-01-14,1610578800.0
17491,8,0,2021-01-15,8,0,30,0,2021-01-15,1610665200.0
17492,8,0,2021-01-16,0,0,30,0,2021-01-16,1610751600.0
17493,8,0,2021-01-17,0,0,30,0,2021-01-17,1610838000.0
17494,8,0,2021-01-18,0,0,30,0,2021-01-18,1610924400.0
17495,8,0,2021-01-19,12,0,42,0,2021-01-19,1611010800.0
17496,8,0,2021-01-20,12,0,54,0,2021-01-20,1611097200.0
17497,8,0,2021-01-21,6,0,60,0,2021-01-21,1611183600.0
17498,8,0,2021-01-22,0,0,60,0,2021-01-22,1611270000.0
17499,8,0,2021-01-23,0,0,60,0,2021-01-23,1611356400.0
17500,8,0,2021-01-24,0,0,60,0,2021-01-24,1611442800.0
17501,8,0,2021-01-25,0,0,60,0,2021-01-25,1611529200.0
17502,8,0,2021-01-26,9,0,69,0,2021-01-26,1611615600.0
17503,8,0,2021-01-27,10,0,79,0,2021-01-27,1611702000.0
17504,8,0,2021-01-28,6,0,85,0,2021-01-28,1611788400.0
17505,8,0,2021-01-29,0,0,85,0,2021-01-29,1611874800.0
17506,8,0,2021-01-30,0,0,85,0,2021-01-30,1611961200.0
17507,8,0,2021-01-31,0,0,85,0,2021-01-31,1612047600.0
17508,8,0,2021-02-01,0,0,85,0,2021-02-01,1612134000.0
17509,8,0,2021-02-02,38,0,123,0,2021-02-02,1612220400.0
17510,8,0,2021-02-03,10,0,133,0,2021-02-03,1612306800.0
17511,8,0,2021-02-04,29,1,162,1,2021-02-04,1612393200.0
17512,8,0,2021-02-05,6,0,168,1,2021-02-05,1612479600.0
17513,8,0,2021-02-06,0,0,168,1,2021-02-06,1612566000.0
17514,8,0,2021-02-07,0,0,168,1,2021-02-07,1612652400.0
17515,8,0,2021-02-08,0,0,168,1,2021-02-08,1612738800.0
17516,8,0,2021-02-09,38,0,206,1,2021-02-09,1612825200.0
17517,8,0,2021-02-10,27,0,233,1,2021-02-10,1612911600.0
17518,8,0,2021-02-11,0,0,233,1,2021-02-11,1612998000.0
17519,8,0,2021-02-12,36,0,269,1,2021-02-12,1613084400.0
17520,8,0,2021-02-13,0,0,269,1,2021-02-13,1613170800.0
17521,8,0,2021-02-14,0,0,269,1,2021-02-14,1613257200.0
17522,8,0,2021-02-15,50,0,319,1,2021-02-15,1613343600.0
17523,8,0,2021-02-16,0,0,319,1,2021-02-16,1613430000.0
17524,8,0,2021-02-17,0,0,319,1,2021-02-17,1613516400.0
17525,8,0,2021-02-18,27,0,346,1,2021-02-18,1613602800.0
17526,8,0,2021-02-19,44,0,390,1,2021-02-19,1613689200.0
17527,8,0,2021-02-20,0,0,390,1,2021-02-20,1613775600.0
17528,8,0,2021-02-21,0,0,390,1,2021-02-21,1613862000.0
17529,8,0,2021-02-22,45,2,435,3,2021-02-22,1613948400.0
17530,8,0,2021-02-23,41,29,476,32,2021-02-23,1614034800.0
17531,8,0,2021-02-24,35,1,511,33,2021-02-24,1614121200.0
17532,8,0,2021-02-25,55,35,566,68,2021-02-25,1614207600.0
17533,8,0,2021-02-26,39,2,605,70,2021-02-26,1614294000.0
17534,8,0,2021-02-27,0,0,605,70,2021-02-27,1614380400.0
17535,8,0,2021-02-28,0,0,605,70,2021-02-28,1614466800.0
17536,8,0,2021-03-01,48,5,653,75,2021-03-01,1614553200.0
17537,8,0,2021-03-02,7,27,660,102,2021-03-02,1614639600.0
17538,8,0,2021-03-03,38,27,698,129,2021-03-03,1614726000.0
17539,8,0,2021-03-04,30,26,728,155,2021-03-04,1614812400.0
17540,8,0,2021-03-05,46,9,774,164,2021-03-05,1614898800.0
17541,8,0,2021-03-06,0,0,774,164,2021-03-06,1614985200.0
17542,8,0,2021-03-07,0,0,774,164,2021-03-07,1615071600.0
17543,8,0,2021-03-08,30,7,804,171,2021-03-08,1615158000.0
17544,8,0,2021-03-09,19,27,823,198,2021-03-09,1615244400.0
17545,8,0,2021-03-10,32,27,855,225,2021-03-10,1615330800.0
17546,8,0,2021-03-11,2,0,857,225,2021-03-11,1615417200.0
17547,8,0,2021-03-12,52,21,909,246,2021-03-12,1615503600.0
17548,8,0,2021-03-13,11,0,920,246,2021-03-13,1615590000.0
17549,8,0,2021-03-14,0,0,920,246,2021-03-14,1615676400.0
17550,8,0,2021-03-15,31,42,951,288,2021-03-15,1615762800.0
17551,8,0,2021-03-16,73,3,1024,291,2021-03-16,1615849200.0
17552,8,0,2021-03-17,67,13,1091,304,2021-03-17,1615935600.0
17553,8,0,2021-03-18,82,39,1173,343,2021-03-18,1616022000.0
17554,8,0,2021-03-19,30,46,1203,389,2021-03-19,1616108400.0
17555,8,0,2021-03-20,0,0,1203,389,2021-03-20,1616194800.0
17556,8,0,2021-03-21,0,0,1203,389,2021-03-21,1616281200.0
17557,8,0,2021-03-22,34,45,1237,434,2021-03-22,1616367600.0
17558,8,0,2021-03-23,30,43,1267,477,2021-03-23,1616454000.0
17559,8,0,2021-03-24,38,42,1305,519,2021-03-24,1616540400.0
17560,8,0,2021-03-25,92,31,1397,550,2021-03-25,1616626800.0
17561,8,0,2021-03-26,45,32,1442,582,2021-03-26,1616713200.0
17562,8,0,2021-03-27,94,0,1536,582,2021-03-27,1616799600.0
17563,8,0,2021-03-28,0,0,1536,582,2021-03-28,1616886000.0
17564,8,0,2021-03-29,69,47,1605,629,2021-03-29,1616972400.0
17565,8,0,2021-03-30,98,19,1703,648,2021-03-30,1617058800.0
17566,8,0,2021-03-31,89,44,1792,692,2021-03-31,1617145200.0
17567,8,0,2021-04-01,56,45,1848,737,2021-04-01,1617231600.0
17568,8,0,2021-04-02,0,0,1848,737,2021-04-02,1617318000.0
17569,8,0,2021-04-03,0,0,1848,737,2021-04-03,1617404400.0
17570,8,0,2021-04-04,0,0,1848,737,2021-04-04,1617490800.0
17571,8,0,2021-04-05,0,0,1848,737,2021-04-05,1617577200.0
17572,8,0,2021-04-06,49,61,1897,798,2021-04-06,1617663600.0
17573,8,0,2021-04-07,91,28,1988,826,2021-04-07,1617750000.0
17574,8,0,2021-04-08,120,3,2108,829,2021-04-08,1617836400.0
17575,8,0,2021-04-09,89,27,2197,856,2021-04-09,1617922800.0
17576,8,0,2021-04-10,164,1,2361,857,2021-04-10,1618009200.0
17577,8,0,2021-04-11,0,0,2361,857,2021-04-11,1618095600.0
17578,8,0,2021-04-12,41,72,2402,929,2021-04-12,1618185600.0
17579,8,0,2021-04-13,48,71,2450,1000,2021-04-13,1618272000.0
17580,8,0,2021-04-14,81,43,2531,1043,2021-04-14,1618358400.0
17581,8,0,2021-04-15,92,20,2623,1063,2021-04-15,1618444800.0
17582,8,0,2021-04-16,77,38,2700,1101,2021-04-16,1618531200.0
17583,8,0,2021-04-17,165,0,2865,1101,2021-04-17,1618617600.0
17584,8,0,2021-04-18,0,0,2865,1101,2021-04-18,1618704000.0
17585,8,0,2021-04-19,52,64,2917,1165,2021-04-19,1618790400.0
17586,8,0,2021-04-20,83,27,3000,1192,2021-04-20,1618876800.0
17587,8,0,2021-04-21,91,24,3091,1216,2021-04-21,1618963200.0
17588,8,0,2021-04-22,101,18,3192,1234,2021-04-22,1619049600.0
17589,8,0,2021-04-23,44,65,3236,1299,2021-04-23,1619136000.0
17590,8,0,2021-04-24,99,72,3335,1371,2021-04-24,1619222400.0
17591,8,0,2021-04-25,0,0,3335,1371,2021-04-25,1619308800.0
17592,8,0,2021-04-26,28,88,3363,1459,2021-04-26,1619395200.0
17593,8,0,2021-04-27,59,61,3422,1520,2021-04-27,1619481600.0
17594,8,0,2021-04-28,90,34,3512,1554,2021-04-28,1619568000.0
17595,8,0,2021-04-29,89,30,3601,1584,2021-04-29,1619654400.0
17596,8,0,2021-04-30,104,9,3705,1593,2021-04-30,1619740800.0
17597,8,0,2021-05-01,0,8,3705,1601,2021-05-01,1619827200.0
17598,8,0,2021-05-02,0,0,3705,1601,2021-05-02,1619913600.0
17599,8,0,2021-05-03,24,96,3729,1697,2021-05-03,1620000000.0
17600,8,0,2021-05-04,157,97,3886,1794,2021-05-04,1620086400.0
17601,8,0,2021-05-05,141,50,4027,1844,2021-05-05,1620172800.0
17602,8,0,2021-05-06,199,30,4226,1874,2021-05-06,1620259200.0
17603,8,0,2021-05-07,127,64,4353,1938,2021-05-07,1620345600.0
17604,8,0,2021-05-08,69,120,4422,2058,2021-05-08,1620432000.0
17605,8,0,2021-05-09,0,0,4422,2058,2021-05-09,1620518400.0
17606,8,0,2021-05-10,124,92,4546,2150,2021-05-10,1620604800.0
17607,8,0,2021-05-11,132,73,4678,2223,2021-05-11,1620691200.0
17608,8,0,2021-05-12,156,58,4834,2281,2021-05-12,1620777600.0
17609,8,0,2021-05-13,83,0,4917,2281,2021-05-13,1620864000.0
17610,8,0,2021-05-14,129,49,5046,2330,2021-05-14,1620950400.0
17611,8,0,2021-05-15,86,2,5132,2332,2021-05-15,1621036800.0
17612,8,0,2021-05-16,0,0,5132,2332,2021-05-16,1621123200.0
17613,8,0,2021-05-17,146,100,5278,2432,2021-05-17,1621206000.0
17614,8,0,2021-05-18,151,83,5429,2515,2021-05-18,1621292400.0
17615,8,0,2021-05-19,84,68,5513,2583,2021-05-19,1621378800.0
17616,8,0,2021-05-20,104,19,5617,2602,2021-05-20,1621465200.0
17617,8,0,2021-05-21,98,38,5715,2640,2021-05-21,1621551600.0
17618,8,0,2021-05-22,100,2,5815,2642,2021-05-22,1621638000.0
17619,8,0,2021-05-23,0,0,5815,2642,2021-05-23,1621724400.0
17620,8,0,2021-05-24,33,0,5848,2642,2021-05-24,1621810800.0
17621,8,0,2021-05-25,119,66,5967,2708,2021-05-25,1621897200.0
17622,8,0,2021-05-26,108,33,6075,2741,2021-05-26,1621983600.0
17623,8,0,2021-05-27,111,35,6186,2776,2021-05-27,1622070000.0
17624,8,0,2021-05-28,33,1,6219,2777,2021-05-28,1622156400.0
17625,8,0,2021-05-29,59,211,6278,2988,2021-05-29,1622242800.0
17626,8,0,2021-05-30,0,0,6278,2988,2021-05-30,1622329200.0
17627,8,0,2021-05-31,109,55,6387,3043,2021-05-31,1622415600.0
17628,8,0,2021-06-01,112,50,6499,3093,2021-06-01,1622502000.0
17629,8,0,2021-06-02,131,24,6630,3117,2021-06-02,1622588400.0
17630,8,0,2021-06-03,100,31,6730,3148,2021-06-03,1622674800.0
17631,8,0,2021-06-04,128,60,6858,3208,2021-06-04,1622761200.0
17632,8,0,2021-06-05,82,19,6940,3227,2021-06-05,1622847600.0
17633,8,0,2021-06-06,0,0,6940,3227,2021-06-06,1622934000.0
17634,8,0,2021-06-07,96,86,7036,3313,2021-06-07,1623020400.0
17635,8,0,2021-06-08,81,82,7117,3395,2021-06-08,1623106800.0
17636,8,0,2021-06-09,98,66,7215,3461,2021-06-09,1623193200.0
17637,8,0,2021-06-10,111,49,7326,3510,2021-06-10,1623279600.0
17638,8,0,2021-06-11,116,85,7442,3595,2021-06-11,1623366000.0
17639,8,0,2021-06-12,57,25,7499,3620,2021-06-12,1623452400.0
17640,8,0,2021-06-13,0,0,7499,3620,2021-06-13,1623538800.0
17641,8,0,2021-06-14,106,107,7605,3727,2021-06-14,1623625200.0
17642,8,0,2021-06-15,86,109,7691,3836,2021-06-15,1623711600.0
17643,8,0,2021-06-16,103,142,7794,3978,2021-06-16,1623798000.0
17644,8,0,2021-06-17,84,64,7878,4042,2021-06-17,1623884400.0
17645,8,0,2021-06-18,66,96,7944,4138,2021-06-18,1623970800.0
17646,8,0,2021-06-19,64,73,8008,4211,2021-06-19,1624057200.0
17647,8,0,2021-06-20,0,0,8008,4211,2021-06-20,1624143600.0
17648,8,0,2021-06-21,78,140,8086,4351,2021-06-21,1624230000.0
17649,8,0,2021-06-22,70,95,8156,4446,2021-06-22,1624316400.0
17650,8,0,2021-06-23,68,108,8224,4554,2021-06-23,1624402800.0
17651,8,0,2021-06-24,42,69,8266,4623,2021-06-24,1624489200.0
17652,8,0,2021-06-25,63,88,8329,4711,2021-06-25,1624575600.0
17653,8,0,2021-06-26,35,58,8364,4769,2021-06-26,1624662000.0
17654,8,0,2021-06-27,0,0,8364,4769,2021-06-27,1624748400.0
17655,8,0,2021-06-28,70,125,8434,4894,2021-06-28,1624834800.0
17656,8,0,2021-06-29,59,95,8493,4989,2021-06-29,1624921200.0
17657,8,0,2021-06-30,56,106,8549,5095,2021-06-30,1625007600.0
17658,8,0,2021-07-01,41,80,8590,5175,2021-07-01,1625094000.0
17659,8,0,2021-07-02,52,89,8642,5264,2021-07-02,1625180400.0
17660,8,0,2021-07-03,40,86,8682,5350,2021-07-03,1625266800.0
17661,8,0,2021-07-04,0,1,8682,5351,2021-07-04,1625353200.0
17662,8,0,2021-07-05,66,90,8748,5441,2021-07-05,1625439600.0
17663,8,0,2021-07-06,55,71,8803,5512,2021-07-06,1625526000.0
17664,11,0,2020-12-27,13,0,13,0,2020-12-27,1609023600.0
17665,11,0,2020-12-28,12,0,25,0,2020-12-28,1609110000.0
17666,11,0,2020-12-29,56,0,81,0,2020-12-29,1609196400.0
17667,11,0,2020-12-30,91,0,172,0,2020-12-30,1609282800.0
17668,11,0,2020-12-31,39,0,211,0,2020-12-31,1609369200.0
17669,11,0,2021-01-01,32,0,243,0,2021-01-01,1609455600.0
17670,11,0,2021-01-02,64,0,307,0,2021-01-02,1609542000.0
17671,11,0,2021-01-03,78,0,385,0,2021-01-03,1609628400.0
17672,11,0,2021-01-04,554,0,939,0,2021-01-04,1609714800.0
17673,11,0,2021-01-05,2075,0,3014,0,2021-01-05,1609801200.0
17674,11,0,2021-01-06,3022,0,6036,0,2021-01-06,1609887600.0
17675,11,0,2021-01-07,5393,0,11429,0,2021-01-07,1609974000.0
17676,11,0,2021-01-08,7136,0,18565,0,2021-01-08,1610060400.0
17677,11,0,2021-01-09,1895,0,20460,0,2021-01-09,1610146800.0
17678,11,0,2021-01-10,1756,0,22216,0,2021-01-10,1610233200.0
17679,11,0,2021-01-11,8021,0,30237,0,2021-01-11,1610319600.0
17680,11,0,2021-01-12,10381,0,40618,0,2021-01-12,1610406000.0
17681,11,0,2021-01-13,10027,0,50645,0,2021-01-13,1610492400.0
17682,11,0,2021-01-14,10160,0,60805,0,2021-01-14,1610578800.0
17683,11,0,2021-01-15,8929,0,69734,0,2021-01-15,1610665200.0
17684,11,0,2021-01-16,2417,9,72151,9,2021-01-16,1610751600.0
17685,11,0,2021-01-17,1092,6,73243,15,2021-01-17,1610838000.0
17686,11,0,2021-01-18,12268,22,85511,37,2021-01-18,1610924400.0
17687,11,0,2021-01-19,15867,22,101378,59,2021-01-19,1611010800.0
17688,11,0,2021-01-20,18389,26,119767,85,2021-01-20,1611097200.0
17689,11,0,2021-01-21,22320,25,142087,110,2021-01-21,1611183600.0
17690,11,0,2021-01-22,17115,54,159202,164,2021-01-22,1611270000.0
17691,11,0,2021-01-23,4962,7,164164,171,2021-01-23,1611356400.0
17692,11,0,2021-01-24,1284,0,165448,171,2021-01-24,1611442800.0
17693,11,0,2021-01-25,8875,153,174323,324,2021-01-25,1611529200.0
17694,11,0,2021-01-26,12347,333,186670,657,2021-01-26,1611615600.0
17695,11,0,2021-01-27,16232,641,202902,1298,2021-01-27,1611702000.0
17696,11,0,2021-01-28,20312,1112,223214,2410,2021-01-28,1611788400.0
17697,11,0,2021-01-29,15404,1298,238618,3708,2021-01-29,1611874800.0
17698,11,0,2021-01-30,4468,82,243086,3790,2021-01-30,1611961200.0
17699,11,0,2021-01-31,586,19,243672,3809,2021-01-31,1612047600.0
17700,11,0,2021-02-01,7390,1937,251062,5746,2021-02-01,1612134000.0
17701,11,0,2021-02-02,8359,2793,259421,8539,2021-02-02,1612220400.0
17702,11,0,2021-02-03,8128,3778,267549,12317,2021-02-03,1612306800.0
17703,11,0,2021-02-04,8785,4567,276334,16884,2021-02-04,1612393200.0
17704,11,0,2021-02-05,8953,4406,285287,21290,2021-02-05,1612479600.0
17705,11,0,2021-02-06,3271,744,288558,22034,2021-02-06,1612566000.0
17706,11,0,2021-02-07,588,535,289146,22569,2021-02-07,1612652400.0
17707,11,0,2021-02-08,6230,5857,295376,28426,2021-02-08,1612738800.0
17708,11,0,2021-02-09,8440,9563,303816,37989,2021-02-09,1612825200.0
17709,11,0,2021-02-10,9968,11020,313784,49009,2021-02-10,1612911600.0
17710,11,0,2021-02-11,12386,16168,326170,65177,2021-02-11,1612998000.0
17711,11,0,2021-02-12,11877,10268,338047,75445,2021-02-12,1613084400.0
17712,11,0,2021-02-13,2596,2555,340643,78000,2021-02-13,1613170800.0
17713,11,0,2021-02-14,315,554,340958,78554,2021-02-14,1613257200.0
17714,11,0,2021-02-15,4458,11863,345416,90417,2021-02-15,1613343600.0
17715,11,0,2021-02-16,5682,18266,351098,108683,2021-02-16,1613430000.0
17716,11,0,2021-02-17,5692,15412,356790,124095,2021-02-17,1613516400.0
17717,11,0,2021-02-18,8649,20464,365439,144559,2021-02-18,1613602800.0
17718,11,0,2021-02-19,9046,15139,374485,159698,2021-02-19,1613689200.0
17719,11,0,2021-02-20,1691,4806,376176,164504,2021-02-20,1613775600.0
17720,11,0,2021-02-21,398,817,376574,165321,2021-02-21,1613862000.0
17721,11,0,2021-02-22,4229,9814,380803,175135,2021-02-22,1613948400.0
17722,11,0,2021-02-23,4952,10377,385755,185512,2021-02-23,1614034800.0
17723,11,0,2021-02-24,5421,9750,391176,195262,2021-02-24,1614121200.0
17724,11,0,2021-02-25,8624,13817,399800,209079,2021-02-25,1614207600.0
17725,11,0,2021-02-26,11198,9877,410998,218956,2021-02-26,1614294000.0
17726,11,0,2021-02-27,5068,3197,416066,222153,2021-02-27,1614380400.0
17727,11,0,2021-02-28,743,626,416809,222779,2021-02-28,1614466800.0
17728,11,0,2021-03-01,8859,7678,425668,230457,2021-03-01,1614553200.0
17729,11,0,2021-03-02,14394,9264,440062,239721,2021-03-02,1614639600.0
17730,11,0,2021-03-03,18695,9528,458757,249249,2021-03-03,1614726000.0
17731,11,0,2021-03-04,28289,10208,487046,259457,2021-03-04,1614812400.0
17732,11,0,2021-03-05,36525,10002,523571,269459,2021-03-05,1614898800.0
17733,11,0,2021-03-06,46455,2731,570026,272190,2021-03-06,1614985200.0
17734,11,0,2021-03-07,34311,2188,604337,274378,2021-03-07,1615071600.0
17735,11,0,2021-03-08,17785,6869,622122,281247,2021-03-08,1615158000.0
17736,11,0,2021-03-09,26890,6987,649012,288234,2021-03-09,1615244400.0
17737,11,0,2021-03-10,27676,7534,676688,295768,2021-03-10,1615330800.0
17738,11,0,2021-03-11,37090,8644,713778,304412,2021-03-11,1615417200.0
17739,11,0,2021-03-12,44840,8103,758618,312515,2021-03-12,1615503600.0
17740,11,0,2021-03-13,39899,1845,798517,314360,2021-03-13,1615590000.0
17741,11,0,2021-03-14,14275,474,812792,314834,2021-03-14,1615676400.0
17742,11,0,2021-03-15,29244,3249,842036,318083,2021-03-15,1615762800.0
17743,11,0,2021-03-16,23773,3260,865809,321343,2021-03-16,1615849200.0
17744,11,0,2021-03-17,24457,3022,890266,324365,2021-03-17,1615935600.0
17745,11,0,2021-03-18,29042,3235,919308,327600,2021-03-18,1616022000.0
17746,11,0,2021-03-19,39705,3053,959013,330653,2021-03-19,1616108400.0
17747,11,0,2021-03-20,25879,881,984892,331534,2021-03-20,1616194800.0
17748,11,0,2021-03-21,5637,1068,990529,332602,2021-03-21,1616281200.0
17749,11,0,2021-03-22,32174,3135,1022703,335737,2021-03-22,1616367600.0
17750,11,0,2021-03-23,43360,4019,1066063,339756,2021-03-23,1616454000.0
17751,11,0,2021-03-24,42711,3674,1108774,343430,2021-03-24,1616540400.0
17752,11,0,2021-03-25,58010,3295,1166784,346725,2021-03-25,1616626800.0
17753,11,0,2021-03-26,57831,3853,1224615,350578,2021-03-26,1616713200.0
17754,11,0,2021-03-27,34518,1029,1259133,351607,2021-03-27,1616799600.0
17755,11,0,2021-03-28,10173,158,1269306,351765,2021-03-28,1616886000.0
17756,11,0,2021-03-29,33114,6977,1302420,358742,2021-03-29,1616972400.0
17757,11,0,2021-03-30,44923,9759,1347343,368501,2021-03-30,1617058800.0
17758,11,0,2021-03-31,39952,12218,1387295,380719,2021-03-31,1617145200.0
17759,11,0,2021-04-01,45479,19550,1432774,400269,2021-04-01,1617231600.0
17760,11,0,2021-04-02,39516,22051,1472290,422320,2021-04-02,1617318000.0
17761,11,0,2021-04-03,18407,20355,1490697,442675,2021-04-03,1617404400.0
17762,11,0,2021-04-04,6126,7036,1496823,449711,2021-04-04,1617490800.0
17763,11,0,2021-04-05,5974,1814,1502797,451525,2021-04-05,1617577200.0
17764,11,0,2021-04-06,30021,16996,1532818,468521,2021-04-06,1617663600.0
17765,11,0,2021-04-07,37608,18057,1570426,486578,2021-04-07,1617750000.0
17766,11,0,2021-04-08,46766,18465,1617192,505043,2021-04-08,1617836400.0
17767,11,0,2021-04-09,53892,18783,1671084,523826,2021-04-09,1617922800.0
17768,11,0,2021-04-10,29001,18307,1700085,542133,2021-04-10,1618009200.0
17769,11,0,2021-04-11,6557,6811,1706642,548944,2021-04-11,1618095600.0
17770,11,0,2021-04-12,30348,17762,1736990,566706,2021-04-12,1618185600.0
17771,11,0,2021-04-13,37372,25687,1774362,592393,2021-04-13,1618272000.0
17772,11,0,2021-04-14,35078,22443,1809440,614836,2021-04-14,1618358400.0
17773,11,0,2021-04-15,39219,26251,1848659,641087,2021-04-15,1618444800.0
17774,11,0,2021-04-16,41127,25760,1889786,666847,2021-04-16,1618531200.0
17775,11,0,2021-04-17,22816,13863,1912602,680710,2021-04-17,1618617600.0
17776,11,0,2021-04-18,5324,3419,1917926,684129,2021-04-18,1618704000.0
17777,11,0,2021-04-19,25144,21892,1943070,706021,2021-04-19,1618790400.0
17778,11,0,2021-04-20,30633,26213,1973703,732234,2021-04-20,1618876800.0
17779,11,0,2021-04-21,32269,26437,2005972,758671,2021-04-21,1618963200.0
17780,11,0,2021-04-22,34527,32573,2040499,791244,2021-04-22,1619049600.0
17781,11,0,2021-04-23,37988,29824,2078487,821068,2021-04-23,1619136000.0
17782,11,0,2021-04-24,37988,20650,2116475,841718,2021-04-24,1619222400.0
17783,11,0,2021-04-25,20530,6757,2137005,848475,2021-04-25,1619308800.0
17784,11,0,2021-04-26,33917,22605,2170922,871080,2021-04-26,1619395200.0
17785,11,0,2021-04-27,45791,25989,2216713,897069,2021-04-27,1619481600.0
17786,11,0,2021-04-28,48460,25381,2265173,922450,2021-04-28,1619568000.0
17787,11,0,2021-04-29,57832,26642,2323005,949092,2021-04-29,1619654400.0
17788,11,0,2021-04-30,61365,24981,2384370,974073,2021-04-30,1619740800.0
17789,11,0,2021-05-01,24132,4221,2408502,978294,2021-05-01,1619827200.0
17790,11,0,2021-05-02,14664,3926,2423166,982220,2021-05-02,1619913600.0
17791,11,0,2021-05-03,54474,31238,2477640,1013458,2021-05-03,1620000000.0
17792,11,0,2021-05-04,59762,29109,2537402,1042567,2021-05-04,1620086400.0
17793,11,0,2021-05-05,60417,28981,2597819,1071548,2021-05-05,1620172800.0
17794,11,0,2021-05-06,67359,31942,2665178,1103490,2021-05-06,1620259200.0
17795,11,0,2021-05-07,65641,33331,2730819,1136821,2021-05-07,1620345600.0
17796,11,0,2021-05-08,51207,13025,2782026,1149846,2021-05-08,1620432000.0
17797,11,0,2021-05-09,33202,7464,2815228,1157310,2021-05-09,1620518400.0
17798,11,0,2021-05-10,70825,24616,2886053,1181926,2021-05-10,1620604800.0
17799,11,0,2021-05-11,81860,30408,2967913,1212334,2021-05-11,1620691200.0
17800,11,0,2021-05-12,83727,25072,3051640,1237406,2021-05-12,1620777600.0
17801,11,0,2021-05-13,68244,4626,3119884,1242032,2021-05-13,1620864000.0
17802,11,0,2021-05-14,84664,14864,3204548,1256896,2021-05-14,1620950400.0
17803,11,0,2021-05-15,66814,9901,3271362,1266797,2021-05-15,1621036800.0
17804,11,0,2021-05-16,36730,2367,3308092,1269164,2021-05-16,1621123200.0
17805,11,0,2021-05-17,82967,9610,3391059,1278774,2021-05-17,1621206000.0
17806,11,0,2021-05-18,99794,10895,3490853,1289669,2021-05-18,1621292400.0
17807,11,0,2021-05-19,98445,19104,3589298,1308773,2021-05-19,1621378800.0
17808,11,0,2021-05-20,107387,18659,3696685,1327432,2021-05-20,1621465200.0
17809,11,0,2021-05-21,101729,16048,3798414,1343480,2021-05-21,1621551600.0
17810,11,0,2021-05-22,80126,7513,3878540,1350993,2021-05-22,1621638000.0
17811,11,0,2021-05-23,42072,2146,3920612,1353139,2021-05-23,1621724400.0
17812,11,0,2021-05-24,60135,3059,3980747,1356198,2021-05-24,1621810800.0
17813,11,0,2021-05-25,86199,23580,4066946,1379778,2021-05-25,1621897200.0
17814,11,0,2021-05-26,84702,23514,4151648,1403292,2021-05-26,1621983600.0
17815,11,0,2021-05-27,92616,30445,4244264,1433737,2021-05-27,1622070000.0
17816,11,0,2021-05-28,87150,34447,4331414,1468184,2021-05-28,1622156400.0
17817,11,0,2021-05-29,68302,19651,4399716,1487835,2021-05-29,1622242800.0
17818,11,0,2021-05-30,36034,4916,4435750,1492751,2021-05-30,1622329200.0
17819,11,0,2021-05-31,78083,31420,4513833,1524171,2021-05-31,1622415600.0
17820,11,0,2021-06-01,87232,40511,4601065,1564682,2021-06-01,1622502000.0
17821,11,0,2021-06-02,83358,35342,4684423,1600024,2021-06-02,1622588400.0
17822,11,0,2021-06-03,89019,42598,4773442,1642622,2021-06-03,1622674800.0
17823,11,0,2021-06-04,84767,47665,4858209,1690287,2021-06-04,1622761200.0
17824,11,0,2021-06-05,63663,41925,4921872,1732212,2021-06-05,1622847600.0
17825,11,0,2021-06-06,37977,13332,4959849,1745544,2021-06-06,1622934000.0
17826,11,0,2021-06-07,69025,44958,5028874,1790502,2021-06-07,1623020400.0
17827,11,0,2021-06-08,72456,52144,5101330,1842646,2021-06-08,1623106800.0
17828,11,0,2021-06-09,70617,53200,5171947,1895846,2021-06-09,1623193200.0
17829,11,0,2021-06-10,71214,70532,5243161,1966378,2021-06-10,1623279600.0
17830,11,0,2021-06-11,65614,62177,5308775,2028555,2021-06-11,1623366000.0
17831,11,0,2021-06-12,63756,38928,5372531,2067483,2021-06-12,1623452400.0
17832,11,0,2021-06-13,29550,18541,5402081,2086024,2021-06-13,1623538800.0
17833,11,0,2021-06-14,43201,68405,5445282,2154429,2021-06-14,1623625200.0
17834,11,0,2021-06-15,51094,74752,5496376,2229181,2021-06-15,1623711600.0
17835,11,0,2021-06-16,52333,69831,5548709,2299012,2021-06-16,1623798000.0
17836,11,0,2021-06-17,54012,72709,5602721,2371721,2021-06-17,1623884400.0
17837,11,0,2021-06-18,49971,87109,5652692,2458830,2021-06-18,1623970800.0
17838,11,0,2021-06-19,43465,62106,5696157,2520936,2021-06-19,1624057200.0
17839,11,0,2021-06-20,16298,33074,5712455,2554010,2021-06-20,1624143600.0
17840,11,0,2021-06-21,34355,78001,5746810,2632011,2021-06-21,1624230000.0
17841,11,0,2021-06-22,38957,93506,5785767,2725517,2021-06-22,1624316400.0
17842,11,0,2021-06-23,39426,89939,5825193,2815456,2021-06-23,1624402800.0
17843,11,0,2021-06-24,42275,87177,5867468,2902633,2021-06-24,1624489200.0
17844,11,0,2021-06-25,38717,101715,5906185,3004348,2021-06-25,1624575600.0
17845,11,0,2021-06-26,35320,78440,5941505,3082788,2021-06-26,1624662000.0
17846,11,0,2021-06-27,13316,37424,5954821,3120212,2021-06-27,1624748400.0
17847,11,0,2021-06-28,30193,89251,5985014,3209463,2021-06-28,1624834800.0
17848,11,0,2021-06-29,34006,100741,6019020,3310204,2021-06-29,1624921200.0
17849,11,0,2021-06-30,36607,97346,6055627,3407550,2021-06-30,1625007600.0
17850,11,0,2021-07-01,39045,96346,6094672,3503896,2021-07-01,1625094000.0
17851,11,0,2021-07-02,38256,100265,6132928,3604161,2021-07-02,1625180400.0
17852,11,0,2021-07-03,32060,85162,6164988,3689323,2021-07-03,1625266800.0
17853,11,0,2021-07-04,14208,39406,6179196,3728729,2021-07-04,1625353200.0
17854,11,0,2021-07-05,32449,78706,6211645,3807435,2021-07-05,1625439600.0
17855,11,0,2021-07-06,35857,91952,6247502,3899387,2021-07-06,1625526000.0
17856,24,0,2020-12-27,0,0,0,0,2020-12-27,1609023600.0
17857,24,0,2020-12-28,17,0,17,0,2020-12-28,1609110000.0
17858,24,0,2020-12-29,10,0,27,0,2020-12-29,1609196400.0
17859,24,0,2020-12-30,1,0,28,0,2020-12-30,1609282800.0
17860,24,0,2020-12-31,0,0,28,0,2020-12-31,1609369200.0
17861,24,0,2021-01-01,1,0,29,0,2021-01-01,1609455600.0
17862,24,0,2021-01-02,0,0,29,0,2021-01-02,1609542000.0
17863,24,0,2021-01-03,0,0,29,0,2021-01-03,1609628400.0
17864,24,0,2021-01-04,24,0,53,0,2021-01-04,1609714800.0
17865,24,0,2021-01-05,163,0,216,0,2021-01-05,1609801200.0
17866,24,0,2021-01-06,328,0,544,0,2021-01-06,1609887600.0
17867,24,0,2021-01-07,492,0,1036,0,2021-01-07,1609974000.0
17868,24,0,2021-01-08,952,0,1988,0,2021-01-08,1610060400.0
17869,24,0,2021-01-09,504,0,2492,0,2021-01-09,1610146800.0
17870,24,0,2021-01-10,395,0,2887,0,2021-01-10,1610233200.0
17871,24,0,2021-01-11,1279,0,4166,0,2021-01-11,1610319600.0
17872,24,0,2021-01-12,2575,0,6741,0,2021-01-12,1610406000.0
17873,24,0,2021-01-13,2190,0,8931,0,2021-01-13,1610492400.0
17874,24,0,2021-01-14,2504,0,11435,0,2021-01-14,1610578800.0
17875,24,0,2021-01-15,2115,0,13550,0,2021-01-15,1610665200.0
17876,24,0,2021-01-16,857,2,14407,2,2021-01-16,1610751600.0
17877,24,0,2021-01-17,322,3,14729,5,2021-01-17,1610838000.0
17878,24,0,2021-01-18,3214,13,17943,18,2021-01-18,1610924400.0
17879,24,0,2021-01-19,6325,10,24268,28,2021-01-19,1611010800.0
17880,24,0,2021-01-20,7165,5,31433,33,2021-01-20,1611097200.0
17881,24,0,2021-01-21,7418,1,38851,34,2021-01-21,1611183600.0
17882,24,0,2021-01-22,5120,1,43971,35,2021-01-22,1611270000.0
17883,24,0,2021-01-23,1276,1,45247,36,2021-01-23,1611356400.0
17884,24,0,2021-01-24,225,1,45472,37,2021-01-24,1611442800.0
17885,24,0,2021-01-25,3114,20,48586,57,2021-01-25,1611529200.0
17886,24,0,2021-01-26,4848,81,53434,138,2021-01-26,1611615600.0
17887,24,0,2021-01-27,5045,176,58479,314,2021-01-27,1611702000.0
17888,24,0,2021-01-28,5634,495,64113,809,2021-01-28,1611788400.0
17889,24,0,2021-01-29,3423,725,67536,1534,2021-01-29,1611874800.0
17890,24,0,2021-01-30,1208,397,68744,1931,2021-01-30,1611961200.0
17891,24,0,2021-01-31,251,368,68995,2299,2021-01-31,1612047600.0
17892,24,0,2021-02-01,2170,925,71165,3224,2021-02-01,1612134000.0
17893,24,0,2021-02-02,3032,1887,74197,5111,2021-02-02,1612220400.0
17894,24,0,2021-02-03,3111,1766,77308,6877,2021-02-03,1612306800.0
17895,24,0,2021-02-04,3234,1611,80542,8488,2021-02-04,1612393200.0
17896,24,0,2021-02-05,2394,1364,82936,9852,2021-02-05,1612479600.0
17897,24,0,2021-02-06,707,262,83643,10114,2021-02-06,1612566000.0
17898,24,0,2021-02-07,134,31,83777,10145,2021-02-07,1612652400.0
17899,24,0,2021-02-08,1968,1560,85745,11705,2021-02-08,1612738800.0
17900,24,0,2021-02-09,3413,3287,89158,14992,2021-02-09,1612825200.0
17901,24,0,2021-02-10,4085,3735,93243,18727,2021-02-10,1612911600.0
17902,24,0,2021-02-11,4656,4745,97899,23472,2021-02-11,1612998000.0
17903,24,0,2021-02-12,3483,3256,101382,26728,2021-02-12,1613084400.0
17904,24,0,2021-02-13,840,766,102222,27494,2021-02-13,1613170800.0
17905,24,0,2021-02-14,426,250,102648,27744,2021-02-14,1613257200.0
17906,24,0,2021-02-15,1963,2838,104611,30582,2021-02-15,1613343600.0
17907,24,0,2021-02-16,2849,4473,107460,35055,2021-02-16,1613430000.0
17908,24,0,2021-02-17,2691,5071,110151,40126,2021-02-17,1613516400.0
17909,24,0,2021-02-18,3521,5132,113672,45258,2021-02-18,1613602800.0
17910,24,0,2021-02-19,3257,3543,116929,48801,2021-02-19,1613689200.0
17911,24,0,2021-02-20,1288,981,118217,49782,2021-02-20,1613775600.0
17912,24,0,2021-02-21,433,238,118650,50020,2021-02-21,1613862000.0
17913,24,0,2021-02-22,1652,3054,120302,53074,2021-02-22,1613948400.0
17914,24,0,2021-02-23,2340,3133,122642,56207,2021-02-23,1614034800.0
17915,24,0,2021-02-24,2093,3457,124735,59664,2021-02-24,1614121200.0
17916,24,0,2021-02-25,3623,3139,128358,62803,2021-02-25,1614207600.0
17917,24,0,2021-02-26,4467,2596,132825,65399,2021-02-26,1614294000.0
17918,24,0,2021-02-27,1877,979,134702,66378,2021-02-27,1614380400.0
17919,24,0,2021-02-28,97,219,134799,66597,2021-02-28,1614466800.0
17920,24,0,2021-03-01,2176,2003,136975,68600,2021-03-01,1614553200.0
17921,24,0,2021-03-02,3431,2865,140406,71465,2021-03-02,1614639600.0
17922,24,0,2021-03-03,3551,3389,143957,74854,2021-03-03,1614726000.0
17923,24,0,2021-03-04,5337,3635,149294,78489,2021-03-04,1614812400.0
17924,24,0,2021-03-05,7039,3089,156333,81578,2021-03-05,1614898800.0
17925,24,0,2021-03-06,7376,691,163709,82269,2021-03-06,1614985200.0
17926,24,0,2021-03-07,2429,268,166138,82537,2021-03-07,1615071600.0
17927,24,0,2021-03-08,2689,2592,168827,85129,2021-03-08,1615158000.0
17928,24,0,2021-03-09,5778,2763,174605,87892,2021-03-09,1615244400.0
17929,24,0,2021-03-10,6413,3469,181018,91361,2021-03-10,1615330800.0
17930,24,0,2021-03-11,7805,3424,188823,94785,2021-03-11,1615417200.0
17931,24,0,2021-03-12,10788,2582,199611,97367,2021-03-12,1615503600.0
17932,24,0,2021-03-13,7122,681,206733,98048,2021-03-13,1615590000.0
17933,24,0,2021-03-14,1549,263,208282,98311,2021-03-14,1615676400.0
17934,24,0,2021-03-15,4559,1945,212841,100256,2021-03-15,1615762800.0
17935,24,0,2021-03-16,4597,2322,217438,102578,2021-03-16,1615849200.0
17936,24,0,2021-03-17,4462,1961,221900,104539,2021-03-17,1615935600.0
17937,24,0,2021-03-18,5064,2042,226964,106581,2021-03-18,1616022000.0
17938,24,0,2021-03-19,7783,1600,234747,108181,2021-03-19,1616108400.0
17939,24,0,2021-03-20,4436,842,239183,109023,2021-03-20,1616194800.0
17940,24,0,2021-03-21,557,344,239740,109367,2021-03-21,1616281200.0
17941,24,0,2021-03-22,4861,1633,244601,111000,2021-03-22,1616367600.0
17942,24,0,2021-03-23,8039,2216,252640,113216,2021-03-23,1616454000.0
17943,24,0,2021-03-24,8816,1905,261456,115121,2021-03-24,1616540400.0
17944,24,0,2021-03-25,12134,1841,273590,116962,2021-03-25,1616626800.0
17945,24,0,2021-03-26,13273,1834,286863,118796,2021-03-26,1616713200.0
17946,24,0,2021-03-27,5782,633,292645,119429,2021-03-27,1616799600.0
17947,24,0,2021-03-28,520,97,293165,119526,2021-03-28,1616886000.0
17948,24,0,2021-03-29,6762,1791,299927,121317,2021-03-29,1616972400.0
17949,24,0,2021-03-30,10174,2646,310101,123963,2021-03-30,1617058800.0
17950,24,0,2021-03-31,9894,2196,319995,126159,2021-03-31,1617145200.0
17951,24,0,2021-04-01,12047,3122,332042,129281,2021-04-01,1617231600.0
17952,24,0,2021-04-02,10642,3123,342684,132404,2021-04-02,1617318000.0
17953,24,0,2021-04-03,3415,1676,346099,134080,2021-04-03,1617404400.0
17954,24,0,2021-04-04,394,338,346493,134418,2021-04-04,1617490800.0
17955,24,0,2021-04-05,400,48,346893,134466,2021-04-05,1617577200.0
17956,24,0,2021-04-06,8328,3284,355221,137750,2021-04-06,1617663600.0
17957,24,0,2021-04-07,11071,4357,366292,142107,2021-04-07,1617750000.0
17958,24,0,2021-04-08,14189,4487,380481,146594,2021-04-08,1617836400.0
17959,24,0,2021-04-09,17765,3417,398246,150011,2021-04-09,1617922800.0
17960,24,0,2021-04-10,9392,1946,407638,151957,2021-04-10,1618009200.0
17961,24,0,2021-04-11,2910,1188,410548,153145,2021-04-11,1618095600.0
17962,24,0,2021-04-12,10848,3277,421396,156422,2021-04-12,1618185600.0
17963,24,0,2021-04-13,14995,4573,436391,160995,2021-04-13,1618272000.0
17964,24,0,2021-04-14,13477,4681,449868,165676,2021-04-14,1618358400.0
17965,24,0,2021-04-15,15360,4870,465228,170546,2021-04-15,1618444800.0
17966,24,0,2021-04-16,15693,4041,480921,174587,2021-04-16,1618531200.0
17967,24,0,2021-04-17,8196,1202,489117,175789,2021-04-17,1618617600.0
17968,24,0,2021-04-18,1101,265,490218,176054,2021-04-18,1618704000.0
17969,24,0,2021-04-19,9439,3900,499657,179954,2021-04-19,1618790400.0
17970,24,0,2021-04-20,12727,5690,512384,185644,2021-04-20,1618876800.0
17971,24,0,2021-04-21,12329,5678,524713,191322,2021-04-21,1618963200.0
17972,24,0,2021-04-22,13865,7178,538578,198500,2021-04-22,1619049600.0
17973,24,0,2021-04-23,13701,6672,552279,205172,2021-04-23,1619136000.0
17974,24,0,2021-04-24,10238,3002,562517,208174,2021-04-24,1619222400.0
17975,24,0,2021-04-25,3048,375,565565,208549,2021-04-25,1619308800.0
17976,24,0,2021-04-26,10206,5110,575771,213659,2021-04-26,1619395200.0
17977,24,0,2021-04-27,13875,7001,589646,220660,2021-04-27,1619481600.0
17978,24,0,2021-04-28,13025,7748,602671,228408,2021-04-28,1619568000.0
17979,24,0,2021-04-29,16583,7475,619254,235883,2021-04-29,1619654400.0
17980,24,0,2021-04-30,17476,5960,636730,241843,2021-04-30,1619740800.0
17981,24,0,2021-05-01,2911,504,639641,242347,2021-05-01,1619827200.0
17982,24,0,2021-05-02,2142,218,641783,242565,2021-05-02,1619913600.0
17983,24,0,2021-05-03,11295,5575,653078,248140,2021-05-03,1620000000.0
17984,24,0,2021-05-04,12819,9659,665897,257799,2021-05-04,1620086400.0
17985,24,0,2021-05-05,13885,8832,679782,266631,2021-05-05,1620172800.0
17986,24,0,2021-05-06,17490,8616,697272,275247,2021-05-06,1620259200.0
17987,24,0,2021-05-07,14564,10590,711836,285837,2021-05-07,1620345600.0
17988,24,0,2021-05-08,3705,2097,715541,287934,2021-05-08,1620432000.0
17989,24,0,2021-05-09,2349,3629,717890,291563,2021-05-09,1620518400.0
17990,24,0,2021-05-10,11538,11362,729428,302925,2021-05-10,1620604800.0
17991,24,0,2021-05-11,16369,12992,745797,315917,2021-05-11,1620691200.0
17992,24,0,2021-05-12,18238,12044,764035,327961,2021-05-12,1620777600.0
17993,24,0,2021-05-13,6930,2803,770965,330764,2021-05-13,1620864000.0
17994,24,0,2021-05-14,14512,8243,785477,339007,2021-05-14,1620950400.0
17995,24,0,2021-05-15,10466,4523,795943,343530,2021-05-15,1621036800.0
17996,24,0,2021-05-16,3167,1020,799110,344550,2021-05-16,1621123200.0
17997,24,0,2021-05-17,13318,6807,812428,351357,2021-05-17,1621206000.0
17998,24,0,2021-05-18,18481,7017,830909,358374,2021-05-18,1621292400.0
17999,24,0,2021-05-19,19046,6491,849955,364865,2021-05-19,1621378800.0
18000,24,0,2021-05-20,21343,7019,871298,371884,2021-05-20,1621465200.0
18001,24,0,2021-05-21,18436,7708,889734,379592,2021-05-21,1621551600.0
18002,24,0,2021-05-22,7627,3699,897361,383291,2021-05-22,1621638000.0
18003,24,0,2021-05-23,2992,783,900353,384074,2021-05-23,1621724400.0
18004,24,0,2021-05-24,8349,1183,908702,385257,2021-05-24,1621810800.0
18005,24,0,2021-05-25,17803,7564,926505,392821,2021-05-25,1621897200.0
18006,24,0,2021-05-26,19332,7096,945837,399917,2021-05-26,1621983600.0
18007,24,0,2021-05-27,20892,8420,966729,408337,2021-05-27,1622070000.0
18008,24,0,2021-05-28,20472,9941,987201,418278,2021-05-28,1622156400.0
18009,24,0,2021-05-29,12421,4756,999622,423034,2021-05-29,1622242800.0
18010,24,0,2021-05-30,2033,1386,1001655,424420,2021-05-30,1622329200.0
18011,24,0,2021-05-31,14582,7709,1016237,432129,2021-05-31,1622415600.0
18012,24,0,2021-06-01,19702,9985,1035939,442114,2021-06-01,1622502000.0
18013,24,0,2021-06-02,17777,9319,1053716,451433,2021-06-02,1622588400.0
18014,24,0,2021-06-03,20893,9882,1074609,461315,2021-06-03,1622674800.0
18015,24,0,2021-06-04,19937,11744,1094546,473059,2021-06-04,1622761200.0
18016,24,0,2021-06-05,9875,7871,1104421,480930,2021-06-05,1622847600.0
18017,24,0,2021-06-06,1993,2870,1106414,483800,2021-06-06,1622934000.0
18018,24,0,2021-06-07,14416,10803,1120830,494603,2021-06-07,1623020400.0
18019,24,0,2021-06-08,16078,13265,1136908,507868,2021-06-08,1623106800.0
18020,24,0,2021-06-09,16454,11220,1153362,519088,2021-06-09,1623193200.0
18021,24,0,2021-06-10,17888,10542,1171250,529630,2021-06-10,1623279600.0
18022,24,0,2021-06-11,17164,13402,1188414,543032,2021-06-11,1623366000.0
18023,24,0,2021-06-12,10078,6364,1198492,549396,2021-06-12,1623452400.0
18024,24,0,2021-06-13,893,1230,1199385,550626,2021-06-13,1623538800.0
18025,24,0,2021-06-14,10452,14339,1209837,564965,2021-06-14,1623625200.0
18026,24,0,2021-06-15,12977,15885,1222814,580850,2021-06-15,1623711600.0
18027,24,0,2021-06-16,13441,15103,1236255,595953,2021-06-16,1623798000.0
18028,24,0,2021-06-17,13122,15939,1249377,611892,2021-06-17,1623884400.0
18029,24,0,2021-06-18,14543,18282,1263920,630174,2021-06-18,1623970800.0
18030,24,0,2021-06-19,7925,5866,1271845,636040,2021-06-19,1624057200.0
18031,24,0,2021-06-20,554,812,1272399,636852,2021-06-20,1624143600.0
18032,24,0,2021-06-21,8853,15529,1281252,652381,2021-06-21,1624230000.0
18033,24,0,2021-06-22,10206,18118,1291458,670499,2021-06-22,1624316400.0
18034,24,0,2021-06-23,9700,16648,1301158,687147,2021-06-23,1624402800.0
18035,24,0,2021-06-24,9009,11704,1310167,698851,2021-06-24,1624489200.0
18036,24,0,2021-06-25,10642,18481,1320809,717332,2021-06-25,1624575600.0
18037,24,0,2021-06-26,5294,10237,1326103,727569,2021-06-26,1624662000.0
18038,24,0,2021-06-27,794,2070,1326897,729639,2021-06-27,1624748400.0
18039,24,0,2021-06-28,6480,17711,1333377,747350,2021-06-28,1624834800.0
18040,24,0,2021-06-29,7915,22961,1341292,770311,2021-06-29,1624921200.0
18041,24,0,2021-06-30,8137,21105,1349429,791416,2021-06-30,1625007600.0
18042,24,0,2021-07-01,7684,18395,1357113,809811,2021-07-01,1625094000.0
18043,24,0,2021-07-02,8214,22076,1365327,831887,2021-07-02,1625180400.0
18044,24,0,2021-07-03,4168,10521,1369495,842408,2021-07-03,1625266800.0
18045,24,0,2021-07-04,499,2698,1369994,845106,2021-07-04,1625353200.0
18046,24,0,2021-07-05,6633,17596,1376627,862702,2021-07-05,1625439600.0
18047,24,0,2021-07-06,7926,22271,1384553,884973,2021-07-06,1625526000.0
18048,27,0,2020-12-27,4,0,4,0,2020-12-27,1609023600.0
18049,27,0,2020-12-28,0,0,4,0,2020-12-28,1609110000.0
18050,27,0,2020-12-29,19,0,23,0,2020-12-29,1609196400.0
18051,27,0,2020-12-30,20,0,43,0,2020-12-30,1609282800.0
18052,27,0,2020-12-31,2,0,45,0,2020-12-31,1609369200.0
18053,27,0,2021-01-01,0,0,45,0,2021-01-01,1609455600.0
18054,27,0,2021-01-02,1,0,46,0,2021-01-02,1609542000.0
18055,27,0,2021-01-03,1,0,47,0,2021-01-03,1609628400.0
18056,27,0,2021-01-04,28,0,75,0,2021-01-04,1609714800.0
18057,27,0,2021-01-05,263,0,338,0,2021-01-05,1609801200.0
18058,27,0,2021-01-06,718,0,1056,0,2021-01-06,1609887600.0
18059,27,0,2021-01-07,1582,0,2638,0,2021-01-07,1609974000.0
18060,27,0,2021-01-08,1896,0,4534,0,2021-01-08,1610060400.0
18061,27,0,2021-01-09,688,0,5222,0,2021-01-09,1610146800.0
18062,27,0,2021-01-10,3,0,5225,0,2021-01-10,1610233200.0
18063,27,0,2021-01-11,2420,0,7645,0,2021-01-11,1610319600.0
18064,27,0,2021-01-12,3823,0,11468,0,2021-01-12,1610406000.0
18065,27,0,2021-01-13,3849,0,15317,0,2021-01-13,1610492400.0
18066,27,0,2021-01-14,4752,0,20069,0,2021-01-14,1610578800.0
18067,27,0,2021-01-15,3601,0,23670,0,2021-01-15,1610665200.0
18068,27,0,2021-01-16,795,5,24465,5,2021-01-16,1610751600.0
18069,27,0,2021-01-17,116,1,24581,6,2021-01-17,1610838000.0
18070,27,0,2021-01-18,6254,10,30835,16,2021-01-18,1610924400.0
18071,27,0,2021-01-19,8401,8,39236,24,2021-01-19,1611010800.0
18072,27,0,2021-01-20,7910,48,47146,72,2021-01-20,1611097200.0
18073,27,0,2021-01-21,9461,8,56607,80,2021-01-21,1611183600.0
18074,27,0,2021-01-22,7710,6,64317,86,2021-01-22,1611270000.0
18075,27,0,2021-01-23,2986,6,67303,92,2021-01-23,1611356400.0
18076,27,0,2021-01-24,347,0,67650,92,2021-01-24,1611442800.0
18077,27,0,2021-01-25,5222,24,72872,116,2021-01-25,1611529200.0
18078,27,0,2021-01-26,7390,223,80262,339,2021-01-26,1611615600.0
18079,27,0,2021-01-27,7098,339,87360,678,2021-01-27,1611702000.0
18080,27,0,2021-01-28,6337,886,93697,1564,2021-01-28,1611788400.0
18081,27,0,2021-01-29,5931,1255,99628,2819,2021-01-29,1611874800.0
18082,27,0,2021-01-30,2496,347,102124,3166,2021-01-30,1611961200.0
18083,27,0,2021-01-31,252,22,102376,3188,2021-01-31,1612047600.0
18084,27,0,2021-02-01,3359,1389,105735,4577,2021-02-01,1612134000.0
18085,27,0,2021-02-02,4040,2216,109775,6793,2021-02-02,1612220400.0
18086,27,0,2021-02-03,3618,2378,113393,9171,2021-02-03,1612306800.0
18087,27,0,2021-02-04,3702,3150,117095,12321,2021-02-04,1612393200.0
18088,27,0,2021-02-05,3239,2587,120334,14908,2021-02-05,1612479600.0
18089,27,0,2021-02-06,1608,669,121942,15577,2021-02-06,1612566000.0
18090,27,0,2021-02-07,5,87,121947,15664,2021-02-07,1612652400.0
18091,27,0,2021-02-08,2912,2678,124859,18342,2021-02-08,1612738800.0
18092,27,0,2021-02-09,3016,3611,127875,21953,2021-02-09,1612825200.0
18093,27,0,2021-02-10,3054,3374,130929,25327,2021-02-10,1612911600.0
18094,27,0,2021-02-11,3314,4628,134243,29955,2021-02-11,1612998000.0
18095,27,0,2021-02-12,2727,4434,136970,34389,2021-02-12,1613084400.0
18096,27,0,2021-02-13,986,1451,137956,35840,2021-02-13,1613170800.0
18097,27,0,2021-02-14,258,289,138214,36129,2021-02-14,1613257200.0
18098,27,0,2021-02-15,1239,5735,139453,41864,2021-02-15,1613343600.0
18099,27,0,2021-02-16,1507,7413,140960,49277,2021-02-16,1613430000.0
18100,27,0,2021-02-17,1806,6879,142766,56156,2021-02-17,1613516400.0
18101,27,0,2021-02-18,2146,6411,144912,62567,2021-02-18,1613602800.0
18102,27,0,2021-02-19,1736,5633,146648,68200,2021-02-19,1613689200.0
18103,27,0,2021-02-20,712,2176,147360,70376,2021-02-20,1613775600.0
18104,27,0,2021-02-21,2,280,147362,70656,2021-02-21,1613862000.0
18105,27,0,2021-02-22,979,4843,148341,75499,2021-02-22,1613948400.0
18106,27,0,2021-02-23,1203,5405,149544,80904,2021-02-23,1614034800.0
18107,27,0,2021-02-24,1508,4810,151052,85714,2021-02-24,1614121200.0
18108,27,0,2021-02-25,2921,5001,153973,90715,2021-02-25,1614207600.0
18109,27,0,2021-02-26,3683,4144,157656,94859,2021-02-26,1614294000.0
18110,27,0,2021-02-27,1911,1933,159567,96792,2021-02-27,1614380400.0
18111,27,0,2021-02-28,107,279,159674,97071,2021-02-28,1614466800.0
18112,27,0,2021-03-01,3673,3453,163347,100524,2021-03-01,1614553200.0
18113,27,0,2021-03-02,5417,4240,168764,104764,2021-03-02,1614639600.0
18114,27,0,2021-03-03,5975,3485,174739,108249,2021-03-03,1614726000.0
18115,27,0,2021-03-04,7714,3415,182453,111664,2021-03-04,1614812400.0
18116,27,0,2021-03-05,9701,3009,192154,114673,2021-03-05,1614898800.0
18117,27,0,2021-03-06,6231,1008,198385,115681,2021-03-06,1614985200.0
18118,27,0,2021-03-07,872,179,199257,115860,2021-03-07,1615071600.0
18119,27,0,2021-03-08,4552,3343,203809,119203,2021-03-08,1615158000.0
18120,27,0,2021-03-09,8424,3244,212233,122447,2021-03-09,1615244400.0
18121,27,0,2021-03-10,8726,2640,220959,125087,2021-03-10,1615330800.0
18122,27,0,2021-03-11,10269,3043,231228,128130,2021-03-11,1615417200.0
18123,27,0,2021-03-12,11896,2275,243124,130405,2021-03-12,1615503600.0
18124,27,0,2021-03-13,7050,601,250174,131006,2021-03-13,1615590000.0
18125,27,0,2021-03-14,214,59,250388,131065,2021-03-14,1615676400.0
18126,27,0,2021-03-15,7320,1238,257708,132303,2021-03-15,1615762800.0
18127,27,0,2021-03-16,8246,894,265954,133197,2021-03-16,1615849200.0
18128,27,0,2021-03-17,8540,936,274494,134133,2021-03-17,1615935600.0
18129,27,0,2021-03-18,8624,1189,283118,135322,2021-03-18,1616022000.0
18130,27,0,2021-03-19,9448,828,292566,136150,2021-03-19,1616108400.0
18131,27,0,2021-03-20,5670,280,298236,136430,2021-03-20,1616194800.0
18132,27,0,2021-03-21,238,4,298474,136434,2021-03-21,1616281200.0
18133,27,0,2021-03-22,9346,728,307820,137162,2021-03-22,1616367600.0
18134,27,0,2021-03-23,14728,844,322548,138006,2021-03-23,1616454000.0
18135,27,0,2021-03-24,15193,845,337741,138851,2021-03-24,1616540400.0
18136,27,0,2021-03-25,18385,1015,356126,139866,2021-03-25,1616626800.0
18137,27,0,2021-03-26,18390,794,374516,140660,2021-03-26,1616713200.0
18138,27,0,2021-03-27,7690,235,382206,140895,2021-03-27,1616799600.0
18139,27,0,2021-03-28,492,116,382698,141011,2021-03-28,1616886000.0
18140,27,0,2021-03-29,10033,3147,392731,144158,2021-03-29,1616972400.0
18141,27,0,2021-03-30,12974,3633,405705,147791,2021-03-30,1617058800.0
18142,27,0,2021-03-31,12844,3758,418549,151549,2021-03-31,1617145200.0
18143,27,0,2021-04-01,14555,3687,433104,155236,2021-04-01,1617231600.0
18144,27,0,2021-04-02,12954,3635,446058,158871,2021-04-02,1617318000.0
18145,27,0,2021-04-03,4481,1020,450539,159891,2021-04-03,1617404400.0
18146,27,0,2021-04-04,70,33,450609,159924,2021-04-04,1617490800.0
18147,27,0,2021-04-05,345,1,450954,159925,2021-04-05,1617577200.0
18148,27,0,2021-04-06,9564,5795,460518,165720,2021-04-06,1617663600.0
18149,27,0,2021-04-07,10199,6048,470717,171768,2021-04-07,1617750000.0
18150,27,0,2021-04-08,15735,5493,486452,177261,2021-04-08,1617836400.0
18151,27,0,2021-04-09,17853,5301,504305,182562,2021-04-09,1617922800.0
18152,27,0,2021-04-10,6073,1751,510378,184313,2021-04-10,1618009200.0
18153,27,0,2021-04-11,422,74,510800,184387,2021-04-11,1618095600.0
18154,27,0,2021-04-12,9070,6451,519870,190838,2021-04-12,1618185600.0
18155,27,0,2021-04-13,11744,8033,531614,198871,2021-04-13,1618272000.0
18156,27,0,2021-04-14,10296,7335,541910,206206,2021-04-14,1618358400.0
18157,27,0,2021-04-15,12961,7103,554871,213309,2021-04-15,1618444800.0
18158,27,0,2021-04-16,12763,5887,567634,219196,2021-04-16,1618531200.0
18159,27,0,2021-04-17,5923,2747,573557,221943,2021-04-17,1618617600.0
18160,27,0,2021-04-18,357,170,573914,222113,2021-04-18,1618704000.0
18161,27,0,2021-04-19,6968,8556,580882,230669,2021-04-19,1618790400.0
18162,27,0,2021-04-20,8482,10186,589364,240855,2021-04-20,1618876800.0
18163,27,0,2021-04-21,8340,9689,597704,250544,2021-04-21,1618963200.0
18164,27,0,2021-04-22,9854,10938,607558,261482,2021-04-22,1619049600.0
18165,27,0,2021-04-23,11344,9686,618902,271168,2021-04-23,1619136000.0
18166,27,0,2021-04-24,5172,3749,624074,274917,2021-04-24,1619222400.0
18167,27,0,2021-04-25,440,269,624514,275186,2021-04-25,1619308800.0
18168,27,0,2021-04-26,9540,8291,634054,283477,2021-04-26,1619395200.0
18169,27,0,2021-04-27,13460,9338,647514,292815,2021-04-27,1619481600.0
18170,27,0,2021-04-28,14194,9280,661708,302095,2021-04-28,1619568000.0
18171,27,0,2021-04-29,17873,9563,679581,311658,2021-04-29,1619654400.0
18172,27,0,2021-04-30,18733,7533,698314,319191,2021-04-30,1619740800.0
18173,27,0,2021-05-01,5428,1122,703742,320313,2021-05-01,1619827200.0
18174,27,0,2021-05-02,604,28,704346,320341,2021-05-02,1619913600.0
18175,27,0,2021-05-03,14907,5260,719253,325601,2021-05-03,1620000000.0
18176,27,0,2021-05-04,13946,9495,733199,335096,2021-05-04,1620086400.0
18177,27,0,2021-05-05,15559,8823,748758,343919,2021-05-05,1620172800.0
18178,27,0,2021-05-06,18276,10633,767034,354552,2021-05-06,1620259200.0
18179,27,0,2021-05-07,17216,9861,784250,364413,2021-05-07,1620345600.0
18180,27,0,2021-05-08,5949,1040,790199,365453,2021-05-08,1620432000.0
18181,27,0,2021-05-09,533,402,790732,365855,2021-05-09,1620518400.0
18182,27,0,2021-05-10,15280,8596,806012,374451,2021-05-10,1620604800.0
18183,27,0,2021-05-11,20754,11009,826766,385460,2021-05-11,1620691200.0
18184,27,0,2021-05-12,19670,10094,846436,395554,2021-05-12,1620777600.0
18185,27,0,2021-05-13,12298,1168,858734,396722,2021-05-13,1620864000.0
18186,27,0,2021-05-14,22928,6622,881662,403344,2021-05-14,1620950400.0
18187,27,0,2021-05-15,15419,2478,897081,405822,2021-05-15,1621036800.0
18188,27,0,2021-05-16,1892,89,898973,405911,2021-05-16,1621123200.0
18189,27,0,2021-05-17,18965,5392,917938,411303,2021-05-17,1621206000.0
18190,27,0,2021-05-18,20696,7566,938634,418869,2021-05-18,1621292400.0
18191,27,0,2021-05-19,22253,5532,960887,424401,2021-05-19,1621378800.0
18192,27,0,2021-05-20,23236,6181,984123,430582,2021-05-20,1621465200.0
18193,27,0,2021-05-21,21166,7931,1005289,438513,2021-05-21,1621551600.0
18194,27,0,2021-05-22,8284,2742,1013573,441255,2021-05-22,1621638000.0
18195,27,0,2021-05-23,913,218,1014486,441473,2021-05-23,1621724400.0
18196,27,0,2021-05-24,4244,759,1018730,442232,2021-05-24,1621810800.0
18197,27,0,2021-05-25,14968,10166,1033698,452398,2021-05-25,1621897200.0
18198,27,0,2021-05-26,15435,9065,1049133,461463,2021-05-26,1621983600.0
18199,27,0,2021-05-27,18408,9597,1067541,471060,2021-05-27,1622070000.0
18200,27,0,2021-05-28,16078,11618,1083619,482678,2021-05-28,1622156400.0
18201,27,0,2021-05-29,6814,4172,1090433,486850,2021-05-29,1622242800.0
18202,27,0,2021-05-30,393,198,1090826,487048,2021-05-30,1622329200.0
18203,27,0,2021-05-31,13309,9412,1104135,496460,2021-05-31,1622415600.0
18204,27,0,2021-06-01,16548,11121,1120683,507581,2021-06-01,1622502000.0
18205,27,0,2021-06-02,16165,9582,1136848,517163,2021-06-02,1622588400.0
18206,27,0,2021-06-03,17739,9542,1154587,526705,2021-06-03,1622674800.0
18207,27,0,2021-06-04,16183,12332,1170770,539037,2021-06-04,1622761200.0
18208,27,0,2021-06-05,8345,5679,1179115,544716,2021-06-05,1622847600.0
18209,27,0,2021-06-06,1722,467,1180837,545183,2021-06-06,1622934000.0
18210,27,0,2021-06-07,17433,11191,1198270,556374,2021-06-07,1623020400.0
18211,27,0,2021-06-08,19685,13128,1217955,569502,2021-06-08,1623106800.0
18212,27,0,2021-06-09,19056,10515,1237011,580017,2021-06-09,1623193200.0
18213,27,0,2021-06-10,19020,11606,1256031,591623,2021-06-10,1623279600.0
18214,27,0,2021-06-11,18117,14773,1274148,606396,2021-06-11,1623366000.0
18215,27,0,2021-06-12,9473,6720,1283621,613116,2021-06-12,1623452400.0
18216,27,0,2021-06-13,953,795,1284574,613911,2021-06-13,1623538800.0
18217,27,0,2021-06-14,11056,15667,1295630,629578,2021-06-14,1623625200.0
18218,27,0,2021-06-15,14132,15822,1309762,645400,2021-06-15,1623711600.0
18219,27,0,2021-06-16,14686,13845,1324448,659245,2021-06-16,1623798000.0
18220,27,0,2021-06-17,15155,15294,1339603,674539,2021-06-17,1623884400.0
18221,27,0,2021-06-18,14782,18178,1354385,692717,2021-06-18,1623970800.0
18222,27,0,2021-06-19,7669,7630,1362054,700347,2021-06-19,1624057200.0
18223,27,0,2021-06-20,172,420,1362226,700767,2021-06-20,1624143600.0
18224,27,0,2021-06-21,7761,17947,1369987,718714,2021-06-21,1624230000.0
18225,27,0,2021-06-22,9557,22825,1379544,741539,2021-06-22,1624316400.0
18226,27,0,2021-06-23,11258,17781,1390802,759320,2021-06-23,1624402800.0
18227,27,0,2021-06-24,10503,16380,1401305,775700,2021-06-24,1624489200.0
18228,27,0,2021-06-25,9351,25410,1410656,801110,2021-06-25,1624575600.0
18229,27,0,2021-06-26,5074,14977,1415730,816087,2021-06-26,1624662000.0
18230,27,0,2021-06-27,663,1803,1416393,817890,2021-06-27,1624748400.0
18231,27,0,2021-06-28,6237,20961,1422630,838851,2021-06-28,1624834800.0
18232,27,0,2021-06-29,7152,23356,1429782,862207,2021-06-29,1624921200.0
18233,27,0,2021-06-30,9015,21383,1438797,883590,2021-06-30,1625007600.0
18234,27,0,2021-07-01,9183,20878,1447980,904468,2021-07-01,1625094000.0
18235,27,0,2021-07-02,10580,19067,1458560,923535,2021-07-02,1625180400.0
18236,27,0,2021-07-03,4605,8523,1463165,932058,2021-07-03,1625266800.0
18237,27,0,2021-07-04,520,977,1463685,933035,2021-07-04,1625353200.0
18238,27,0,2021-07-05,8661,16272,1472346,949307,2021-07-05,1625439600.0
18239,27,0,2021-07-06,8950,19829,1481296,969136,2021-07-06,1625526000.0
18240,28,0,2020-12-27,0,0,0,0,2020-12-27,1609023600.0
18241,28,0,2020-12-28,1,0,1,0,2020-12-28,1609110000.0
18242,28,0,2020-12-29,2,0,3,0,2020-12-29,1609196400.0
18243,28,0,2020-12-30,0,0,3,0,2020-12-30,1609282800.0
18244,28,0,2020-12-31,1,0,4,0,2020-12-31,1609369200.0
18245,28,0,2021-01-01,1,0,5,0,2021-01-01,1609455600.0
18246,28,0,2021-01-02,1,0,6,0,2021-01-02,1609542000.0
18247,28,0,2021-01-03,1,0,7,0,2021-01-03,1609628400.0
18248,28,0,2021-01-04,16,0,23,0,2021-01-04,1609714800.0
18249,28,0,2021-01-05,169,0,192,0,2021-01-05,1609801200.0
18250,28,0,2021-01-06,1393,0,1585,0,2021-01-06,1609887600.0
18251,28,0,2021-01-07,2600,0,4185,0,2021-01-07,1609974000.0
18252,28,0,2021-01-08,3428,0,7613,0,2021-01-08,1610060400.0
18253,28,0,2021-01-09,1333,0,8946,0,2021-01-09,1610146800.0
18254,28,0,2021-01-10,705,0,9651,0,2021-01-10,1610233200.0
18255,28,0,2021-01-11,3178,0,12829,0,2021-01-11,1610319600.0
18256,28,0,2021-01-12,3977,0,16806,0,2021-01-12,1610406000.0
18257,28,0,2021-01-13,4302,0,21108,0,2021-01-13,1610492400.0
18258,28,0,2021-01-14,8098,0,29206,0,2021-01-14,1610578800.0
18259,28,0,2021-01-15,6218,0,35424,0,2021-01-15,1610665200.0
18260,28,0,2021-01-16,2087,8,37511,8,2021-01-16,1610751600.0
18261,28,0,2021-01-17,4073,16,41584,24,2021-01-17,1610838000.0
18262,28,0,2021-01-18,8785,8,50369,32,2021-01-18,1610924400.0
18263,28,0,2021-01-19,7142,2,57511,34,2021-01-19,1611010800.0
18264,28,0,2021-01-20,6509,4,64020,38,2021-01-20,1611097200.0
18265,28,0,2021-01-21,5992,3,70012,41,2021-01-21,1611183600.0
18266,28,0,2021-01-22,5440,7,75452,48,2021-01-22,1611270000.0
18267,28,0,2021-01-23,2019,6,77471,54,2021-01-23,1611356400.0
18268,28,0,2021-01-24,1447,11,78918,65,2021-01-24,1611442800.0
18269,28,0,2021-01-25,6242,173,85160,238,2021-01-25,1611529200.0
18270,28,0,2021-01-26,4577,391,89737,629,2021-01-26,1611615600.0
18271,28,0,2021-01-27,4034,762,93771,1391,2021-01-27,1611702000.0
18272,28,0,2021-01-28,3755,1044,97526,2435,2021-01-28,1611788400.0
18273,28,0,2021-01-29,3489,1298,101015,3733,2021-01-29,1611874800.0
18274,28,0,2021-01-30,1386,516,102401,4249,2021-01-30,1611961200.0
18275,28,0,2021-01-31,195,124,102596,4373,2021-01-31,1612047600.0
18276,28,0,2021-02-01,2782,1659,105378,6032,2021-02-01,1612134000.0
18277,28,0,2021-02-02,2985,2388,108363,8420,2021-02-02,1612220400.0
18278,28,0,2021-02-03,2948,2665,111311,11085,2021-02-03,1612306800.0
18279,28,0,2021-02-04,3726,5199,115037,16284,2021-02-04,1612393200.0
18280,28,0,2021-02-05,3887,4380,118924,20664,2021-02-05,1612479600.0
18281,28,0,2021-02-06,1140,1546,120064,22210,2021-02-06,1612566000.0
18282,28,0,2021-02-07,715,1971,120779,24181,2021-02-07,1612652400.0
18283,28,0,2021-02-08,3802,6841,124581,31022,2021-02-08,1612738800.0
18284,28,0,2021-02-09,3461,6004,128042,37026,2021-02-09,1612825200.0
18285,28,0,2021-02-10,3454,5049,131496,42075,2021-02-10,1612911600.0
18286,28,0,2021-02-11,4211,4848,135707,46923,2021-02-11,1612998000.0
18287,28,0,2021-02-12,4042,4579,139749,51502,2021-02-12,1613084400.0
18288,28,0,2021-02-13,1124,1570,140873,53072,2021-02-13,1613170800.0
18289,28,0,2021-02-14,285,1385,141158,54457,2021-02-14,1613257200.0
18290,28,0,2021-02-15,2211,6248,143369,60705,2021-02-15,1613343600.0
18291,28,0,2021-02-16,2655,5617,146024,66322,2021-02-16,1613430000.0
18292,28,0,2021-02-17,1949,4549,147973,70871,2021-02-17,1613516400.0
18293,28,0,2021-02-18,2569,4255,150542,75126,2021-02-18,1613602800.0
18294,28,0,2021-02-19,2548,3660,153090,78786,2021-02-19,1613689200.0
18295,28,0,2021-02-20,945,1253,154035,80039,2021-02-20,1613775600.0
18296,28,0,2021-02-21,103,416,154138,80455,2021-02-21,1613862000.0
18297,28,0,2021-02-22,1666,4175,155804,84630,2021-02-22,1613948400.0
18298,28,0,2021-02-23,2171,3804,157975,88434,2021-02-23,1614034800.0
18299,28,0,2021-02-24,2372,3869,160347,92303,2021-02-24,1614121200.0
18300,28,0,2021-02-25,4772,4129,165119,96432,2021-02-25,1614207600.0
18301,28,0,2021-02-26,5961,3663,171080,100095,2021-02-26,1614294000.0
18302,28,0,2021-02-27,3008,1011,174088,101106,2021-02-27,1614380400.0
18303,28,0,2021-02-28,340,383,174428,101489,2021-02-28,1614466800.0
18304,28,0,2021-03-01,2526,4624,176954,106113,2021-03-01,1614553200.0
18305,28,0,2021-03-02,3900,4043,180854,110156,2021-03-02,1614639600.0
18306,28,0,2021-03-03,4792,3452,185646,113608,2021-03-03,1614726000.0
18307,28,0,2021-03-04,7305,2799,192951,116407,2021-03-04,1614812400.0
18308,28,0,2021-03-05,10147,2352,203098,118759,2021-03-05,1614898800.0
18309,28,0,2021-03-06,9809,714,212907,119473,2021-03-06,1614985200.0
18310,28,0,2021-03-07,3772,117,216679,119590,2021-03-07,1615071600.0
18311,28,0,2021-03-08,5867,3224,222546,122814,2021-03-08,1615158000.0
18312,28,0,2021-03-09,9283,2727,231829,125541,2021-03-09,1615244400.0
18313,28,0,2021-03-10,9804,2369,241633,127910,2021-03-10,1615330800.0
18314,28,0,2021-03-11,13963,1904,255596,129814,2021-03-11,1615417200.0
18315,28,0,2021-03-12,17992,1381,273588,131195,2021-03-12,1615503600.0
18316,28,0,2021-03-13,11154,469,284742,131664,2021-03-13,1615590000.0
18317,28,0,2021-03-14,2259,80,287001,131744,2021-03-14,1615676400.0
18318,28,0,2021-03-15,8650,800,295651,132544,2021-03-15,1615762800.0
18319,28,0,2021-03-16,7489,1143,303140,133687,2021-03-16,1615849200.0
18320,28,0,2021-03-17,7719,1124,310859,134811,2021-03-17,1615935600.0
18321,28,0,2021-03-18,8165,1301,319024,136112,2021-03-18,1616022000.0
18322,28,0,2021-03-19,11563,1321,330587,137433,2021-03-19,1616108400.0
18323,28,0,2021-03-20,9670,449,340257,137882,2021-03-20,1616194800.0
18324,28,0,2021-03-21,2410,7,342667,137889,2021-03-21,1616281200.0
18325,28,0,2021-03-22,9385,1489,352052,139378,2021-03-22,1616367600.0
18326,28,0,2021-03-23,12484,1347,364536,140725,2021-03-23,1616454000.0
18327,28,0,2021-03-24,13257,1428,377793,142153,2021-03-24,1616540400.0
18328,28,0,2021-03-25,17618,1599,395411,143752,2021-03-25,1616626800.0
18329,28,0,2021-03-26,20828,1635,416239,145387,2021-03-26,1616713200.0
18330,28,0,2021-03-27,11498,986,427737,146373,2021-03-27,1616799600.0
18331,28,0,2021-03-28,2966,50,430703,146423,2021-03-28,1616886000.0
18332,28,0,2021-03-29,11771,2789,442474,149212,2021-03-29,1616972400.0
18333,28,0,2021-03-30,14419,2817,456893,152029,2021-03-30,1617058800.0
18334,28,0,2021-03-31,14394,3155,471287,155184,2021-03-31,1617145200.0
18335,28,0,2021-04-01,18037,5082,489324,160266,2021-04-01,1617231600.0
18336,28,0,2021-04-02,16813,6001,506137,166267,2021-04-02,1617318000.0
18337,28,0,2021-04-03,7004,3845,513141,170112,2021-04-03,1617404400.0
18338,28,0,2021-04-04,1778,766,514919,170878,2021-04-04,1617490800.0
18339,28,0,2021-04-05,3290,699,518209,171577,2021-04-05,1617577200.0
18340,28,0,2021-04-06,10813,7167,529022,178744,2021-04-06,1617663600.0
18341,28,0,2021-04-07,12693,6706,541715,185450,2021-04-07,1617750000.0
18342,28,0,2021-04-08,17674,7220,559389,192670,2021-04-08,1617836400.0
18343,28,0,2021-04-09,23821,7434,583210,200104,2021-04-09,1617922800.0
18344,28,0,2021-04-10,13841,3913,597051,204017,2021-04-10,1618009200.0
18345,28,0,2021-04-11,3028,1130,600079,205147,2021-04-11,1618095600.0
18346,28,0,2021-04-12,13787,7755,613866,212902,2021-04-12,1618185600.0
18347,28,0,2021-04-13,16183,7743,630049,220645,2021-04-13,1618272000.0
18348,28,0,2021-04-14,14320,7686,644369,228331,2021-04-14,1618358400.0
18349,28,0,2021-04-15,17224,8009,661593,236340,2021-04-15,1618444800.0
18350,28,0,2021-04-16,20280,7362,681873,243702,2021-04-16,1618531200.0
18351,28,0,2021-04-17,12748,4718,694621,248420,2021-04-17,1618617600.0
18352,28,0,2021-04-18,2289,1148,696910,249568,2021-04-18,1618704000.0
18353,28,0,2021-04-19,10867,8604,707777,258172,2021-04-19,1618790400.0
18354,28,0,2021-04-20,13901,9411,721678,267583,2021-04-20,1618876800.0
18355,28,0,2021-04-21,13282,9641,734960,277224,2021-04-21,1618963200.0
18356,28,0,2021-04-22,15294,11480,750254,288704,2021-04-22,1619049600.0
18357,28,0,2021-04-23,16435,11687,766689,300391,2021-04-23,1619136000.0
18358,28,0,2021-04-24,12585,6788,779274,307179,2021-04-24,1619222400.0
18359,28,0,2021-04-25,3293,1821,782567,309000,2021-04-25,1619308800.0
18360,28,0,2021-04-26,12539,9617,795106,318617,2021-04-26,1619395200.0
18361,28,0,2021-04-27,14865,10679,809971,329296,2021-04-27,1619481600.0
18362,28,0,2021-04-28,15045,9708,825016,339004,2021-04-28,1619568000.0
18363,28,0,2021-04-29,18451,10252,843467,349256,2021-04-29,1619654400.0
18364,28,0,2021-04-30,20390,9966,863857,359222,2021-04-30,1619740800.0
18365,28,0,2021-05-01,12809,2419,876666,361641,2021-05-01,1619827200.0
18366,28,0,2021-05-02,5991,1636,882657,363277,2021-05-02,1619913600.0
18367,28,0,2021-05-03,12856,9314,895513,372591,2021-05-03,1620000000.0
18368,28,0,2021-05-04,13817,12076,909330,384667,2021-05-04,1620086400.0
18369,28,0,2021-05-05,13944,13654,923274,398321,2021-05-05,1620172800.0
18370,28,0,2021-05-06,18313,13726,941587,412047,2021-05-06,1620259200.0
18371,28,0,2021-05-07,17837,15406,959424,427453,2021-05-07,1620345600.0
18372,28,0,2021-05-08,12628,4210,972052,431663,2021-05-08,1620432000.0
18373,28,0,2021-05-09,7151,1548,979203,433211,2021-05-09,1620518400.0
18374,28,0,2021-05-10,14204,13847,993407,447058,2021-05-10,1620604800.0
18375,28,0,2021-05-11,18107,13876,1011514,460934,2021-05-11,1620691200.0
18376,28,0,2021-05-12,18791,12744,1030305,473678,2021-05-12,1620777600.0
18377,28,0,2021-05-13,19679,2953,1049984,476631,2021-05-13,1620864000.0
18378,28,0,2021-05-14,26359,10883,1076343,487514,2021-05-14,1620950400.0
18379,28,0,2021-05-15,26941,5851,1103284,493365,2021-05-15,1621036800.0
18380,28,0,2021-05-16,14144,978,1117428,494343,2021-05-16,1621123200.0
18381,28,0,2021-05-17,16218,8591,1133646,502934,2021-05-17,1621206000.0
18382,28,0,2021-05-18,21091,7504,1154737,510438,2021-05-18,1621292400.0
18383,28,0,2021-05-19,20913,7352,1175650,517790,2021-05-19,1621378800.0
18384,28,0,2021-05-20,23144,8131,1198794,525921,2021-05-20,1621465200.0
18385,28,0,2021-05-21,21449,10299,1220243,536220,2021-05-21,1621551600.0
18386,28,0,2021-05-22,17599,4909,1237842,541129,2021-05-22,1621638000.0
18387,28,0,2021-05-23,9137,561,1246979,541690,2021-05-23,1621724400.0
18388,28,0,2021-05-24,13434,2495,1260413,544185,2021-05-24,1621810800.0
18389,28,0,2021-05-25,19193,10242,1279606,554427,2021-05-25,1621897200.0
18390,28,0,2021-05-26,19391,8615,1298997,563042,2021-05-26,1621983600.0
18391,28,0,2021-05-27,21743,10196,1320740,573238,2021-05-27,1622070000.0
18392,28,0,2021-05-28,21612,13696,1342352,586934,2021-05-28,1622156400.0
18393,28,0,2021-05-29,17560,8686,1359912,595620,2021-05-29,1622242800.0
18394,28,0,2021-05-30,6273,906,1366185,596526,2021-05-30,1622329200.0
18395,28,0,2021-05-31,19867,10353,1386052,606879,2021-05-31,1622415600.0
18396,28,0,2021-06-01,23732,11553,1409784,618432,2021-06-01,1622502000.0
18397,28,0,2021-06-02,20816,10442,1430600,628874,2021-06-02,1622588400.0
18398,28,0,2021-06-03,26451,12341,1457051,641215,2021-06-03,1622674800.0
18399,28,0,2021-06-04,24582,16108,1481633,657323,2021-06-04,1622761200.0
18400,28,0,2021-06-05,18359,10458,1499992,667781,2021-06-05,1622847600.0
18401,28,0,2021-06-06,7674,1952,1507666,669733,2021-06-06,1622934000.0
18402,28,0,2021-06-07,19227,12523,1526893,682256,2021-06-07,1623020400.0
18403,28,0,2021-06-08,22637,13385,1549530,695641,2021-06-08,1623106800.0
18404,28,0,2021-06-09,19747,12907,1569277,708548,2021-06-09,1623193200.0
18405,28,0,2021-06-10,21206,12740,1590483,721288,2021-06-10,1623279600.0
18406,28,0,2021-06-11,21017,18891,1611500,740179,2021-06-11,1623366000.0
18407,28,0,2021-06-12,17912,15775,1629412,755954,2021-06-12,1623452400.0
18408,28,0,2021-06-13,6341,5464,1635753,761418,2021-06-13,1623538800.0
18409,28,0,2021-06-14,13888,16554,1649641,777972,2021-06-14,1623625200.0
18410,28,0,2021-06-15,16209,17127,1665850,795099,2021-06-15,1623711600.0
18411,28,0,2021-06-16,16680,17134,1682530,812233,2021-06-16,1623798000.0
18412,28,0,2021-06-17,17229,18661,1699759,830894,2021-06-17,1623884400.0
18413,28,0,2021-06-18,18507,22430,1718266,853324,2021-06-18,1623970800.0
18414,28,0,2021-06-19,14790,14582,1733056,867906,2021-06-19,1624057200.0
18415,28,0,2021-06-20,4981,4741,1738037,872647,2021-06-20,1624143600.0
18416,28,0,2021-06-21,11293,19669,1749330,892316,2021-06-21,1624230000.0
18417,28,0,2021-06-22,12729,22317,1762059,914633,2021-06-22,1624316400.0
18418,28,0,2021-06-23,11894,22313,1773953,936946,2021-06-23,1624402800.0
18419,28,0,2021-06-24,12637,22794,1786590,959740,2021-06-24,1624489200.0
18420,28,0,2021-06-25,12460,27669,1799050,987409,2021-06-25,1624575600.0
18421,28,0,2021-06-26,9212,22254,1808262,1009663,2021-06-26,1624662000.0
18422,28,0,2021-06-27,2906,9803,1811168,1019466,2021-06-27,1624748400.0
18423,28,0,2021-06-28,8285,21912,1819453,1041378,2021-06-28,1624834800.0
18424,28,0,2021-06-29,9800,24721,1829253,1066099,2021-06-29,1624921200.0
18425,28,0,2021-06-30,11114,22806,1840367,1088905,2021-06-30,1625007600.0
18426,28,0,2021-07-01,12150,21942,1852517,1110847,2021-07-01,1625094000.0
18427,28,0,2021-07-02,11059,27808,1863576,1138655,2021-07-02,1625180400.0
18428,28,0,2021-07-03,8083,19998,1871659,1158653,2021-07-03,1625266800.0
18429,28,0,2021-07-04,2907,8762,1874566,1167415,2021-07-04,1625353200.0
18430,28,0,2021-07-05,8418,21554,1882984,1188969,2021-07-05,1625439600.0
18431,28,0,2021-07-06,9725,25347,1892709,1214316,2021-07-06,1625526000.0
18432,32,0,2020-12-27,1,0,1,0,2020-12-27,1609023600.0
18433,32,0,2020-12-28,27,0,28,0,2020-12-28,1609110000.0
18434,32,0,2020-12-29,12,0,40,0,2020-12-29,1609196400.0
18435,32,0,2020-12-30,0,0,40,0,2020-12-30,1609282800.0
18436,32,0,2020-12-31,0,0,40,0,2020-12-31,1609369200.0
18437,32,0,2021-01-01,1,0,41,0,2021-01-01,1609455600.0
18438,32,0,2021-01-02,6,0,47,0,2021-01-02,1609542000.0
18439,32,0,2021-01-03,4,0,51,0,2021-01-03,1609628400.0
18440,32,0,2021-01-04,82,0,133,0,2021-01-04,1609714800.0
18441,32,0,2021-01-05,300,0,433,0,2021-01-05,1609801200.0
18442,32,0,2021-01-06,788,0,1221,0,2021-01-06,1609887600.0
18443,32,0,2021-01-07,2430,0,3651,0,2021-01-07,1609974000.0
18444,32,0,2021-01-08,3167,0,6818,0,2021-01-08,1610060400.0
18445,32,0,2021-01-09,957,0,7775,0,2021-01-09,1610146800.0
18446,32,0,2021-01-10,641,0,8416,0,2021-01-10,1610233200.0
18447,32,0,2021-01-11,3269,0,11685,0,2021-01-11,1610319600.0
18448,32,0,2021-01-12,5023,0,16708,0,2021-01-12,1610406000.0
18449,32,0,2021-01-13,4943,0,21651,0,2021-01-13,1610492400.0
18450,32,0,2021-01-14,5723,0,27374,0,2021-01-14,1610578800.0
18451,32,0,2021-01-15,5228,0,32602,0,2021-01-15,1610665200.0
18452,32,0,2021-01-16,1637,8,34239,8,2021-01-16,1610751600.0
18453,32,0,2021-01-17,860,2,35099,10,2021-01-17,1610838000.0
18454,32,0,2021-01-18,7234,16,42333,26,2021-01-18,1610924400.0
18455,32,0,2021-01-19,9901,26,52234,52,2021-01-19,1611010800.0
18456,32,0,2021-01-20,10369,15,62603,67,2021-01-20,1611097200.0
18457,32,0,2021-01-21,12717,29,75320,96,2021-01-21,1611183600.0
18458,32,0,2021-01-22,9883,11,85203,107,2021-01-22,1611270000.0
18459,32,0,2021-01-23,3412,1,88615,108,2021-01-23,1611356400.0
18460,32,0,2021-01-24,1119,2,89734,110,2021-01-24,1611442800.0
18461,32,0,2021-01-25,6867,68,96601,178,2021-01-25,1611529200.0
18462,32,0,2021-01-26,7447,163,104048,341,2021-01-26,1611615600.0
18463,32,0,2021-01-27,4837,506,108885,847,2021-01-27,1611702000.0
18464,32,0,2021-01-28,8598,1668,117483,2515,2021-01-28,1611788400.0
18465,32,0,2021-01-29,5385,1835,122868,4350,2021-01-29,1611874800.0
18466,32,0,2021-01-30,534,413,123402,4763,2021-01-30,1611961200.0
18467,32,0,2021-01-31,67,74,123469,4837,2021-01-31,1612047600.0
18468,32,0,2021-02-01,192,1814,123661,6651,2021-02-01,1612134000.0
18469,32,0,2021-02-02,787,3159,124448,9810,2021-02-02,1612220400.0
18470,32,0,2021-02-03,4076,3176,128524,12986,2021-02-03,1612306800.0
18471,32,0,2021-02-04,3687,3601,132211,16587,2021-02-04,1612393200.0
18472,32,0,2021-02-05,1962,3264,134173,19851,2021-02-05,1612479600.0
18473,32,0,2021-02-06,517,873,134690,20724,2021-02-06,1612566000.0
18474,32,0,2021-02-07,541,80,135231,20804,2021-02-07,1612652400.0
18475,32,0,2021-02-08,1865,3664,137096,24468,2021-02-08,1612738800.0
18476,32,0,2021-02-09,2550,4343,139646,28811,2021-02-09,1612825200.0
18477,32,0,2021-02-10,2984,5307,142630,34118,2021-02-10,1612911600.0
18478,32,0,2021-02-11,4781,6135,147411,40253,2021-02-11,1612998000.0
18479,32,0,2021-02-12,5093,4557,152504,44810,2021-02-12,1613084400.0
18480,32,0,2021-02-13,939,1891,153443,46701,2021-02-13,1613170800.0
18481,32,0,2021-02-14,116,710,153559,47411,2021-02-14,1613257200.0
18482,32,0,2021-02-15,3614,6871,157173,54282,2021-02-15,1613343600.0
18483,32,0,2021-02-16,4028,8191,161201,62473,2021-02-16,1613430000.0
18484,32,0,2021-02-17,4304,8623,165505,71096,2021-02-17,1613516400.0
18485,32,0,2021-02-18,7040,11289,172545,82385,2021-02-18,1613602800.0
18486,32,0,2021-02-19,7084,8181,179629,90566,2021-02-19,1613689200.0
18487,32,0,2021-02-20,2518,2982,182147,93548,2021-02-20,1613775600.0
18488,32,0,2021-02-21,434,484,182581,94032,2021-02-21,1613862000.0
18489,32,0,2021-02-22,3262,5292,185843,99324,2021-02-22,1613948400.0
18490,32,0,2021-02-23,5505,5854,191348,105178,2021-02-23,1614034800.0
18491,32,0,2021-02-24,7445,5975,198793,111153,2021-02-24,1614121200.0
18492,32,0,2021-02-25,12833,4836,211626,115989,2021-02-25,1614207600.0
18493,32,0,2021-02-26,12545,2673,224171,118662,2021-02-26,1614294000.0
18494,32,0,2021-02-27,6493,201,230664,118863,2021-02-27,1614380400.0
18495,32,0,2021-02-28,364,131,231028,118994,2021-02-28,1614466800.0
18496,32,0,2021-03-01,7247,787,238275,119781,2021-03-01,1614553200.0
18497,32,0,2021-03-02,10963,837,249238,120618,2021-03-02,1614639600.0
18498,32,0,2021-03-03,11998,1550,261236,122168,2021-03-03,1614726000.0
18499,32,0,2021-03-04,15106,2185,276342,124353,2021-03-04,1614812400.0
18500,32,0,2021-03-05,17129,1800,293471,126153,2021-03-05,1614898800.0
18501,32,0,2021-03-06,28100,718,321571,126871,2021-03-06,1614985200.0
18502,32,0,2021-03-07,19862,274,341433,127145,2021-03-07,1615071600.0
18503,32,0,2021-03-08,8927,2427,350360,129572,2021-03-08,1615158000.0
18504,32,0,2021-03-09,14298,3058,364658,132630,2021-03-09,1615244400.0
18505,32,0,2021-03-10,15774,2942,380432,135572,2021-03-10,1615330800.0
18506,32,0,2021-03-11,20926,4284,401358,139856,2021-03-11,1615417200.0
18507,32,0,2021-03-12,26071,3673,427429,143529,2021-03-12,1615503600.0
18508,32,0,2021-03-13,41628,1474,469057,145003,2021-03-13,1615590000.0
18509,32,0,2021-03-14,20099,328,489156,145331,2021-03-14,1615676400.0
18510,32,0,2021-03-15,13056,3259,502212,148590,2021-03-15,1615762800.0
18511,32,0,2021-03-16,9790,3318,512002,151908,2021-03-16,1615849200.0
18512,32,0,2021-03-17,9714,3920,521716,155828,2021-03-17,1615935600.0
18513,32,0,2021-03-18,10017,4773,531733,160601,2021-03-18,1616022000.0
18514,32,0,2021-03-19,17948,3436,549681,164037,2021-03-19,1616108400.0
18515,32,0,2021-03-20,36504,1267,586185,165304,2021-03-20,1616194800.0
18516,32,0,2021-03-21,19840,329,606025,165633,2021-03-21,1616281200.0
18517,32,0,2021-03-22,12153,3974,618178,169607,2021-03-22,1616367600.0
18518,32,0,2021-03-23,18930,5444,637108,175051,2021-03-23,1616454000.0
18519,32,0,2021-03-24,17930,5648,655038,180699,2021-03-24,1616540400.0
18520,32,0,2021-03-25,25304,5021,680342,185720,2021-03-25,1616626800.0
18521,32,0,2021-03-26,28989,5099,709331,190819,2021-03-26,1616713200.0
18522,32,0,2021-03-27,36684,1191,746015,192010,2021-03-27,1616799600.0
18523,32,0,2021-03-28,18646,137,764661,192147,2021-03-28,1616886000.0
18524,32,0,2021-03-29,14577,6612,779238,198759,2021-03-29,1616972400.0
18525,32,0,2021-03-30,18876,8106,798114,206865,2021-03-30,1617058800.0
18526,32,0,2021-03-31,15796,8738,813910,215603,2021-03-31,1617145200.0
18527,32,0,2021-04-01,18226,10348,832136,225951,2021-04-01,1617231600.0
18528,32,0,2021-04-02,19976,11923,852112,237874,2021-04-02,1617318000.0
18529,32,0,2021-04-03,30032,9171,882144,247045,2021-04-03,1617404400.0
18530,32,0,2021-04-04,11654,4334,893798,251379,2021-04-04,1617490800.0
18531,32,0,2021-04-05,9598,2012,903396,253391,2021-04-05,1617577200.0
18532,32,0,2021-04-06,14273,10309,917669,263700,2021-04-06,1617663600.0
18533,32,0,2021-04-07,18083,11640,935752,275340,2021-04-07,1617750000.0
18534,32,0,2021-04-08,23514,11824,959266,287164,2021-04-08,1617836400.0
18535,32,0,2021-04-09,29955,11896,989221,299060,2021-04-09,1617922800.0
18536,32,0,2021-04-10,26172,17822,1015393,316882,2021-04-10,1618009200.0
18537,32,0,2021-04-11,9150,11609,1024543,328491,2021-04-11,1618095600.0
18538,32,0,2021-04-12,15397,8887,1039940,337378,2021-04-12,1618185600.0
18539,32,0,2021-04-13,21794,10647,1061734,348025,2021-04-13,1618272000.0
18540,32,0,2021-04-14,22492,10198,1084226,358223,2021-04-14,1618358400.0
18541,32,0,2021-04-15,25740,9936,1109966,368159,2021-04-15,1618444800.0
18542,32,0,2021-04-16,25320,11331,1135286,379490,2021-04-16,1618531200.0
18543,32,0,2021-04-17,17994,22148,1153280,401638,2021-04-17,1618617600.0
18544,32,0,2021-04-18,6391,13677,1159671,415315,2021-04-18,1618704000.0
18545,32,0,2021-04-19,11659,9213,1171330,424528,2021-04-19,1618790400.0
18546,32,0,2021-04-20,16413,11566,1187743,436094,2021-04-20,1618876800.0
18547,32,0,2021-04-21,15787,11753,1203530,447847,2021-04-21,1618963200.0
18548,32,0,2021-04-22,19031,13903,1222561,461750,2021-04-22,1619049600.0
18549,32,0,2021-04-23,19646,14953,1242207,476703,2021-04-23,1619136000.0
18550,32,0,2021-04-24,15461,20051,1257668,496754,2021-04-24,1619222400.0
18551,32,0,2021-04-25,6962,11869,1264630,508623,2021-04-25,1619308800.0
18552,32,0,2021-04-26,13211,9652,1277841,518275,2021-04-26,1619395200.0
18553,32,0,2021-04-27,18692,11987,1296533,530262,2021-04-27,1619481600.0
18554,32,0,2021-04-28,20192,13688,1316725,543950,2021-04-28,1619568000.0
18555,32,0,2021-04-29,22402,17102,1339127,561052,2021-04-29,1619654400.0
18556,32,0,2021-04-30,25009,18049,1364136,579101,2021-04-30,1619740800.0
18557,32,0,2021-05-01,23037,12212,1387173,591313,2021-05-01,1619827200.0
18558,32,0,2021-05-02,20948,9091,1408121,600404,2021-05-02,1619913600.0
18559,32,0,2021-05-03,21931,9595,1430052,609999,2021-05-03,1620000000.0
18560,32,0,2021-05-04,23845,14036,1453897,624035,2021-05-04,1620086400.0
18561,32,0,2021-05-05,23943,15493,1477840,639528,2021-05-05,1620172800.0
18562,32,0,2021-05-06,25727,17241,1503567,656769,2021-05-06,1620259200.0
18563,32,0,2021-05-07,30732,17482,1534299,674251,2021-05-07,1620345600.0
18564,32,0,2021-05-08,34591,6757,1568890,681008,2021-05-08,1620432000.0
18565,32,0,2021-05-09,26800,4874,1595690,685882,2021-05-09,1620518400.0
18566,32,0,2021-05-10,24218,13679,1619908,699561,2021-05-10,1620604800.0
18567,32,0,2021-05-11,31304,15740,1651212,715301,2021-05-11,1620691200.0
18568,32,0,2021-05-12,37282,15402,1688494,730703,2021-05-12,1620777600.0
18569,32,0,2021-05-13,40527,4688,1729021,735391,2021-05-13,1620864000.0
18570,32,0,2021-05-14,41784,11007,1770805,746398,2021-05-14,1620950400.0
18571,32,0,2021-05-15,59655,7698,1830460,754096,2021-05-15,1621036800.0
18572,32,0,2021-05-16,47882,1721,1878342,755817,2021-05-16,1621123200.0
18573,32,0,2021-05-17,31465,8084,1909807,763901,2021-05-17,1621206000.0
18574,32,0,2021-05-18,36826,9085,1946633,772986,2021-05-18,1621292400.0
18575,32,0,2021-05-19,38849,8090,1985482,781076,2021-05-19,1621378800.0
18576,32,0,2021-05-20,39800,11029,2025282,792105,2021-05-20,1621465200.0
18577,32,0,2021-05-21,42395,12465,2067677,804570,2021-05-21,1621551600.0
18578,32,0,2021-05-22,57874,8326,2125551,812896,2021-05-22,1621638000.0
18579,32,0,2021-05-23,38984,1499,2164535,814395,2021-05-23,1621724400.0
18580,32,0,2021-05-24,28531,1515,2193066,815910,2021-05-24,1621810800.0
18581,32,0,2021-05-25,31192,11627,2224258,827537,2021-05-25,1621897200.0
18582,32,0,2021-05-26,34217,13458,2258475,840995,2021-05-26,1621983600.0
18583,32,0,2021-05-27,34692,16703,2293167,857698,2021-05-27,1622070000.0
18584,32,0,2021-05-28,34307,19687,2327474,877385,2021-05-28,1622156400.0
18585,32,0,2021-05-29,37441,15343,2364915,892728,2021-05-29,1622242800.0
18586,32,0,2021-05-30,16105,2114,2381020,894842,2021-05-30,1622329200.0
18587,32,0,2021-05-31,27899,13078,2408919,907920,2021-05-31,1622415600.0
18588,32,0,2021-06-01,32770,19564,2441689,927484,2021-06-01,1622502000.0
18589,32,0,2021-06-02,32260,17502,2473949,944986,2021-06-02,1622588400.0
18590,32,0,2021-06-03,34347,20462,2508296,965448,2021-06-03,1622674800.0
18591,32,0,2021-06-04,35902,22621,2544198,988069,2021-06-04,1622761200.0
18592,32,0,2021-06-05,34403,18778,2578601,1006847,2021-06-05,1622847600.0
18593,32,0,2021-06-06,16528,4184,2595129,1011031,2021-06-06,1622934000.0
18594,32,0,2021-06-07,21179,16705,2616308,1027736,2021-06-07,1623020400.0
18595,32,0,2021-06-08,26305,20613,2642613,1048349,2021-06-08,1623106800.0
18596,32,0,2021-06-09,24370,20877,2666983,1069226,2021-06-09,1623193200.0
18597,32,0,2021-06-10,24973,22574,2691956,1091800,2021-06-10,1623279600.0
18598,32,0,2021-06-11,26335,31772,2718291,1123572,2021-06-11,1623366000.0
18599,32,0,2021-06-12,25978,28033,2744269,1151605,2021-06-12,1623452400.0
18600,32,0,2021-06-13,11805,13425,2756074,1165030,2021-06-13,1623538800.0
18601,32,0,2021-06-14,13226,26069,2769300,1191099,2021-06-14,1623625200.0
18602,32,0,2021-06-15,19599,31731,2788899,1222830,2021-06-15,1623711600.0
18603,32,0,2021-06-16,20495,29550,2809394,1252380,2021-06-16,1623798000.0
18604,32,0,2021-06-17,21400,31766,2830794,1284146,2021-06-17,1623884400.0
18605,32,0,2021-06-18,21556,39141,2852350,1323287,2021-06-18,1623970800.0
18606,32,0,2021-06-19,22588,40709,2874938,1363996,2021-06-19,1624057200.0
18607,32,0,2021-06-20,9216,17872,2884154,1381868,2021-06-20,1624143600.0
18608,32,0,2021-06-21,11372,33013,2895526,1414881,2021-06-21,1624230000.0
18609,32,0,2021-06-22,13681,39267,2909207,1454148,2021-06-22,1624316400.0
18610,32,0,2021-06-23,14330,40988,2923537,1495136,2021-06-23,1624402800.0
18611,32,0,2021-06-24,15328,42744,2938865,1537880,2021-06-24,1624489200.0
18612,32,0,2021-06-25,14745,50299,2953610,1588179,2021-06-25,1624575600.0
18613,32,0,2021-06-26,14988,56698,2968598,1644877,2021-06-26,1624662000.0
18614,32,0,2021-06-27,7458,32376,2976056,1677253,2021-06-27,1624748400.0
18615,32,0,2021-06-28,10362,37000,2986418,1714253,2021-06-28,1624834800.0
18616,32,0,2021-06-29,13176,42228,2999594,1756481,2021-06-29,1624921200.0
18617,32,0,2021-06-30,14920,41084,3014514,1797565,2021-06-30,1625007600.0
18618,32,0,2021-07-01,15552,41306,3030066,1838871,2021-07-01,1625094000.0
18619,32,0,2021-07-02,16284,48303,3046350,1887174,2021-07-02,1625180400.0
18620,32,0,2021-07-03,13133,57032,3059483,1944206,2021-07-03,1625266800.0
18621,32,0,2021-07-04,7790,30202,3067273,1974408,2021-07-04,1625353200.0
18622,32,0,2021-07-05,11135,33200,3078408,2007608,2021-07-05,1625439600.0
18623,32,0,2021-07-06,14787,36962,3093195,2044570,2021-07-06,1625526000.0
18624,44,0,2020-12-27,0,0,0,0,2020-12-27,1609023600.0
18625,44,0,2020-12-28,0,0,0,0,2020-12-28,1609110000.0
18626,44,0,2020-12-29,0,0,0,0,2020-12-29,1609196400.0
18627,44,0,2020-12-30,1,0,1,0,2020-12-30,1609282800.0
18628,44,0,2020-12-31,11,0,12,0,2020-12-31,1609369200.0
18629,44,0,2021-01-01,2,0,14,0,2021-01-01,1609455600.0
18630,44,0,2021-01-02,3,0,17,0,2021-01-02,1609542000.0
18631,44,0,2021-01-03,3,0,20,0,2021-01-03,1609628400.0
18632,44,0,2021-01-04,243,0,263,0,2021-01-04,1609714800.0
18633,44,0,2021-01-05,773,0,1036,0,2021-01-05,1609801200.0
18634,44,0,2021-01-06,1246,0,2282,0,2021-01-06,1609887600.0
18635,44,0,2021-01-07,2426,0,4708,0,2021-01-07,1609974000.0
18636,44,0,2021-01-08,3135,0,7843,0,2021-01-08,1610060400.0
18637,44,0,2021-01-09,945,0,8788,0,2021-01-09,1610146800.0
18638,44,0,2021-01-10,241,0,9029,0,2021-01-10,1610233200.0
18639,44,0,2021-01-11,2990,0,12019,0,2021-01-11,1610319600.0
18640,44,0,2021-01-12,5279,0,17298,0,2021-01-12,1610406000.0
18641,44,0,2021-01-13,7668,0,24966,0,2021-01-13,1610492400.0
18642,44,0,2021-01-14,9556,0,34522,0,2021-01-14,1610578800.0
18643,44,0,2021-01-15,6709,0,41231,0,2021-01-15,1610665200.0
18644,44,0,2021-01-16,1918,7,43149,7,2021-01-16,1610751600.0
18645,44,0,2021-01-17,902,1,44051,8,2021-01-17,1610838000.0
18646,44,0,2021-01-18,8722,4,52773,12,2021-01-18,1610924400.0
18647,44,0,2021-01-19,10670,2,63443,14,2021-01-19,1611010800.0
18648,44,0,2021-01-20,11030,8,74473,22,2021-01-20,1611097200.0
18649,44,0,2021-01-21,11734,2,86207,24,2021-01-21,1611183600.0
18650,44,0,2021-01-22,9636,6,95843,30,2021-01-22,1611270000.0
18651,44,0,2021-01-23,3287,15,99130,45,2021-01-23,1611356400.0
18652,44,0,2021-01-24,1569,1,100699,46,2021-01-24,1611442800.0
18653,44,0,2021-01-25,6683,286,107382,332,2021-01-25,1611529200.0
18654,44,0,2021-01-26,5644,415,113026,747,2021-01-26,1611615600.0
18655,44,0,2021-01-27,7380,575,120406,1322,2021-01-27,1611702000.0
18656,44,0,2021-01-28,8831,1221,129237,2543,2021-01-28,1611788400.0
18657,44,0,2021-01-29,6760,1780,135997,4323,2021-01-29,1611874800.0
18658,44,0,2021-01-30,2549,489,138546,4812,2021-01-30,1611961200.0
18659,44,0,2021-01-31,1252,53,139798,4865,2021-01-31,1612047600.0
18660,44,0,2021-02-01,6386,2361,146184,7226,2021-02-01,1612134000.0
18661,44,0,2021-02-02,6214,3789,152398,11015,2021-02-02,1612220400.0
18662,44,0,2021-02-03,5602,4527,158000,15542,2021-02-03,1612306800.0
18663,44,0,2021-02-04,6455,6937,164455,22479,2021-02-04,1612393200.0
18664,44,0,2021-02-05,6392,5210,170847,27689,2021-02-05,1612479600.0
18665,44,0,2021-02-06,1971,1204,172818,28893,2021-02-06,1612566000.0
18666,44,0,2021-02-07,406,591,173224,29484,2021-02-07,1612652400.0
18667,44,0,2021-02-08,3825,4435,177049,33919,2021-02-08,1612738800.0
18668,44,0,2021-02-09,5720,5769,182769,39688,2021-02-09,1612825200.0
18669,44,0,2021-02-10,6252,5955,189021,45643,2021-02-10,1612911600.0
18670,44,0,2021-02-11,7063,6454,196084,52097,2021-02-11,1612998000.0
18671,44,0,2021-02-12,7277,5455,203361,57552,2021-02-12,1613084400.0
18672,44,0,2021-02-13,2545,1239,205906,58791,2021-02-13,1613170800.0
18673,44,0,2021-02-14,1612,815,207518,59606,2021-02-14,1613257200.0
18674,44,0,2021-02-15,4005,7144,211523,66750,2021-02-15,1613343600.0
18675,44,0,2021-02-16,4564,7907,216087,74657,2021-02-16,1613430000.0
18676,44,0,2021-02-17,4711,8454,220798,83111,2021-02-17,1613516400.0
18677,44,0,2021-02-18,6071,9161,226869,92272,2021-02-18,1613602800.0
18678,44,0,2021-02-19,5546,7406,232415,99678,2021-02-19,1613689200.0
18679,44,0,2021-02-20,2339,2815,234754,102493,2021-02-20,1613775600.0
18680,44,0,2021-02-21,542,1387,235296,103880,2021-02-21,1613862000.0
18681,44,0,2021-02-22,4487,6967,239783,110847,2021-02-22,1613948400.0
18682,44,0,2021-02-23,6030,7155,245813,118002,2021-02-23,1614034800.0
18683,44,0,2021-02-24,6603,5799,252416,123801,2021-02-24,1614121200.0
18684,44,0,2021-02-25,10543,7328,262959,131129,2021-02-25,1614207600.0
18685,44,0,2021-02-26,12376,6093,275335,137222,2021-02-26,1614294000.0
18686,44,0,2021-02-27,7890,2061,283225,139283,2021-02-27,1614380400.0
18687,44,0,2021-02-28,2118,498,285343,139781,2021-02-28,1614466800.0
18688,44,0,2021-03-01,6080,4579,291423,144360,2021-03-01,1614553200.0
18689,44,0,2021-03-02,9394,5539,300817,149899,2021-03-02,1614639600.0
18690,44,0,2021-03-03,11272,5384,312089,155283,2021-03-03,1614726000.0
18691,44,0,2021-03-04,13266,5530,325355,160813,2021-03-04,1614812400.0
18692,44,0,2021-03-05,17894,5335,343249,166148,2021-03-05,1614898800.0
18693,44,0,2021-03-06,21368,1795,364617,167943,2021-03-06,1614985200.0
18694,44,0,2021-03-07,12203,552,376820,168495,2021-03-07,1615071600.0
18695,44,0,2021-03-08,9417,4071,386237,172566,2021-03-08,1615158000.0
18696,44,0,2021-03-09,15199,4668,401436,177234,2021-03-09,1615244400.0
18697,44,0,2021-03-10,16603,4917,418039,182151,2021-03-10,1615330800.0
18698,44,0,2021-03-11,20355,5272,438394,187423,2021-03-11,1615417200.0
18699,44,0,2021-03-12,26814,5012,465208,192435,2021-03-12,1615503600.0
18700,44,0,2021-03-13,24221,2018,489429,194453,2021-03-13,1615590000.0
18701,44,0,2021-03-14,6765,741,496194,195194,2021-03-14,1615676400.0
18702,44,0,2021-03-15,12957,3208,509151,198402,2021-03-15,1615762800.0
18703,44,0,2021-03-16,12837,3713,521988,202115,2021-03-16,1615849200.0
18704,44,0,2021-03-17,14195,3325,536183,205440,2021-03-17,1615935600.0
18705,44,0,2021-03-18,15410,3418,551593,208858,2021-03-18,1616022000.0
18706,44,0,2021-03-19,21415,3373,573008,212231,2021-03-19,1616108400.0
18707,44,0,2021-03-20,15565,1674,588573,213905,2021-03-20,1616194800.0
18708,44,0,2021-03-21,4619,218,593192,214123,2021-03-21,1616281200.0
18709,44,0,2021-03-22,12523,3595,605715,217718,2021-03-22,1616367600.0
18710,44,0,2021-03-23,19446,4618,625161,222336,2021-03-23,1616454000.0
18711,44,0,2021-03-24,22048,4610,647209,226946,2021-03-24,1616540400.0
18712,44,0,2021-03-25,28206,5050,675415,231996,2021-03-25,1616626800.0
18713,44,0,2021-03-26,30552,4654,705967,236650,2021-03-26,1616713200.0
18714,44,0,2021-03-27,16231,4256,722198,240906,2021-03-27,1616799600.0
18715,44,0,2021-03-28,4079,1892,726277,242798,2021-03-28,1616886000.0
18716,44,0,2021-03-29,14308,5642,740585,248440,2021-03-29,1616972400.0
18717,44,0,2021-03-30,21417,7115,762002,255555,2021-03-30,1617058800.0
18718,44,0,2021-03-31,20126,7293,782128,262848,2021-03-31,1617145200.0
18719,44,0,2021-04-01,23570,8392,805698,271240,2021-04-01,1617231600.0
18720,44,0,2021-04-02,16238,6282,821936,277522,2021-04-02,1617318000.0
18721,44,0,2021-04-03,10189,5514,832125,283036,2021-04-03,1617404400.0
18722,44,0,2021-04-04,3133,1588,835258,284624,2021-04-04,1617490800.0
18723,44,0,2021-04-05,4425,1304,839683,285928,2021-04-05,1617577200.0
18724,44,0,2021-04-06,13422,10034,853105,295962,2021-04-06,1617663600.0
18725,44,0,2021-04-07,17669,11331,870774,307293,2021-04-07,1617750000.0
18726,44,0,2021-04-08,26024,11057,896798,318350,2021-04-08,1617836400.0
18727,44,0,2021-04-09,32269,11431,929067,329781,2021-04-09,1617922800.0
18728,44,0,2021-04-10,18273,9398,947340,339179,2021-04-10,1618009200.0
18729,44,0,2021-04-11,3030,5810,950370,344989,2021-04-11,1618095600.0
18730,44,0,2021-04-12,16955,10573,967325,355562,2021-04-12,1618185600.0
18731,44,0,2021-04-13,21987,12873,989312,368435,2021-04-13,1618272000.0
18732,44,0,2021-04-14,23125,12913,1012437,381348,2021-04-14,1618358400.0
18733,44,0,2021-04-15,26292,14071,1038729,395419,2021-04-15,1618444800.0
18734,44,0,2021-04-16,28121,14002,1066850,409421,2021-04-16,1618531200.0
18735,44,0,2021-04-17,19827,8343,1086677,417764,2021-04-17,1618617600.0
18736,44,0,2021-04-18,5053,4430,1091730,422194,2021-04-18,1618704000.0
18737,44,0,2021-04-19,16928,10933,1108658,433127,2021-04-19,1618790400.0
18738,44,0,2021-04-20,19109,13353,1127767,446480,2021-04-20,1618876800.0
18739,44,0,2021-04-21,21144,13930,1148911,460410,2021-04-21,1618963200.0
18740,44,0,2021-04-22,23704,14702,1172615,475112,2021-04-22,1619049600.0
18741,44,0,2021-04-23,27811,15057,1200426,490169,2021-04-23,1619136000.0
18742,44,0,2021-04-24,16977,8431,1217403,498600,2021-04-24,1619222400.0
18743,44,0,2021-04-25,4826,3337,1222229,501937,2021-04-25,1619308800.0
18744,44,0,2021-04-26,16710,11184,1238939,513121,2021-04-26,1619395200.0
18745,44,0,2021-04-27,21161,13079,1260100,526200,2021-04-27,1619481600.0
18746,44,0,2021-04-28,23812,12805,1283912,539005,2021-04-28,1619568000.0
18747,44,0,2021-04-29,28157,14057,1312069,553062,2021-04-29,1619654400.0
18748,44,0,2021-04-30,33113,12328,1345182,565390,2021-04-30,1619740800.0
18749,44,0,2021-05-01,14850,5941,1360032,571331,2021-05-01,1619827200.0
18750,44,0,2021-05-02,7903,3477,1367935,574808,2021-05-02,1619913600.0
18751,44,0,2021-05-03,24009,10553,1391944,585361,2021-05-03,1620000000.0
18752,44,0,2021-05-04,26968,15064,1418912,600425,2021-05-04,1620086400.0
18753,44,0,2021-05-05,30810,16883,1449722,617308,2021-05-05,1620172800.0
18754,44,0,2021-05-06,37982,17708,1487704,635016,2021-05-06,1620259200.0
18755,44,0,2021-05-07,36132,20788,1523836,655804,2021-05-07,1620345600.0
18756,44,0,2021-05-08,19566,5424,1543402,661228,2021-05-08,1620432000.0
18757,44,0,2021-05-09,11304,2222,1554706,663450,2021-05-09,1620518400.0
18758,44,0,2021-05-10,24494,18765,1579200,682215,2021-05-10,1620604800.0
18759,44,0,2021-05-11,34419,19986,1613619,702201,2021-05-11,1620691200.0
18760,44,0,2021-05-12,37111,20812,1650730,723013,2021-05-12,1620777600.0
18761,44,0,2021-05-13,27880,4563,1678610,727576,2021-05-13,1620864000.0
18762,44,0,2021-05-14,44202,15521,1722812,743097,2021-05-14,1620950400.0
18763,44,0,2021-05-15,34027,11639,1756839,754736,2021-05-15,1621036800.0
18764,44,0,2021-05-16,15604,2521,1772443,757257,2021-05-16,1621123200.0
18765,44,0,2021-05-17,27202,12540,1799645,769797,2021-05-17,1621206000.0
18766,44,0,2021-05-18,35276,12469,1834921,782266,2021-05-18,1621292400.0
18767,44,0,2021-05-19,36918,13387,1871839,795653,2021-05-19,1621378800.0
18768,44,0,2021-05-20,40933,12948,1912772,808601,2021-05-20,1621465200.0
18769,44,0,2021-05-21,42905,16925,1955677,825526,2021-05-21,1621551600.0
18770,44,0,2021-05-22,27763,9336,1983440,834862,2021-05-22,1621638000.0
18771,44,0,2021-05-23,8691,1083,1992131,835945,2021-05-23,1621724400.0
18772,44,0,2021-05-24,17961,3393,2010092,839338,2021-05-24,1621810800.0
18773,44,0,2021-05-25,30456,14941,2040548,854279,2021-05-25,1621897200.0
18774,44,0,2021-05-26,32547,16565,2073095,870844,2021-05-26,1621983600.0
18775,44,0,2021-05-27,34570,16963,2107665,887807,2021-05-27,1622070000.0
18776,44,0,2021-05-28,37544,22598,2145209,910405,2021-05-28,1622156400.0
18777,44,0,2021-05-29,26786,16826,2171995,927231,2021-05-29,1622242800.0
18778,44,0,2021-05-30,6125,3616,2178120,930847,2021-05-30,1622329200.0
18779,44,0,2021-05-31,27029,16619,2205149,947466,2021-05-31,1622415600.0
18780,44,0,2021-06-01,31548,19061,2236697,966527,2021-06-01,1622502000.0
18781,44,0,2021-06-02,33590,19138,2270287,985665,2021-06-02,1622588400.0
18782,44,0,2021-06-03,34584,21071,2304871,1006736,2021-06-03,1622674800.0
18783,44,0,2021-06-04,39970,27332,2344841,1034068,2021-06-04,1622761200.0
18784,44,0,2021-06-05,23058,17255,2367899,1051323,2021-06-05,1622847600.0
18785,44,0,2021-06-06,8325,3643,2376224,1054966,2021-06-06,1622934000.0
18786,44,0,2021-06-07,28121,19172,2404345,1074138,2021-06-07,1623020400.0
18787,44,0,2021-06-08,33079,22809,2437424,1096947,2021-06-08,1623106800.0
18788,44,0,2021-06-09,35630,20945,2473054,1117892,2021-06-09,1623193200.0
18789,44,0,2021-06-10,34573,21517,2507627,1139409,2021-06-10,1623279600.0
18790,44,0,2021-06-11,32343,31206,2539970,1170615,2021-06-11,1623366000.0
18791,44,0,2021-06-12,25693,20389,2565663,1191004,2021-06-12,1623452400.0
18792,44,0,2021-06-13,6772,5304,2572435,1196308,2021-06-13,1623538800.0
18793,44,0,2021-06-14,17608,27353,2590043,1223661,2021-06-14,1623625200.0
18794,44,0,2021-06-15,23592,32074,2613635,1255735,2021-06-15,1623711600.0
18795,44,0,2021-06-16,24285,33640,2637920,1289375,2021-06-16,1623798000.0
18796,44,0,2021-06-17,23754,36125,2661674,1325500,2021-06-17,1623884400.0
18797,44,0,2021-06-18,26431,39449,2688105,1364949,2021-06-18,1623970800.0
18798,44,0,2021-06-19,21006,25732,2709111,1390681,2021-06-19,1624057200.0
18799,44,0,2021-06-20,3669,6070,2712780,1396751,2021-06-20,1624143600.0
18800,44,0,2021-06-21,14786,32186,2727566,1428937,2021-06-21,1624230000.0
18801,44,0,2021-06-22,15428,39303,2742994,1468240,2021-06-22,1624316400.0
18802,44,0,2021-06-23,20063,38547,2763057,1506787,2021-06-23,1624402800.0
18803,44,0,2021-06-24,16538,31785,2779595,1538572,2021-06-24,1624489200.0
18804,44,0,2021-06-25,18886,46473,2798481,1585045,2021-06-25,1624575600.0
18805,44,0,2021-06-26,14146,35277,2812627,1620322,2021-06-26,1624662000.0
18806,44,0,2021-06-27,3415,11099,2816042,1631421,2021-06-27,1624748400.0
18807,44,0,2021-06-28,11379,35635,2827421,1667056,2021-06-28,1624834800.0
18808,44,0,2021-06-29,11884,39940,2839305,1706996,2021-06-29,1624921200.0
18809,44,0,2021-06-30,14680,41109,2853985,1748105,2021-06-30,1625007600.0
18810,44,0,2021-07-01,15341,36672,2869326,1784777,2021-07-01,1625094000.0
18811,44,0,2021-07-02,16235,48396,2885561,1833173,2021-07-02,1625180400.0
18812,44,0,2021-07-03,13146,28979,2898707,1862152,2021-07-03,1625266800.0
18813,44,0,2021-07-04,3088,8218,2901795,1870370,2021-07-04,1625353200.0
18814,44,0,2021-07-05,10191,34688,2911986,1905058,2021-07-05,1625439600.0
18815,44,0,2021-07-06,13188,36870,2925174,1941928,2021-07-06,1625526000.0
18816,52,0,2020-12-27,0,0,0,0,2020-12-27,1609023600.0
18817,52,0,2020-12-28,2,0,2,0,2020-12-28,1609110000.0
18818,52,0,2020-12-29,0,0,2,0,2020-12-29,1609196400.0
18819,52,0,2020-12-30,0,0,2,0,2020-12-30,1609282800.0
18820,52,0,2020-12-31,0,0,2,0,2020-12-31,1609369200.0
18821,52,0,2021-01-01,5,0,7,0,2021-01-01,1609455600.0
18822,52,0,2021-01-02,1,0,8,0,2021-01-02,1609542000.0
18823,52,0,2021-01-03,1,0,9,0,2021-01-03,1609628400.0
18824,52,0,2021-01-04,34,0,43,0,2021-01-04,1609714800.0
18825,52,0,2021-01-05,168,0,211,0,2021-01-05,1609801200.0
18826,52,0,2021-01-06,384,0,595,0,2021-01-06,1609887600.0
18827,52,0,2021-01-07,964,0,1559,0,2021-01-07,1609974000.0
18828,52,0,2021-01-08,1664,0,3223,0,2021-01-08,1610060400.0
18829,52,0,2021-01-09,1049,0,4272,0,2021-01-09,1610146800.0
18830,52,0,2021-01-10,643,0,4915,0,2021-01-10,1610233200.0
18831,52,0,2021-01-11,2197,0,7112,0,2021-01-11,1610319600.0
18832,52,0,2021-01-12,3170,0,10282,0,2021-01-12,1610406000.0
18833,52,0,2021-01-13,2983,0,13265,0,2021-01-13,1610492400.0
18834,52,0,2021-01-14,3304,0,16569,0,2021-01-14,1610578800.0
18835,52,0,2021-01-15,3016,0,19585,0,2021-01-15,1610665200.0
18836,52,0,2021-01-16,896,3,20481,3,2021-01-16,1610751600.0
18837,52,0,2021-01-17,499,3,20980,6,2021-01-17,1610838000.0
18838,52,0,2021-01-18,3199,5,24179,11,2021-01-18,1610924400.0
18839,52,0,2021-01-19,6556,4,30735,15,2021-01-19,1611010800.0
18840,52,0,2021-01-20,8340,6,39075,21,2021-01-20,1611097200.0
18841,52,0,2021-01-21,12172,3,51247,24,2021-01-21,1611183600.0
18842,52,0,2021-01-22,7273,21,58520,45,2021-01-22,1611270000.0
18843,52,0,2021-01-23,1678,3,60198,48,2021-01-23,1611356400.0
18844,52,0,2021-01-24,174,0,60372,48,2021-01-24,1611442800.0
18845,52,0,2021-01-25,3006,9,63378,57,2021-01-25,1611529200.0
18846,52,0,2021-01-26,6738,148,70116,205,2021-01-26,1611615600.0
18847,52,0,2021-01-27,7285,143,77401,348,2021-01-27,1611702000.0
18848,52,0,2021-01-28,9728,456,87129,804,2021-01-28,1611788400.0
18849,52,0,2021-01-29,5956,903,93085,1707,2021-01-29,1611874800.0
18850,52,0,2021-01-30,1259,271,94344,1978,2021-01-30,1611961200.0
18851,52,0,2021-01-31,79,314,94423,2292,2021-01-31,1612047600.0
18852,52,0,2021-02-01,2521,1189,96944,3481,2021-02-01,1612134000.0
18853,52,0,2021-02-02,2970,1857,99914,5338,2021-02-02,1612220400.0
18854,52,0,2021-02-03,2686,2159,102600,7497,2021-02-03,1612306800.0
18855,52,0,2021-02-04,2963,2110,105563,9607,2021-02-04,1612393200.0
18856,52,0,2021-02-05,2964,2203,108527,11810,2021-02-05,1612479600.0
18857,52,0,2021-02-06,1076,661,109603,12471,2021-02-06,1612566000.0
18858,52,0,2021-02-07,151,294,109754,12765,2021-02-07,1612652400.0
18859,52,0,2021-02-08,1929,2108,111683,14873,2021-02-08,1612738800.0
18860,52,0,2021-02-09,3174,3698,114857,18571,2021-02-09,1612825200.0
18861,52,0,2021-02-10,3322,4746,118179,23317,2021-02-10,1612911600.0
18862,52,0,2021-02-11,6100,9258,124279,32575,2021-02-11,1612998000.0
18863,52,0,2021-02-12,4704,5121,128983,37696,2021-02-12,1613084400.0
18864,52,0,2021-02-13,1150,1238,130133,38934,2021-02-13,1613170800.0
18865,52,0,2021-02-14,22,541,130155,39475,2021-02-14,1613257200.0
18866,52,0,2021-02-15,2028,3514,132183,42989,2021-02-15,1613343600.0
18867,52,0,2021-02-16,4121,6703,136304,49692,2021-02-16,1613430000.0
18868,52,0,2021-02-17,3876,6918,140180,56610,2021-02-17,1613516400.0
18869,52,0,2021-02-18,6140,9229,146320,65839,2021-02-18,1613602800.0
18870,52,0,2021-02-19,5332,5767,151652,71606,2021-02-19,1613689200.0
18871,52,0,2021-02-20,1028,1468,152680,73074,2021-02-20,1613775600.0
18872,52,0,2021-02-21,7,274,152687,73348,2021-02-21,1613862000.0
18873,52,0,2021-02-22,2647,3464,155334,76812,2021-02-22,1613948400.0
18874,52,0,2021-02-23,3425,3679,158759,80491,2021-02-23,1614034800.0
18875,52,0,2021-02-24,3304,3018,162063,83509,2021-02-24,1614121200.0
18876,52,0,2021-02-25,6344,3162,168407,86671,2021-02-25,1614207600.0
18877,52,0,2021-02-26,6214,2874,174621,89545,2021-02-26,1614294000.0
18878,52,0,2021-02-27,2216,1037,176837,90582,2021-02-27,1614380400.0
18879,52,0,2021-02-28,76,87,176913,90669,2021-02-28,1614466800.0
18880,52,0,2021-03-01,3114,2307,180027,92976,2021-03-01,1614553200.0
18881,52,0,2021-03-02,4723,3404,184750,96380,2021-03-02,1614639600.0
18882,52,0,2021-03-03,5282,3369,190032,99749,2021-03-03,1614726000.0
18883,52,0,2021-03-04,7795,4690,197827,104439,2021-03-04,1614812400.0
18884,52,0,2021-03-05,9008,3821,206835,108260,2021-03-05,1614898800.0
18885,52,0,2021-03-06,5637,1095,212472,109355,2021-03-06,1614985200.0
18886,52,0,2021-03-07,2661,105,215133,109460,2021-03-07,1615071600.0
18887,52,0,2021-03-08,5845,2366,220978,111826,2021-03-08,1615158000.0
18888,52,0,2021-03-09,9546,3227,230524,115053,2021-03-09,1615244400.0
18889,52,0,2021-03-10,9387,3313,239911,118366,2021-03-10,1615330800.0
18890,52,0,2021-03-11,13574,4905,253485,123271,2021-03-11,1615417200.0
18891,52,0,2021-03-12,15331,3612,268816,126883,2021-03-12,1615503600.0
18892,52,0,2021-03-13,8287,700,277103,127583,2021-03-13,1615590000.0
18893,52,0,2021-03-14,624,72,277727,127655,2021-03-14,1615676400.0
18894,52,0,2021-03-15,8832,1827,286559,129482,2021-03-15,1615762800.0
18895,52,0,2021-03-16,7574,2544,294133,132026,2021-03-16,1615849200.0
18896,52,0,2021-03-17,6457,2337,300590,134363,2021-03-17,1615935600.0
18897,52,0,2021-03-18,8304,2403,308894,136766,2021-03-18,1616022000.0
18898,52,0,2021-03-19,11891,2007,320785,138773,2021-03-19,1616108400.0
18899,52,0,2021-03-20,7087,696,327872,139469,2021-03-20,1616194800.0
18900,52,0,2021-03-21,1689,26,329561,139495,2021-03-21,1616281200.0
18901,52,0,2021-03-22,9013,1933,338574,141428,2021-03-22,1616367600.0
18902,52,0,2021-03-23,13180,2426,351754,143854,2021-03-23,1616454000.0
18903,52,0,2021-03-24,13257,1918,365011,145772,2021-03-24,1616540400.0
18904,52,0,2021-03-25,18198,2612,383209,148384,2021-03-25,1616626800.0
18905,52,0,2021-03-26,18934,2163,402143,150547,2021-03-26,1616713200.0
18906,52,0,2021-03-27,7552,583,409695,151130,2021-03-27,1616799600.0
18907,52,0,2021-03-28,2194,53,411889,151183,2021-03-28,1616886000.0
18908,52,0,2021-03-29,10971,2620,422860,153803,2021-03-29,1616972400.0
18909,52,0,2021-03-30,15680,3396,438540,157199,2021-03-30,1617058800.0
18910,52,0,2021-03-31,13693,3031,452233,160230,2021-03-31,1617145200.0
18911,52,0,2021-04-01,18870,3371,471103,163601,2021-04-01,1617231600.0
18912,52,0,2021-04-02,17086,3227,488189,166828,2021-04-02,1617318000.0
18913,52,0,2021-04-03,5516,1161,493705,167989,2021-04-03,1617404400.0
18914,52,0,2021-04-04,1324,43,495029,168032,2021-04-04,1617490800.0
18915,52,0,2021-04-05,1787,508,496816,168540,2021-04-05,1617577200.0
18916,52,0,2021-04-06,11787,5073,508603,173613,2021-04-06,1617663600.0
18917,52,0,2021-04-07,15188,5403,523791,179016,2021-04-07,1617750000.0
18918,52,0,2021-04-08,21234,5994,545025,185010,2021-04-08,1617836400.0
18919,52,0,2021-04-09,26664,4829,571689,189839,2021-04-09,1617922800.0
18920,52,0,2021-04-10,10125,2221,581814,192060,2021-04-10,1618009200.0
18921,52,0,2021-04-11,2569,406,584383,192466,2021-04-11,1618095600.0
18922,52,0,2021-04-12,16339,6301,600722,198767,2021-04-12,1618185600.0
18923,52,0,2021-04-13,20739,7794,621461,206561,2021-04-13,1618272000.0
18924,52,0,2021-04-14,17656,6539,639117,213100,2021-04-14,1618358400.0
18925,52,0,2021-04-15,21155,7612,660272,220712,2021-04-15,1618444800.0
18926,52,0,2021-04-16,22588,7022,682860,227734,2021-04-16,1618531200.0
18927,52,0,2021-04-17,9981,2884,692841,230618,2021-04-17,1618617600.0
18928,52,0,2021-04-18,3037,1247,695878,231865,2021-04-18,1618704000.0
18929,52,0,2021-04-19,14174,7560,710052,239425,2021-04-19,1618790400.0
18930,52,0,2021-04-20,18265,9057,728317,248482,2021-04-20,1618876800.0
18931,52,0,2021-04-21,15982,8756,744299,257238,2021-04-21,1618963200.0
18932,52,0,2021-04-22,19421,9728,763720,266966,2021-04-22,1619049600.0
18933,52,0,2021-04-23,20521,9482,784241,276448,2021-04-23,1619136000.0
18934,52,0,2021-04-24,10022,4658,794263,281106,2021-04-24,1619222400.0
18935,52,0,2021-04-25,3979,1841,798242,282947,2021-04-25,1619308800.0
18936,52,0,2021-04-26,16825,9270,815067,292217,2021-04-26,1619395200.0
18937,52,0,2021-04-27,21061,11350,836128,303567,2021-04-27,1619481600.0
18938,52,0,2021-04-28,22755,9508,858883,313075,2021-04-28,1619568000.0
18939,52,0,2021-04-29,25001,10912,883884,323987,2021-04-29,1619654400.0
18940,52,0,2021-04-30,25640,10734,909524,334721,2021-04-30,1619740800.0
18941,52,0,2021-05-01,8619,2155,918143,336876,2021-05-01,1619827200.0
18942,52,0,2021-05-02,4300,1134,922443,338010,2021-05-02,1619913600.0
18943,52,0,2021-05-03,19066,9894,941509,347904,2021-05-03,1620000000.0
18944,52,0,2021-05-04,20076,13366,961585,361270,2021-05-04,1620086400.0
18945,52,0,2021-05-05,20852,11722,982437,372992,2021-05-05,1620172800.0
18946,52,0,2021-05-06,22465,12444,1004902,385436,2021-05-06,1620259200.0
18947,52,0,2021-05-07,20688,16253,1025590,401689,2021-05-07,1620345600.0
18948,52,0,2021-05-08,11227,1713,1036817,403402,2021-05-08,1620432000.0
18949,52,0,2021-05-09,5405,2067,1042222,405469,2021-05-09,1620518400.0
18950,52,0,2021-05-10,20781,16255,1063003,421724,2021-05-10,1620604800.0
18951,52,0,2021-05-11,24879,17887,1087882,439611,2021-05-11,1620691200.0
18952,52,0,2021-05-12,24815,15720,1112697,455331,2021-05-12,1620777600.0
18953,52,0,2021-05-13,18579,2144,1131276,457475,2021-05-13,1620864000.0
18954,52,0,2021-05-14,22748,11433,1154024,468908,2021-05-14,1620950400.0
18955,52,0,2021-05-15,15652,4547,1169676,473455,2021-05-15,1621036800.0
18956,52,0,2021-05-16,10290,832,1179966,474287,2021-05-16,1621123200.0
18957,52,0,2021-05-17,21127,13608,1201093,487895,2021-05-17,1621206000.0
18958,52,0,2021-05-18,24833,13543,1225926,501438,2021-05-18,1621292400.0
18959,52,0,2021-05-19,26821,10038,1252747,511476,2021-05-19,1621378800.0
18960,52,0,2021-05-20,29348,10303,1282095,521779,2021-05-20,1621465200.0
18961,52,0,2021-05-21,27367,11949,1309462,533728,2021-05-21,1621551600.0
18962,52,0,2021-05-22,15426,3955,1324888,537683,2021-05-22,1621638000.0
18963,52,0,2021-05-23,4480,976,1329368,538659,2021-05-23,1621724400.0
18964,52,0,2021-05-24,16027,2106,1345395,540765,2021-05-24,1621810800.0
18965,52,0,2021-05-25,24467,13034,1369862,553799,2021-05-25,1621897200.0
18966,52,0,2021-05-26,25244,11264,1395106,565063,2021-05-26,1621983600.0
18967,52,0,2021-05-27,29096,12618,1424202,577681,2021-05-27,1622070000.0
18968,52,0,2021-05-28,27931,14858,1452133,592539,2021-05-28,1622156400.0
18969,52,0,2021-05-29,18340,6470,1470473,599009,2021-05-29,1622242800.0
18970,52,0,2021-05-30,4230,1536,1474703,600545,2021-05-30,1622329200.0
18971,52,0,2021-05-31,24416,13972,1499119,614517,2021-05-31,1622415600.0
18972,52,0,2021-06-01,28820,15338,1527939,629855,2021-06-01,1622502000.0
18973,52,0,2021-06-02,27481,13135,1555420,642990,2021-06-02,1622588400.0
18974,52,0,2021-06-03,31729,13707,1587149,656697,2021-06-03,1622674800.0
18975,52,0,2021-06-04,29223,17942,1616372,674639,2021-06-04,1622761200.0
18976,52,0,2021-06-05,14541,10796,1630913,685435,2021-06-05,1622847600.0
18977,52,0,2021-06-06,4782,3280,1635695,688715,2021-06-06,1622934000.0
18978,52,0,2021-06-07,21718,19276,1657413,707991,2021-06-07,1623020400.0
18979,52,0,2021-06-08,26459,19891,1683872,727882,2021-06-08,1623106800.0
18980,52,0,2021-06-09,25660,16542,1709532,744424,2021-06-09,1623193200.0
18981,52,0,2021-06-10,28733,15222,1738265,759646,2021-06-10,1623279600.0
18982,52,0,2021-06-11,26963,21878,1765228,781524,2021-06-11,1623366000.0
18983,52,0,2021-06-12,14596,10729,1779824,792253,2021-06-12,1623452400.0
18984,52,0,2021-06-13,4385,4300,1784209,796553,2021-06-13,1623538800.0
18985,52,0,2021-06-14,17609,23941,1801818,820494,2021-06-14,1623625200.0
18986,52,0,2021-06-15,23701,23259,1825519,843753,2021-06-15,1623711600.0
18987,52,0,2021-06-16,23276,20553,1848795,864306,2021-06-16,1623798000.0
18988,52,0,2021-06-17,25907,20980,1874702,885286,2021-06-17,1623884400.0
18989,52,0,2021-06-18,23243,26643,1897945,911929,2021-06-18,1623970800.0
18990,52,0,2021-06-19,12437,13302,1910382,925231,2021-06-19,1624057200.0
18991,52,0,2021-06-20,3014,4262,1913396,929493,2021-06-20,1624143600.0
18992,52,0,2021-06-21,14817,27615,1928213,957108,2021-06-21,1624230000.0
18993,52,0,2021-06-22,17384,30224,1945597,987332,2021-06-22,1624316400.0
18994,52,0,2021-06-23,18407,25297,1964004,1012629,2021-06-23,1624402800.0
18995,52,0,2021-06-24,20983,22057,1984987,1034686,2021-06-24,1624489200.0
18996,52,0,2021-06-25,16636,29491,2001623,1064177,2021-06-25,1624575600.0
18997,52,0,2021-06-26,8437,17225,2010060,1081402,2021-06-26,1624662000.0
18998,52,0,2021-06-27,1336,7279,2011396,1088681,2021-06-27,1624748400.0
18999,52,0,2021-06-28,10617,29998,2022013,1118679,2021-06-28,1624834800.0
19000,52,0,2021-06-29,13436,32928,2035449,1151607,2021-06-29,1624921200.0
19001,52,0,2021-06-30,13658,27496,2049107,1179103,2021-06-30,1625007600.0
19002,52,0,2021-07-01,16000,27776,2065107,1206879,2021-07-01,1625094000.0
19003,52,0,2021-07-02,14761,32225,2079868,1239104,2021-07-02,1625180400.0
19004,52,0,2021-07-03,7266,18408,2087134,1257512,2021-07-03,1625266800.0
19005,52,0,2021-07-04,1695,5152,2088829,1262664,2021-07-04,1625353200.0
19006,52,0,2021-07-05,9554,30421,2098383,1293085,2021-07-05,1625439600.0
19007,52,0,2021-07-06,11505,33689,2109888,1326774,2021-07-06,1625526000.0
19008,53,0,2020-12-27,0,0,0,0,2020-12-27,1609023600.0
19009,53,0,2020-12-28,1,0,1,0,2020-12-28,1609110000.0
19010,53,0,2020-12-29,0,0,1,0,2020-12-29,1609196400.0
19011,53,0,2020-12-30,0,0,1,0,2020-12-30,1609282800.0
19012,53,0,2020-12-31,0,0,1,0,2020-12-31,1609369200.0
19013,53,0,2021-01-01,2,0,3,0,2021-01-01,1609455600.0
19014,53,0,2021-01-02,4,0,7,0,2021-01-02,1609542000.0
19015,53,0,2021-01-03,1,0,8,0,2021-01-03,1609628400.0
19016,53,0,2021-01-04,43,0,51,0,2021-01-04,1609714800.0
19017,53,0,2021-01-05,200,0,251,0,2021-01-05,1609801200.0
19018,53,0,2021-01-06,331,0,582,0,2021-01-06,1609887600.0
19019,53,0,2021-01-07,835,0,1417,0,2021-01-07,1609974000.0
19020,53,0,2021-01-08,1214,0,2631,0,2021-01-08,1610060400.0
19021,53,0,2021-01-09,34,0,2665,0,2021-01-09,1610146800.0
19022,53,0,2021-01-10,4,0,2669,0,2021-01-10,1610233200.0
19023,53,0,2021-01-11,1663,0,4332,0,2021-01-11,1610319600.0
19024,53,0,2021-01-12,3381,0,7713,0,2021-01-12,1610406000.0
19025,53,0,2021-01-13,3355,0,11068,0,2021-01-13,1610492400.0
19026,53,0,2021-01-14,3812,0,14880,0,2021-01-14,1610578800.0
19027,53,0,2021-01-15,3299,0,18179,0,2021-01-15,1610665200.0
19028,53,0,2021-01-16,684,3,18863,3,2021-01-16,1610751600.0
19029,53,0,2021-01-17,180,1,19043,4,2021-01-17,1610838000.0
19030,53,0,2021-01-18,3363,4,22406,8,2021-01-18,1610924400.0
19031,53,0,2021-01-19,8177,3,30583,11,2021-01-19,1611010800.0
19032,53,0,2021-01-20,7060,2,37643,13,2021-01-20,1611097200.0
19033,53,0,2021-01-21,11493,2,49136,15,2021-01-21,1611183600.0
19034,53,0,2021-01-22,7824,0,56960,15,2021-01-22,1611270000.0
19035,53,0,2021-01-23,1492,2,58452,17,2021-01-23,1611356400.0
19036,53,0,2021-01-24,255,1,58707,18,2021-01-24,1611442800.0
19037,53,0,2021-01-25,3056,34,61763,52,2021-01-25,1611529200.0
19038,53,0,2021-01-26,4115,231,65878,283,2021-01-26,1611615600.0
19039,53,0,2021-01-27,7238,319,73116,602,2021-01-27,1611702000.0
19040,53,0,2021-01-28,7135,634,80251,1236,2021-01-28,1611788400.0
19041,53,0,2021-01-29,4231,727,84482,1963,2021-01-29,1611874800.0
19042,53,0,2021-01-30,844,42,85326,2005,2021-01-30,1611961200.0
19043,53,0,2021-01-31,79,3,85405,2008,2021-01-31,1612047600.0
19044,53,0,2021-02-01,2211,1026,87616,3034,2021-02-01,1612134000.0
19045,53,0,2021-02-02,3436,2006,91052,5040,2021-02-02,1612220400.0
19046,53,0,2021-02-03,3175,2168,94227,7208,2021-02-03,1612306800.0
19047,53,0,2021-02-04,7098,2259,101325,9467,2021-02-04,1612393200.0
19048,53,0,2021-02-05,5588,2131,106913,11598,2021-02-05,1612479600.0
19049,53,0,2021-02-06,1202,275,108115,11873,2021-02-06,1612566000.0
19050,53,0,2021-02-07,214,132,108329,12005,2021-02-07,1612652400.0
19051,53,0,2021-02-08,1651,1527,109980,13532,2021-02-08,1612738800.0
19052,53,0,2021-02-09,3977,5239,113957,18771,2021-02-09,1612825200.0
19053,53,0,2021-02-10,3792,4626,117749,23397,2021-02-10,1612911600.0
19054,53,0,2021-02-11,5738,8765,123487,32162,2021-02-11,1612998000.0
19055,53,0,2021-02-12,5662,5229,129149,37391,2021-02-12,1613084400.0
19056,53,0,2021-02-13,1232,847,130381,38238,2021-02-13,1613170800.0
19057,53,0,2021-02-14,25,348,130406,38586,2021-02-14,1613257200.0
19058,53,0,2021-02-15,2325,3575,132731,42161,2021-02-15,1613343600.0
19059,53,0,2021-02-16,4052,3533,136783,45694,2021-02-16,1613430000.0
19060,53,0,2021-02-17,4076,5361,140859,51055,2021-02-17,1613516400.0
19061,53,0,2021-02-18,5953,5718,146812,56773,2021-02-18,1613602800.0
19062,53,0,2021-02-19,5355,4825,152167,61598,2021-02-19,1613689200.0
19063,53,0,2021-02-20,1189,884,153356,62482,2021-02-20,1613775600.0
19064,53,0,2021-02-21,166,218,153522,62700,2021-02-21,1613862000.0
19065,53,0,2021-02-22,2319,2816,155841,65516,2021-02-22,1613948400.0
19066,53,0,2021-02-23,3947,3659,159788,69175,2021-02-23,1614034800.0
19067,53,0,2021-02-24,4473,3760,164261,72935,2021-02-24,1614121200.0
19068,53,0,2021-02-25,7950,7102,172211,80037,2021-02-25,1614207600.0
19069,53,0,2021-02-26,8675,4364,180886,84401,2021-02-26,1614294000.0
19070,53,0,2021-02-27,3448,1093,184334,85494,2021-02-27,1614380400.0
19071,53,0,2021-02-28,228,194,184562,85688,2021-02-28,1614466800.0
19072,53,0,2021-03-01,3480,2256,188042,87944,2021-03-01,1614553200.0
19073,53,0,2021-03-02,5617,4442,193659,92386,2021-03-02,1614639600.0
19074,53,0,2021-03-03,6446,3763,200105,96149,2021-03-03,1614726000.0
19075,53,0,2021-03-04,9290,4875,209395,101024,2021-03-04,1614812400.0
19076,53,0,2021-03-05,11913,5135,221308,106159,2021-03-05,1614898800.0
19077,53,0,2021-03-06,5638,988,226946,107147,2021-03-06,1614985200.0
19078,53,0,2021-03-07,913,138,227859,107285,2021-03-07,1615071600.0
19079,53,0,2021-03-08,5166,2177,233025,109462,2021-03-08,1615158000.0
19080,53,0,2021-03-09,9663,2871,242688,112333,2021-03-09,1615244400.0
19081,53,0,2021-03-10,9277,3311,251965,115644,2021-03-10,1615330800.0
19082,53,0,2021-03-11,14303,3958,266268,119602,2021-03-11,1615417200.0
19083,53,0,2021-03-12,18601,3092,284869,122694,2021-03-12,1615503600.0
19084,53,0,2021-03-13,8813,906,293682,123600,2021-03-13,1615590000.0
19085,53,0,2021-03-14,812,50,294494,123650,2021-03-14,1615676400.0
19086,53,0,2021-03-15,6892,1995,301386,125645,2021-03-15,1615762800.0
19087,53,0,2021-03-16,6985,3348,308371,128993,2021-03-16,1615849200.0
19088,53,0,2021-03-17,8226,2755,316597,131748,2021-03-17,1615935600.0
19089,53,0,2021-03-18,8716,4575,325313,136323,2021-03-18,1616022000.0
19090,53,0,2021-03-19,12992,3565,338305,139888,2021-03-19,1616108400.0
19091,53,0,2021-03-20,7128,770,345433,140658,2021-03-20,1616194800.0
19092,53,0,2021-03-21,383,30,345816,140688,2021-03-21,1616281200.0
19093,53,0,2021-03-22,7346,2112,353162,142800,2021-03-22,1616367600.0
19094,53,0,2021-03-23,12991,3586,366153,146386,2021-03-23,1616454000.0
19095,53,0,2021-03-24,14403,3169,380556,149555,2021-03-24,1616540400.0
19096,53,0,2021-03-25,18289,3228,398845,152783,2021-03-25,1616626800.0
19097,53,0,2021-03-26,20325,3047,419170,155830,2021-03-26,1616713200.0
19098,53,0,2021-03-27,7409,983,426579,156813,2021-03-27,1616799600.0
19099,53,0,2021-03-28,528,84,427107,156897,2021-03-28,1616886000.0
19100,53,0,2021-03-29,9800,3100,436907,159997,2021-03-29,1616972400.0
19101,53,0,2021-03-30,15313,4493,452220,164490,2021-03-30,1617058800.0
19102,53,0,2021-03-31,14150,4142,466370,168632,2021-03-31,1617145200.0
19103,53,0,2021-04-01,18205,4093,484575,172725,2021-04-01,1617231600.0
19104,53,0,2021-04-02,17901,4187,502476,176912,2021-04-02,1617318000.0
19105,53,0,2021-04-03,6439,1388,508915,178300,2021-04-03,1617404400.0
19106,53,0,2021-04-04,414,31,509329,178331,2021-04-04,1617490800.0
19107,53,0,2021-04-05,1234,325,510563,178656,2021-04-05,1617577200.0
19108,53,0,2021-04-06,12528,5561,523091,184217,2021-04-06,1617663600.0
19109,53,0,2021-04-07,15021,5211,538112,189428,2021-04-07,1617750000.0
19110,53,0,2021-04-08,20712,5903,558824,195331,2021-04-08,1617836400.0
19111,53,0,2021-04-09,26676,5312,585500,200643,2021-04-09,1617922800.0
19112,53,0,2021-04-10,10351,1641,595851,202284,2021-04-10,1618009200.0
19113,53,0,2021-04-11,817,206,596668,202490,2021-04-11,1618095600.0
19114,53,0,2021-04-12,15841,4775,612509,207265,2021-04-12,1618185600.0
19115,53,0,2021-04-13,22705,6951,635214,214216,2021-04-13,1618272000.0
19116,53,0,2021-04-14,19354,7709,654568,221925,2021-04-14,1618358400.0
19117,53,0,2021-04-15,25367,7791,679935,229716,2021-04-15,1618444800.0
19118,53,0,2021-04-16,26188,7256,706123,236972,2021-04-16,1618531200.0
19119,53,0,2021-04-17,10400,3498,716523,240470,2021-04-17,1618617600.0
19120,53,0,2021-04-18,1034,139,717557,240609,2021-04-18,1618704000.0
19121,53,0,2021-04-19,15406,6361,732963,246970,2021-04-19,1618790400.0
19122,53,0,2021-04-20,16925,9285,749888,256255,2021-04-20,1618876800.0
19123,53,0,2021-04-21,16746,9222,766634,265477,2021-04-21,1618963200.0
19124,53,0,2021-04-22,21758,9868,788392,275345,2021-04-22,1619049600.0
19125,53,0,2021-04-23,21661,9712,810053,285057,2021-04-23,1619136000.0
19126,53,0,2021-04-24,9988,3887,820041,288944,2021-04-24,1619222400.0
19127,53,0,2021-04-25,912,319,820953,289263,2021-04-25,1619308800.0
19128,53,0,2021-04-26,18233,7962,839186,297225,2021-04-26,1619395200.0
19129,53,0,2021-04-27,19856,11142,859042,308367,2021-04-27,1619481600.0
19130,53,0,2021-04-28,19947,9904,878989,318271,2021-04-28,1619568000.0
19131,53,0,2021-04-29,23559,10918,902548,329189,2021-04-29,1619654400.0
19132,53,0,2021-04-30,23903,10903,926451,340092,2021-04-30,1619740800.0
19133,53,0,2021-05-01,5125,1460,931576,341552,2021-05-01,1619827200.0
19134,53,0,2021-05-02,2798,448,934374,342000,2021-05-02,1619913600.0
19135,53,0,2021-05-03,15713,8819,950087,350819,2021-05-03,1620000000.0
19136,53,0,2021-05-04,15699,15030,965786,365849,2021-05-04,1620086400.0
19137,53,0,2021-05-05,14943,14173,980729,380022,2021-05-05,1620172800.0
19138,53,0,2021-05-06,19259,16836,999988,396858,2021-05-06,1620259200.0
19139,53,0,2021-05-07,18642,16541,1018630,413399,2021-05-07,1620345600.0
19140,53,0,2021-05-08,5486,953,1024116,414352,2021-05-08,1620432000.0
19141,53,0,2021-05-09,3512,809,1027628,415161,2021-05-09,1620518400.0
19142,53,0,2021-05-10,16679,14549,1044307,429710,2021-05-10,1620604800.0
19143,53,0,2021-05-11,18672,17456,1062979,447166,2021-05-11,1620691200.0
19144,53,0,2021-05-12,21194,14395,1084173,461561,2021-05-12,1620777600.0
19145,53,0,2021-05-13,9026,3749,1093199,465310,2021-05-13,1620864000.0
19146,53,0,2021-05-14,21714,12545,1114913,477855,2021-05-14,1620950400.0
19147,53,0,2021-05-15,13430,4798,1128343,482653,2021-05-15,1621036800.0
19148,53,0,2021-05-16,3225,800,1131568,483453,2021-05-16,1621123200.0
19149,53,0,2021-05-17,18189,10437,1149757,493890,2021-05-17,1621206000.0
19150,53,0,2021-05-18,21052,11145,1170809,505035,2021-05-18,1621292400.0
19151,53,0,2021-05-19,21676,9711,1192485,514746,2021-05-19,1621378800.0
19152,53,0,2021-05-20,23945,13226,1216430,527972,2021-05-20,1621465200.0
19153,53,0,2021-05-21,22931,13513,1239361,541485,2021-05-21,1621551600.0
19154,53,0,2021-05-22,13200,5223,1252561,546708,2021-05-22,1621638000.0
19155,53,0,2021-05-23,2998,257,1255559,546965,2021-05-23,1621724400.0
19156,53,0,2021-05-24,14033,2133,1269592,549098,2021-05-24,1621810800.0
19157,53,0,2021-05-25,20090,11827,1289682,560925,2021-05-25,1621897200.0
19158,53,0,2021-05-26,19358,12812,1309040,573737,2021-05-26,1621983600.0
19159,53,0,2021-05-27,22088,15566,1331128,589303,2021-05-27,1622070000.0
19160,53,0,2021-05-28,21773,17767,1352901,607070,2021-05-28,1622156400.0
19161,53,0,2021-05-29,12144,6381,1365045,613451,2021-05-29,1622242800.0
19162,53,0,2021-05-30,2311,388,1367356,613839,2021-05-30,1622329200.0
19163,53,0,2021-05-31,20696,12757,1388052,626596,2021-05-31,1622415600.0
19164,53,0,2021-06-01,22966,14846,1411018,641442,2021-06-01,1622502000.0
19165,53,0,2021-06-02,21797,12827,1432815,654269,2021-06-02,1622588400.0
19166,53,0,2021-06-03,25055,14928,1457870,669197,2021-06-03,1622674800.0
19167,53,0,2021-06-04,23109,20307,1480979,689504,2021-06-04,1622761200.0
19168,53,0,2021-06-05,17316,7919,1498295,697423,2021-06-05,1622847600.0
19169,53,0,2021-06-06,5007,1133,1503302,698556,2021-06-06,1622934000.0
19170,53,0,2021-06-07,18392,16666,1521694,715222,2021-06-07,1623020400.0
19171,53,0,2021-06-08,23384,16354,1545078,731576,2021-06-08,1623106800.0
19172,53,0,2021-06-09,23630,14412,1568708,745988,2021-06-09,1623193200.0
19173,53,0,2021-06-10,26813,14912,1595521,760900,2021-06-10,1623279600.0
19174,53,0,2021-06-11,26207,19427,1621728,780327,2021-06-11,1623366000.0
19175,53,0,2021-06-12,18606,6621,1640334,786948,2021-06-12,1623452400.0
19176,53,0,2021-06-13,7795,2832,1648129,789780,2021-06-13,1623538800.0
19177,53,0,2021-06-14,16030,18751,1664159,808531,2021-06-14,1623625200.0
19178,53,0,2021-06-15,20057,19605,1684216,828136,2021-06-15,1623711600.0
19179,53,0,2021-06-16,21166,17176,1705382,845312,2021-06-16,1623798000.0
19180,53,0,2021-06-17,21888,18687,1727270,863999,2021-06-17,1623884400.0
19181,53,0,2021-06-18,22227,23946,1749497,887945,2021-06-18,1623970800.0
19182,53,0,2021-06-19,12832,8812,1762329,896757,2021-06-19,1624057200.0
19183,53,0,2021-06-20,5453,2460,1767782,899217,2021-06-20,1624143600.0
19184,53,0,2021-06-21,14583,21375,1782365,920592,2021-06-21,1624230000.0
19185,53,0,2021-06-22,16985,23535,1799350,944127,2021-06-22,1624316400.0
19186,53,0,2021-06-23,16738,22366,1816088,966493,2021-06-23,1624402800.0
19187,53,0,2021-06-24,19027,20339,1835115,986832,2021-06-24,1624489200.0
19188,53,0,2021-06-25,15512,27660,1850627,1014492,2021-06-25,1624575600.0
19189,53,0,2021-06-26,7136,13411,1857763,1027903,2021-06-26,1624662000.0
19190,53,0,2021-06-27,3881,3135,1861644,1031038,2021-06-27,1624748400.0
19191,53,0,2021-06-28,9637,23459,1871281,1054497,2021-06-28,1624834800.0
19192,53,0,2021-06-29,11475,26097,1882756,1080594,2021-06-29,1624921200.0
19193,53,0,2021-06-30,12080,25429,1894836,1106023,2021-06-30,1625007600.0
19194,53,0,2021-07-01,14090,25412,1908926,1131435,2021-07-01,1625094000.0
19195,53,0,2021-07-02,13120,30261,1922046,1161696,2021-07-02,1625180400.0
19196,53,0,2021-07-03,6514,14803,1928560,1176499,2021-07-03,1625266800.0
19197,53,0,2021-07-04,3850,4241,1932410,1180740,2021-07-04,1625353200.0
19198,53,0,2021-07-05,8945,25669,1941355,1206409,2021-07-05,1625439600.0
19199,53,0,2021-07-06,10597,28096,1951952,1234505,2021-07-06,1625526000.0
19200,75,0,2020-12-27,1,0,1,0,2020-12-27,1609023600.0
19201,75,0,2020-12-28,2,0,3,0,2020-12-28,1609110000.0
19202,75,0,2020-12-29,3,0,6,0,2020-12-29,1609196400.0
19203,75,0,2020-12-30,2,0,8,0,2020-12-30,1609282800.0
19204,75,0,2020-12-31,0,0,8,0,2020-12-31,1609369200.0
19205,75,0,2021-01-01,4,0,12,0,2021-01-01,1609455600.0
19206,75,0,2021-01-02,2,0,14,0,2021-01-02,1609542000.0
19207,75,0,2021-01-03,0,0,14,0,2021-01-03,1609628400.0
19208,75,0,2021-01-04,90,0,104,0,2021-01-04,1609714800.0
19209,75,0,2021-01-05,124,0,228,0,2021-01-05,1609801200.0
19210,75,0,2021-01-06,736,0,964,0,2021-01-06,1609887600.0
19211,75,0,2021-01-07,4923,0,5887,0,2021-01-07,1609974000.0
19212,75,0,2021-01-08,5470,0,11357,0,2021-01-08,1610060400.0
19213,75,0,2021-01-09,845,0,12202,0,2021-01-09,1610146800.0
19214,75,0,2021-01-10,478,0,12680,0,2021-01-10,1610233200.0
19215,75,0,2021-01-11,3585,0,16265,0,2021-01-11,1610319600.0
19216,75,0,2021-01-12,5947,0,22212,0,2021-01-12,1610406000.0
19217,75,0,2021-01-13,6552,0,28764,0,2021-01-13,1610492400.0
19218,75,0,2021-01-14,8126,0,36890,0,2021-01-14,1610578800.0
19219,75,0,2021-01-15,7630,0,44520,0,2021-01-15,1610665200.0
19220,75,0,2021-01-16,1609,12,46129,12,2021-01-16,1610751600.0
19221,75,0,2021-01-17,426,3,46555,15,2021-01-17,1610838000.0
19222,75,0,2021-01-18,6891,24,53446,39,2021-01-18,1610924400.0
19223,75,0,2021-01-19,14055,8,67501,47,2021-01-19,1611010800.0
19224,75,0,2021-01-20,15537,5,83038,52,2021-01-20,1611097200.0
19225,75,0,2021-01-21,16968,16,100006,68,2021-01-21,1611183600.0
19226,75,0,2021-01-22,12973,14,112979,82,2021-01-22,1611270000.0
19227,75,0,2021-01-23,4421,2,117400,84,2021-01-23,1611356400.0
19228,75,0,2021-01-24,700,1,118100,85,2021-01-24,1611442800.0
19229,75,0,2021-01-25,8873,212,126973,297,2021-01-25,1611529200.0
19230,75,0,2021-01-26,11725,446,138698,743,2021-01-26,1611615600.0
19231,75,0,2021-01-27,12299,759,150997,1502,2021-01-27,1611702000.0
19232,75,0,2021-01-28,12942,2636,163939,4138,2021-01-28,1611788400.0
19233,75,0,2021-01-29,10003,2978,173942,7116,2021-01-29,1611874800.0
19234,75,0,2021-01-30,3379,515,177321,7631,2021-01-30,1611961200.0
19235,75,0,2021-01-31,646,418,177967,8049,2021-01-31,1612047600.0
19236,75,0,2021-02-01,5715,2638,183682,10687,2021-02-01,1612134000.0
19237,75,0,2021-02-02,9616,4342,193298,15029,2021-02-02,1612220400.0
19238,75,0,2021-02-03,9597,4356,202895,19385,2021-02-03,1612306800.0
19239,75,0,2021-02-04,10766,5667,213661,25052,2021-02-04,1612393200.0
19240,75,0,2021-02-05,7490,5629,221151,30681,2021-02-05,1612479600.0
19241,75,0,2021-02-06,2381,1104,223532,31785,2021-02-06,1612566000.0
19242,75,0,2021-02-07,674,245,224206,32030,2021-02-07,1612652400.0
19243,75,0,2021-02-08,5136,3647,229342,35677,2021-02-08,1612738800.0
19244,75,0,2021-02-09,7315,8048,236657,43725,2021-02-09,1612825200.0
19245,75,0,2021-02-10,7543,8735,244200,52460,2021-02-10,1612911600.0
19246,75,0,2021-02-11,8866,10246,253066,62706,2021-02-11,1612998000.0
19247,75,0,2021-02-12,7408,8749,260474,71455,2021-02-12,1613084400.0
19248,75,0,2021-02-13,1953,1753,262427,73208,2021-02-13,1613170800.0
19249,75,0,2021-02-14,274,363,262701,73571,2021-02-14,1613257200.0
19250,75,0,2021-02-15,3191,7829,265892,81400,2021-02-15,1613343600.0
19251,75,0,2021-02-16,4627,10492,270519,91892,2021-02-16,1613430000.0
19252,75,0,2021-02-17,4759,11270,275278,103162,2021-02-17,1613516400.0
19253,75,0,2021-02-18,5455,12772,280733,115934,2021-02-18,1613602800.0
19254,75,0,2021-02-19,5418,9581,286151,125515,2021-02-19,1613689200.0
19255,75,0,2021-02-20,989,2627,287140,128142,2021-02-20,1613775600.0
19256,75,0,2021-02-21,187,665,287327,128807,2021-02-21,1613862000.0
19257,75,0,2021-02-22,3648,8486,290975,137293,2021-02-22,1613948400.0
19258,75,0,2021-02-23,5359,10885,296334,148178,2021-02-23,1614034800.0
19259,75,0,2021-02-24,6132,10249,302466,158427,2021-02-24,1614121200.0
19260,75,0,2021-02-25,10045,11617,312511,170044,2021-02-25,1614207600.0
19261,75,0,2021-02-26,12270,8749,324781,178793,2021-02-26,1614294000.0
19262,75,0,2021-02-27,5787,2461,330568,181254,2021-02-27,1614380400.0
19263,75,0,2021-02-28,312,691,330880,181945,2021-02-28,1614466800.0
19264,75,0,2021-03-01,5094,6965,335974,188910,2021-03-01,1614553200.0
19265,75,0,2021-03-02,9354,8076,345328,196986,2021-03-02,1614639600.0
19266,75,0,2021-03-03,10825,7706,356153,204692,2021-03-03,1614726000.0
19267,75,0,2021-03-04,16738,8024,372891,212716,2021-03-04,1614812400.0
19268,75,0,2021-03-05,20814,7247,393705,219963,2021-03-05,1614898800.0
19269,75,0,2021-03-06,13412,2137,407117,222100,2021-03-06,1614985200.0
19270,75,0,2021-03-07,3722,428,410839,222528,2021-03-07,1615071600.0
19271,75,0,2021-03-08,9996,5313,420835,227841,2021-03-08,1615158000.0
19272,75,0,2021-03-09,16864,6375,437699,234216,2021-03-09,1615244400.0
19273,75,0,2021-03-10,18263,6188,455962,240404,2021-03-10,1615330800.0
19274,75,0,2021-03-11,26444,6482,482406,246886,2021-03-11,1615417200.0
19275,75,0,2021-03-12,31319,5021,513725,251907,2021-03-12,1615503600.0
19276,75,0,2021-03-13,17873,1111,531598,253018,2021-03-13,1615590000.0
19277,75,0,2021-03-14,1713,234,533311,253252,2021-03-14,1615676400.0
19278,75,0,2021-03-15,14080,3337,547391,256589,2021-03-15,1615762800.0
19279,75,0,2021-03-16,13687,3625,561078,260214,2021-03-16,1615849200.0
19280,75,0,2021-03-17,14756,3754,575834,263968,2021-03-17,1615935600.0
19281,75,0,2021-03-18,16385,4477,592219,268445,2021-03-18,1616022000.0
19282,75,0,2021-03-19,22450,4086,614669,272531,2021-03-19,1616108400.0
19283,75,0,2021-03-20,14033,726,628702,273257,2021-03-20,1616194800.0
19284,75,0,2021-03-21,2476,86,631178,273343,2021-03-21,1616281200.0
19285,75,0,2021-03-22,16796,3348,647974,276691,2021-03-22,1616367600.0
19286,75,0,2021-03-23,25284,3679,673258,280370,2021-03-23,1616454000.0
19287,75,0,2021-03-24,27170,4094,700428,284464,2021-03-24,1616540400.0
19288,75,0,2021-03-25,35676,4352,736104,288816,2021-03-25,1616626800.0
19289,75,0,2021-03-26,38636,3830,774740,292646,2021-03-26,1616713200.0
19290,75,0,2021-03-27,15731,1107,790471,293753,2021-03-27,1616799600.0
19291,75,0,2021-03-28,2727,366,793198,294119,2021-03-28,1616886000.0
19292,75,0,2021-03-29,22842,3885,816040,298004,2021-03-29,1616972400.0
19293,75,0,2021-03-30,31659,5604,847699,303608,2021-03-30,1617058800.0
19294,75,0,2021-03-31,29762,5619,877461,309227,2021-03-31,1617145200.0
19295,75,0,2021-04-01,35040,6442,912501,315669,2021-04-01,1617231600.0
19296,75,0,2021-04-02,32362,6469,944863,322138,2021-04-02,1617318000.0
19297,75,0,2021-04-03,12847,2505,957710,324643,2021-04-03,1617404400.0
19298,75,0,2021-04-04,2139,319,959849,324962,2021-04-04,1617490800.0
19299,75,0,2021-04-05,6370,537,966219,325499,2021-04-05,1617577200.0
19300,75,0,2021-04-06,26397,10524,992616,336023,2021-04-06,1617663600.0
19301,75,0,2021-04-07,32385,10569,1025001,346592,2021-04-07,1617750000.0
19302,75,0,2021-04-08,39635,11739,1064636,358331,2021-04-08,1617836400.0
19303,75,0,2021-04-09,49301,10266,1113937,368597,2021-04-09,1617922800.0
19304,75,0,2021-04-10,24495,4639,1138432,373236,2021-04-10,1618009200.0
19305,75,0,2021-04-11,4977,668,1143409,373904,2021-04-11,1618095600.0
19306,75,0,2021-04-12,27398,11450,1170807,385354,2021-04-12,1618185600.0
19307,75,0,2021-04-13,35757,13802,1206564,399156,2021-04-13,1618272000.0
19308,75,0,2021-04-14,35473,13936,1242037,413092,2021-04-14,1618358400.0
19309,75,0,2021-04-15,37712,14405,1279749,427497,2021-04-15,1618444800.0
19310,75,0,2021-04-16,37170,14602,1316919,442099,2021-04-16,1618531200.0
19311,75,0,2021-04-17,19584,7121,1336503,449220,2021-04-17,1618617600.0
19312,75,0,2021-04-18,4074,1992,1340577,451212,2021-04-18,1618704000.0
19313,75,0,2021-04-19,20901,14607,1361478,465819,2021-04-19,1618790400.0
19314,75,0,2021-04-20,28513,18627,1389991,484446,2021-04-20,1618876800.0
19315,75,0,2021-04-21,27846,17579,1417837,502025,2021-04-21,1618963200.0
19316,75,0,2021-04-22,30402,19111,1448239,521136,2021-04-22,1619049600.0
19317,75,0,2021-04-23,29081,19624,1477320,540760,2021-04-23,1619136000.0
19318,75,0,2021-04-24,17027,8663,1494347,549423,2021-04-24,1619222400.0
19319,75,0,2021-04-25,4598,1414,1498945,550837,2021-04-25,1619308800.0
19320,75,0,2021-04-26,22329,18543,1521274,569380,2021-04-26,1619395200.0
19321,75,0,2021-04-27,29203,22691,1550477,592071,2021-04-27,1619481600.0
19322,75,0,2021-04-28,31146,22317,1581623,614388,2021-04-28,1619568000.0
19323,75,0,2021-04-29,37271,23875,1618894,638263,2021-04-29,1619654400.0
19324,75,0,2021-04-30,37760,22733,1656654,660996,2021-04-30,1619740800.0
19325,75,0,2021-05-01,15697,5185,1672351,666181,2021-05-01,1619827200.0
19326,75,0,2021-05-02,7263,2393,1679614,668574,2021-05-02,1619913600.0
19327,75,0,2021-05-03,27269,19893,1706883,688467,2021-05-03,1620000000.0
19328,75,0,2021-05-04,30367,27536,1737250,716003,2021-05-04,1620086400.0
19329,75,0,2021-05-05,31513,29334,1768763,745337,2021-05-05,1620172800.0
19330,75,0,2021-05-06,35968,29840,1804731,775177,2021-05-06,1620259200.0
19331,75,0,2021-05-07,37449,30954,1842180,806131,2021-05-07,1620345600.0
19332,75,0,2021-05-08,17724,7441,1859904,813572,2021-05-08,1620432000.0
19333,75,0,2021-05-09,7313,3919,1867217,817491,2021-05-09,1620518400.0
19334,75,0,2021-05-10,25217,27487,1892434,844978,2021-05-10,1620604800.0
19335,75,0,2021-05-11,35610,30246,1928044,875224,2021-05-11,1620691200.0
19336,75,0,2021-05-12,35633,27904,1963677,903128,2021-05-12,1620777600.0
19337,75,0,2021-05-13,22705,6627,1986382,909755,2021-05-13,1620864000.0
19338,75,0,2021-05-14,33908,19054,2020290,928809,2021-05-14,1620950400.0
19339,75,0,2021-05-15,22957,10070,2043247,938879,2021-05-15,1621036800.0
19340,75,0,2021-05-16,7430,1822,2050677,940701,2021-05-16,1621123200.0
19341,75,0,2021-05-17,33940,17538,2084617,958239,2021-05-17,1621206000.0
19342,75,0,2021-05-18,42872,17600,2127489,975839,2021-05-18,1621292400.0
19343,75,0,2021-05-19,42811,15760,2170300,991599,2021-05-19,1621378800.0
19344,75,0,2021-05-20,46030,17876,2216330,1009475,2021-05-20,1621465200.0
19345,75,0,2021-05-21,42999,18482,2259329,1027957,2021-05-21,1621551600.0
19346,75,0,2021-05-22,23319,8575,2282648,1036532,2021-05-22,1621638000.0
19347,75,0,2021-05-23,7841,1121,2290489,1037653,2021-05-23,1621724400.0
19348,75,0,2021-05-24,18897,3283,2309386,1040936,2021-05-24,1621810800.0
19349,75,0,2021-05-25,36963,18938,2346349,1059874,2021-05-25,1621897200.0
19350,75,0,2021-05-26,38604,19123,2384953,1078997,2021-05-26,1621983600.0
19351,75,0,2021-05-27,42977,23992,2427930,1102989,2021-05-27,1622070000.0
19352,75,0,2021-05-28,38927,27598,2466857,1130587,2021-05-28,1622156400.0
19353,75,0,2021-05-29,19659,16186,2486516,1146773,2021-05-29,1622242800.0
19354,75,0,2021-05-30,5787,2031,2492303,1148804,2021-05-30,1622329200.0
19355,75,0,2021-05-31,31644,20442,2523947,1169246,2021-05-31,1622415600.0
19356,75,0,2021-06-01,41044,25667,2564991,1194913,2021-06-01,1622502000.0
19357,75,0,2021-06-02,41407,24666,2606398,1219579,2021-06-02,1622588400.0
19358,75,0,2021-06-03,47637,26918,2654035,1246497,2021-06-03,1622674800.0
19359,75,0,2021-06-04,44427,32439,2698462,1278936,2021-06-04,1622761200.0
19360,75,0,2021-06-05,24424,16388,2722886,1295324,2021-06-05,1622847600.0
19361,75,0,2021-06-06,8746,3836,2731632,1299160,2021-06-06,1622934000.0
19362,75,0,2021-06-07,31419,29069,2763051,1328229,2021-06-07,1623020400.0
19363,75,0,2021-06-08,38479,32562,2801530,1360791,2021-06-08,1623106800.0
19364,75,0,2021-06-09,39353,29654,2840883,1390445,2021-06-09,1623193200.0
19365,75,0,2021-06-10,43008,27869,2883891,1418314,2021-06-10,1623279600.0
19366,75,0,2021-06-11,40287,36180,2924178,1454494,2021-06-11,1623366000.0
19367,75,0,2021-06-12,23207,19605,2947385,1474099,2021-06-12,1623452400.0
19368,75,0,2021-06-13,8106,5232,2955491,1479331,2021-06-13,1623538800.0
19369,75,0,2021-06-14,23964,35816,2979455,1515147,2021-06-14,1623625200.0
19370,75,0,2021-06-15,33132,38439,3012587,1553586,2021-06-15,1623711600.0
19371,75,0,2021-06-16,34654,34411,3047241,1587997,2021-06-16,1623798000.0
19372,75,0,2021-06-17,36079,35045,3083320,1623042,2021-06-17,1623884400.0
19373,75,0,2021-06-18,34704,41902,3118024,1664944,2021-06-18,1623970800.0
19374,75,0,2021-06-19,20140,21531,3138164,1686475,2021-06-19,1624057200.0
19375,75,0,2021-06-20,6218,5302,3144382,1691777,2021-06-20,1624143600.0
19376,75,0,2021-06-21,21411,35356,3165793,1727133,2021-06-21,1624230000.0
19377,75,0,2021-06-22,25235,41057,3191028,1768190,2021-06-22,1624316400.0
19378,75,0,2021-06-23,26169,38264,3217197,1806454,2021-06-23,1624402800.0
19379,75,0,2021-06-24,27870,32694,3245067,1839148,2021-06-24,1624489200.0
19380,75,0,2021-06-25,24000,45695,3269067,1884843,2021-06-25,1624575600.0
19381,75,0,2021-06-26,13606,25448,3282673,1910291,2021-06-26,1624662000.0
19382,75,0,2021-06-27,4570,8245,3287243,1918536,2021-06-27,1624748400.0
19383,75,0,2021-06-28,14808,42989,3302051,1961525,2021-06-28,1624834800.0
19384,75,0,2021-06-29,18561,49548,3320612,2011073,2021-06-29,1624921200.0
19385,75,0,2021-06-30,20070,45569,3340682,2056642,2021-06-30,1625007600.0
19386,75,0,2021-07-01,22306,43692,3362988,2100334,2021-07-01,1625094000.0
19387,75,0,2021-07-02,21015,50573,3384003,2150907,2021-07-02,1625180400.0
19388,75,0,2021-07-03,9932,27776,3393935,2178683,2021-07-03,1625266800.0
19389,75,0,2021-07-04,3375,7501,3397310,2186184,2021-07-04,1625353200.0
19390,75,0,2021-07-05,14046,40576,3411356,2226760,2021-07-05,1625439600.0
19391,75,0,2021-07-06,17914,49607,3429270,2276367,2021-07-06,1625526000.0
19392,76,0,2020-12-27,0,0,0,0,2020-12-27,1609023600.0
19393,76,0,2020-12-28,5,0,5,0,2020-12-28,1609110000.0
19394,76,0,2020-12-29,0,0,5,0,2020-12-29,1609196400.0
19395,76,0,2020-12-30,0,0,5,0,2020-12-30,1609282800.0
19396,76,0,2020-12-31,1,0,6,0,2020-12-31,1609369200.0
19397,76,0,2021-01-01,3,0,9,0,2021-01-01,1609455600.0
19398,76,0,2021-01-02,2,0,11,0,2021-01-02,1609542000.0
19399,76,0,2021-01-03,2,0,13,0,2021-01-03,1609628400.0
19400,76,0,2021-01-04,59,0,72,0,2021-01-04,1609714800.0
19401,76,0,2021-01-05,473,0,545,0,2021-01-05,1609801200.0
19402,76,0,2021-01-06,784,0,1329,0,2021-01-06,1609887600.0
19403,76,0,2021-01-07,2541,0,3870,0,2021-01-07,1609974000.0
19404,76,0,2021-01-08,3217,0,7087,0,2021-01-08,1610060400.0
19405,76,0,2021-01-09,1539,0,8626,0,2021-01-09,1610146800.0
19406,76,0,2021-01-10,517,0,9143,0,2021-01-10,1610233200.0
19407,76,0,2021-01-11,3524,0,12667,0,2021-01-11,1610319600.0
19408,76,0,2021-01-12,5751,0,18418,0,2021-01-12,1610406000.0
19409,76,0,2021-01-13,6477,0,24895,0,2021-01-13,1610492400.0
19410,76,0,2021-01-14,8997,0,33892,0,2021-01-14,1610578800.0
19411,76,0,2021-01-15,7254,0,41146,0,2021-01-15,1610665200.0
19412,76,0,2021-01-16,1954,16,43100,16,2021-01-16,1610751600.0
19413,76,0,2021-01-17,710,2,43810,18,2021-01-17,1610838000.0
19414,76,0,2021-01-18,7708,12,51518,30,2021-01-18,1610924400.0
19415,76,0,2021-01-19,11211,10,62729,40,2021-01-19,1611010800.0
19416,76,0,2021-01-20,13725,9,76454,49,2021-01-20,1611097200.0
19417,76,0,2021-01-21,16725,6,93179,55,2021-01-21,1611183600.0
19418,76,0,2021-01-22,11928,15,105107,70,2021-01-22,1611270000.0
19419,76,0,2021-01-23,3898,5,109005,75,2021-01-23,1611356400.0
19420,76,0,2021-01-24,771,10,109776,85,2021-01-24,1611442800.0
19421,76,0,2021-01-25,7830,85,117606,170,2021-01-25,1611529200.0
19422,76,0,2021-01-26,10349,266,127955,436,2021-01-26,1611615600.0
19423,76,0,2021-01-27,10848,461,138803,897,2021-01-27,1611702000.0
19424,76,0,2021-01-28,10141,1681,148944,2578,2021-01-28,1611788400.0
19425,76,0,2021-01-29,8091,1980,157035,4558,2021-01-29,1611874800.0
19426,76,0,2021-01-30,3187,769,160222,5327,2021-01-30,1611961200.0
19427,76,0,2021-01-31,521,267,160743,5594,2021-01-31,1612047600.0
19428,76,0,2021-02-01,5857,2596,166600,8190,2021-02-01,1612134000.0
19429,76,0,2021-02-02,10064,3987,176664,12177,2021-02-02,1612220400.0
19430,76,0,2021-02-03,9522,4048,186186,16225,2021-02-03,1612306800.0
19431,76,0,2021-02-04,10108,5925,196294,22150,2021-02-04,1612393200.0
19432,76,0,2021-02-05,7775,4985,204069,27135,2021-02-05,1612479600.0
19433,76,0,2021-02-06,2700,1047,206769,28182,2021-02-06,1612566000.0
19434,76,0,2021-02-07,542,494,207311,28676,2021-02-07,1612652400.0
19435,76,0,2021-02-08,4842,4515,212153,33191,2021-02-08,1612738800.0
19436,76,0,2021-02-09,6327,6789,218480,39980,2021-02-09,1612825200.0
19437,76,0,2021-02-10,7181,9197,225661,49177,2021-02-10,1612911600.0
19438,76,0,2021-02-11,9145,10666,234806,59843,2021-02-11,1612998000.0
19439,76,0,2021-02-12,8050,7630,242856,67473,2021-02-12,1613084400.0
19440,76,0,2021-02-13,2648,2260,245504,69733,2021-02-13,1613170800.0
19441,76,0,2021-02-14,358,993,245862,70726,2021-02-14,1613257200.0
19442,76,0,2021-02-15,3380,6445,249242,77171,2021-02-15,1613343600.0
19443,76,0,2021-02-16,4242,8660,253484,85831,2021-02-16,1613430000.0
19444,76,0,2021-02-17,4374,9605,257858,95436,2021-02-17,1613516400.0
19445,76,0,2021-02-18,5871,9929,263729,105365,2021-02-18,1613602800.0
19446,76,0,2021-02-19,4843,8078,268572,113443,2021-02-19,1613689200.0
19447,76,0,2021-02-20,1530,3024,270102,116467,2021-02-20,1613775600.0
19448,76,0,2021-02-21,265,589,270367,117056,2021-02-21,1613862000.0
19449,76,0,2021-02-22,3280,7615,273647,124671,2021-02-22,1613948400.0
19450,76,0,2021-02-23,4919,10190,278566,134861,2021-02-23,1614034800.0
19451,76,0,2021-02-24,4648,10375,283214,145236,2021-02-24,1614121200.0
19452,76,0,2021-02-25,8321,9803,291535,155039,2021-02-25,1614207600.0
19453,76,0,2021-02-26,9638,8296,301173,163335,2021-02-26,1614294000.0
19454,76,0,2021-02-27,3734,3069,304907,166404,2021-02-27,1614380400.0
19455,76,0,2021-02-28,431,449,305338,166853,2021-02-28,1614466800.0
19456,76,0,2021-03-01,5316,6078,310654,172931,2021-03-01,1614553200.0
19457,76,0,2021-03-02,8217,7478,318871,180409,2021-03-02,1614639600.0
19458,76,0,2021-03-03,9250,7364,328121,187773,2021-03-03,1614726000.0
19459,76,0,2021-03-04,14322,7701,342443,195474,2021-03-04,1614812400.0
19460,76,0,2021-03-05,16874,6905,359317,202379,2021-03-05,1614898800.0
19461,76,0,2021-03-06,15891,2019,375208,204398,2021-03-06,1614985200.0
19462,76,0,2021-03-07,11378,361,386586,204759,2021-03-07,1615071600.0
19463,76,0,2021-03-08,9980,5393,396566,210152,2021-03-08,1615158000.0
19464,76,0,2021-03-09,16234,6256,412800,216408,2021-03-09,1615244400.0
19465,76,0,2021-03-10,16423,6287,429223,222695,2021-03-10,1615330800.0
19466,76,0,2021-03-11,22604,6127,451827,228822,2021-03-11,1615417200.0
19467,76,0,2021-03-12,26447,5006,478274,233828,2021-03-12,1615503600.0
19468,76,0,2021-03-13,14927,2046,493201,235874,2021-03-13,1615590000.0
19469,76,0,2021-03-14,2322,333,495523,236207,2021-03-14,1615676400.0
19470,76,0,2021-03-15,13531,3157,509054,239364,2021-03-15,1615762800.0
19471,76,0,2021-03-16,11762,4353,520816,243717,2021-03-16,1615849200.0
19472,76,0,2021-03-17,12840,3783,533656,247500,2021-03-17,1615935600.0
19473,76,0,2021-03-18,13703,4766,547359,252266,2021-03-18,1616022000.0
19474,76,0,2021-03-19,18654,3674,566013,255940,2021-03-19,1616108400.0
19475,76,0,2021-03-20,10663,1023,576676,256963,2021-03-20,1616194800.0
19476,76,0,2021-03-21,3196,188,579872,257151,2021-03-21,1616281200.0
19477,76,0,2021-03-22,14682,3360,594554,260511,2021-03-22,1616367600.0
19478,76,0,2021-03-23,22251,4017,616805,264528,2021-03-23,1616454000.0
19479,76,0,2021-03-24,23606,3891,640411,268419,2021-03-24,1616540400.0
19480,76,0,2021-03-25,32021,4157,672432,272576,2021-03-25,1616626800.0
19481,76,0,2021-03-26,30854,3685,703286,276261,2021-03-26,1616713200.0
19482,76,0,2021-03-27,16252,1195,719538,277456,2021-03-27,1616799600.0
19483,76,0,2021-03-28,4865,145,724403,277601,2021-03-28,1616886000.0
19484,76,0,2021-03-29,22303,4583,746706,282184,2021-03-29,1616972400.0
19485,76,0,2021-03-30,29716,5255,776422,287439,2021-03-30,1617058800.0
19486,76,0,2021-03-31,26894,5173,803316,292612,2021-03-31,1617145200.0
19487,76,0,2021-04-01,34473,5239,837789,297851,2021-04-01,1617231600.0
19488,76,0,2021-04-02,29348,5244,867137,303095,2021-04-02,1617318000.0
19489,76,0,2021-04-03,12156,2662,879293,305757,2021-04-03,1617404400.0
19490,76,0,2021-04-04,4353,581,883646,306338,2021-04-04,1617490800.0
19491,76,0,2021-04-05,4290,612,887936,306950,2021-04-05,1617577200.0
19492,76,0,2021-04-06,22856,9335,910792,316285,2021-04-06,1617663600.0
19493,76,0,2021-04-07,25278,9315,936070,325600,2021-04-07,1617750000.0
19494,76,0,2021-04-08,33121,9559,969191,335159,2021-04-08,1617836400.0
19495,76,0,2021-04-09,38926,8866,1008117,344025,2021-04-09,1617922800.0
19496,76,0,2021-04-10,22706,4704,1030823,348729,2021-04-10,1618009200.0
19497,76,0,2021-04-11,8861,1255,1039684,349984,2021-04-11,1618095600.0
19498,76,0,2021-04-12,26052,9967,1065736,359951,2021-04-12,1618185600.0
19499,76,0,2021-04-13,35788,12084,1101524,372035,2021-04-13,1618272000.0
19500,76,0,2021-04-14,32878,12399,1134402,384434,2021-04-14,1618358400.0
19501,76,0,2021-04-15,37471,12844,1171873,397278,2021-04-15,1618444800.0
19502,76,0,2021-04-16,34455,12299,1206328,409577,2021-04-16,1618531200.0
19503,76,0,2021-04-17,21397,6202,1227725,415779,2021-04-17,1618617600.0
19504,76,0,2021-04-18,7712,2489,1235437,418268,2021-04-18,1618704000.0
19505,76,0,2021-04-19,22048,12402,1257485,430670,2021-04-19,1618790400.0
19506,76,0,2021-04-20,27973,15942,1285458,446612,2021-04-20,1618876800.0
19507,76,0,2021-04-21,27032,16202,1312490,462814,2021-04-21,1618963200.0
19508,76,0,2021-04-22,30351,17062,1342841,479876,2021-04-22,1619049600.0
19509,76,0,2021-04-23,28706,15453,1371547,495329,2021-04-23,1619136000.0
19510,76,0,2021-04-24,18490,9868,1390037,505197,2021-04-24,1619222400.0
19511,76,0,2021-04-25,6911,4005,1396948,509202,2021-04-25,1619308800.0
19512,76,0,2021-04-26,19942,17573,1416890,526775,2021-04-26,1619395200.0
19513,76,0,2021-04-27,26727,19786,1443617,546561,2021-04-27,1619481600.0
19514,76,0,2021-04-28,25890,19235,1469507,565796,2021-04-28,1619568000.0
19515,76,0,2021-04-29,29732,20658,1499239,586454,2021-04-29,1619654400.0
19516,76,0,2021-04-30,30775,17317,1530014,603771,2021-04-30,1619740800.0
19517,76,0,2021-05-01,17423,6264,1547437,610035,2021-05-01,1619827200.0
19518,76,0,2021-05-02,9491,4384,1556928,614419,2021-05-02,1619913600.0
19519,76,0,2021-05-03,26529,15248,1583457,629667,2021-05-03,1620000000.0
19520,76,0,2021-05-04,30007,23695,1613464,653362,2021-05-04,1620086400.0
19521,76,0,2021-05-05,28198,24661,1641662,678023,2021-05-05,1620172800.0
19522,76,0,2021-05-06,31034,28423,1672696,706446,2021-05-06,1620259200.0
19523,76,0,2021-05-07,31616,27776,1704312,734222,2021-05-07,1620345600.0
19524,76,0,2021-05-08,17356,9708,1721668,743930,2021-05-08,1620432000.0
19525,76,0,2021-05-09,9708,8231,1731376,752161,2021-05-09,1620518400.0
19526,76,0,2021-05-10,24079,26507,1755455,778668,2021-05-10,1620604800.0
19527,76,0,2021-05-11,31648,30050,1787103,808718,2021-05-11,1620691200.0
19528,76,0,2021-05-12,33335,26891,1820438,835609,2021-05-12,1620777600.0
19529,76,0,2021-05-13,25949,8637,1846387,844246,2021-05-13,1620864000.0
19530,76,0,2021-05-14,34540,19219,1880927,863465,2021-05-14,1620950400.0
19531,76,0,2021-05-15,24487,10931,1905414,874396,2021-05-15,1621036800.0
19532,76,0,2021-05-16,15453,3098,1920867,877494,2021-05-16,1621123200.0
19533,76,0,2021-05-17,27840,17329,1948707,894823,2021-05-17,1621206000.0
19534,76,0,2021-05-18,35420,16815,1984127,911638,2021-05-18,1621292400.0
19535,76,0,2021-05-19,36829,14408,2020956,926046,2021-05-19,1621378800.0
19536,76,0,2021-05-20,40993,15651,2061949,941697,2021-05-20,1621465200.0
19537,76,0,2021-05-21,37776,16763,2099725,958460,2021-05-21,1621551600.0
19538,76,0,2021-05-22,26988,7519,2126713,965979,2021-05-22,1621638000.0
19539,76,0,2021-05-23,13313,1103,2140026,967082,2021-05-23,1621724400.0
19540,76,0,2021-05-24,15416,3240,2155442,970322,2021-05-24,1621810800.0
19541,76,0,2021-05-25,31690,18225,2187132,988547,2021-05-25,1621897200.0
19542,76,0,2021-05-26,33555,16689,2220687,1005236,2021-05-26,1621983600.0
19543,76,0,2021-05-27,36327,21167,2257014,1026403,2021-05-27,1622070000.0
19544,76,0,2021-05-28,32461,24262,2289475,1050665,2021-05-28,1622156400.0
19545,76,0,2021-05-29,19606,14962,2309081,1065627,2021-05-29,1622242800.0
19546,76,0,2021-05-30,6255,5874,2315336,1071501,2021-05-30,1622329200.0
19547,76,0,2021-05-31,25731,20141,2341067,1091642,2021-05-31,1622415600.0
19548,76,0,2021-06-01,31171,25814,2372238,1117456,2021-06-01,1622502000.0
19549,76,0,2021-06-02,30760,24241,2402998,1141697,2021-06-02,1622588400.0
19550,76,0,2021-06-03,34174,28782,2437172,1170479,2021-06-03,1622674800.0
19551,76,0,2021-06-04,35072,30021,2472244,1200500,2021-06-04,1622761200.0
19552,76,0,2021-06-05,26015,17607,2498259,1218107,2021-06-05,1622847600.0
19553,76,0,2021-06-06,14088,5518,2512347,1223625,2021-06-06,1622934000.0
19554,76,0,2021-06-07,25729,25089,2538076,1248714,2021-06-07,1623020400.0
19555,76,0,2021-06-08,32405,27947,2570481,1276661,2021-06-08,1623106800.0
19556,76,0,2021-06-09,32266,25745,2602747,1302406,2021-06-09,1623193200.0
19557,76,0,2021-06-10,31941,25516,2634688,1327922,2021-06-10,1623279600.0
19558,76,0,2021-06-11,33531,32012,2668219,1359934,2021-06-11,1623366000.0
19559,76,0,2021-06-12,23188,19820,2691407,1379754,2021-06-12,1623452400.0
19560,76,0,2021-06-13,12033,6277,2703440,1386031,2021-06-13,1623538800.0
19561,76,0,2021-06-14,21553,31302,2724993,1417333,2021-06-14,1623625200.0
19562,76,0,2021-06-15,28714,36434,2753707,1453767,2021-06-15,1623711600.0
19563,76,0,2021-06-16,26993,33407,2780700,1487174,2021-06-16,1623798000.0
19564,76,0,2021-06-17,26762,30843,2807462,1518017,2021-06-17,1623884400.0
19565,76,0,2021-06-18,27395,37600,2834857,1555617,2021-06-18,1623970800.0
19566,76,0,2021-06-19,20790,21348,2855647,1576965,2021-06-19,1624057200.0
19567,76,0,2021-06-20,8908,9618,2864555,1586583,2021-06-20,1624143600.0
19568,76,0,2021-06-21,15031,33337,2879586,1619920,2021-06-21,1624230000.0
19569,76,0,2021-06-22,18221,38075,2897807,1657995,2021-06-22,1624316400.0
19570,76,0,2021-06-23,18950,35341,2916757,1693336,2021-06-23,1624402800.0
19571,76,0,2021-06-24,17439,32521,2934196,1725857,2021-06-24,1624489200.0
19572,76,0,2021-06-25,18302,41808,2952498,1767665,2021-06-25,1624575600.0
19573,76,0,2021-06-26,12241,27319,2964739,1794984,2021-06-26,1624662000.0
19574,76,0,2021-06-27,5712,13990,2970451,1808974,2021-06-27,1624748400.0
19575,76,0,2021-06-28,12561,36282,2983012,1845256,2021-06-28,1624834800.0
19576,76,0,2021-06-29,14838,41392,2997850,1886648,2021-06-29,1624921200.0
19577,76,0,2021-06-30,17012,40762,3014862,1927410,2021-06-30,1625007600.0
19578,76,0,2021-07-01,16362,37449,3031224,1964859,2021-07-01,1625094000.0
19579,76,0,2021-07-02,17721,41151,3048945,2006010,2021-07-02,1625180400.0
19580,76,0,2021-07-03,11883,30885,3060828,2036895,2021-07-03,1625266800.0
19581,76,0,2021-07-04,5500,12157,3066328,2049052,2021-07-04,1625353200.0
19582,76,0,2021-07-05,13693,31887,3080021,2080939,2021-07-05,1625439600.0
19583,76,0,2021-07-06,16730,40809,3096751,2121748,2021-07-06,1625526000.0
19584,84,0,2020-12-27,1,0,1,0,2020-12-27,1609023600.0
19585,84,0,2020-12-28,7,0,8,0,2020-12-28,1609110000.0
19586,84,0,2020-12-29,5,0,13,0,2020-12-29,1609196400.0
19587,84,0,2020-12-30,6,0,19,0,2020-12-30,1609282800.0
19588,84,0,2020-12-31,15,0,34,0,2020-12-31,1609369200.0
19589,84,0,2021-01-01,10,0,44,0,2021-01-01,1609455600.0
19590,84,0,2021-01-02,2,0,46,0,2021-01-02,1609542000.0
19591,84,0,2021-01-03,0,0,46,0,2021-01-03,1609628400.0
19592,84,0,2021-01-04,174,0,220,0,2021-01-04,1609714800.0
19593,84,0,2021-01-05,470,0,690,0,2021-01-05,1609801200.0
19594,84,0,2021-01-06,1135,0,1825,0,2021-01-06,1609887600.0
19595,84,0,2021-01-07,2888,0,4713,0,2021-01-07,1609974000.0
19596,84,0,2021-01-08,3082,0,7795,0,2021-01-08,1610060400.0
19597,84,0,2021-01-09,514,0,8309,0,2021-01-09,1610146800.0
19598,84,0,2021-01-10,161,0,8470,0,2021-01-10,1610233200.0
19599,84,0,2021-01-11,4298,0,12768,0,2021-01-11,1610319600.0
19600,84,0,2021-01-12,6365,0,19133,0,2021-01-12,1610406000.0
19601,84,0,2021-01-13,6845,0,25978,0,2021-01-13,1610492400.0
19602,84,0,2021-01-14,9074,0,35052,0,2021-01-14,1610578800.0
19603,84,0,2021-01-15,7762,0,42814,0,2021-01-15,1610665200.0
19604,84,0,2021-01-16,2953,2,45767,2,2021-01-16,1610751600.0
19605,84,0,2021-01-17,921,2,46688,4,2021-01-17,1610838000.0
19606,84,0,2021-01-18,8968,20,55656,24,2021-01-18,1610924400.0
19607,84,0,2021-01-19,15050,16,70706,40,2021-01-19,1611010800.0
19608,84,0,2021-01-20,15503,16,86209,56,2021-01-20,1611097200.0
19609,84,0,2021-01-21,14599,19,100808,75,2021-01-21,1611183600.0
19610,84,0,2021-01-22,12422,19,113230,94,2021-01-22,1611270000.0
19611,84,0,2021-01-23,4763,1,117993,95,2021-01-23,1611356400.0
19612,84,0,2021-01-24,810,0,118803,95,2021-01-24,1611442800.0
19613,84,0,2021-01-25,8769,136,127572,231,2021-01-25,1611529200.0
19614,84,0,2021-01-26,11904,294,139476,525,2021-01-26,1611615600.0
19615,84,0,2021-01-27,12088,588,151564,1113,2021-01-27,1611702000.0
19616,84,0,2021-01-28,13854,1502,165418,2615,2021-01-28,1611788400.0
19617,84,0,2021-01-29,10806,1287,176224,3902,2021-01-29,1611874800.0
19618,84,0,2021-01-30,4142,142,180366,4044,2021-01-30,1611961200.0
19619,84,0,2021-01-31,499,1,180865,4045,2021-01-31,1612047600.0
19620,84,0,2021-02-01,6553,1862,187418,5907,2021-02-01,1612134000.0
19621,84,0,2021-02-02,10608,3463,198026,9370,2021-02-02,1612220400.0
19622,84,0,2021-02-03,11531,3870,209557,13240,2021-02-03,1612306800.0
19623,84,0,2021-02-04,12572,5449,222129,18689,2021-02-04,1612393200.0
19624,84,0,2021-02-05,8620,4645,230749,23334,2021-02-05,1612479600.0
19625,84,0,2021-02-06,2657,931,233406,24265,2021-02-06,1612566000.0
19626,84,0,2021-02-07,452,435,233858,24700,2021-02-07,1612652400.0
19627,84,0,2021-02-08,6220,4916,240078,29616,2021-02-08,1612738800.0
19628,84,0,2021-02-09,9337,8137,249415,37753,2021-02-09,1612825200.0
19629,84,0,2021-02-10,9686,8478,259101,46231,2021-02-10,1612911600.0
19630,84,0,2021-02-11,10695,9688,269796,55919,2021-02-11,1612998000.0
19631,84,0,2021-02-12,9723,7761,279519,63680,2021-02-12,1613084400.0
19632,84,0,2021-02-13,3496,2288,283015,65968,2021-02-13,1613170800.0
19633,84,0,2021-02-14,623,445,283638,66413,2021-02-14,1613257200.0
19634,84,0,2021-02-15,4881,8224,288519,74637,2021-02-15,1613343600.0
19635,84,0,2021-02-16,6106,10637,294625,85274,2021-02-16,1613430000.0
19636,84,0,2021-02-17,6088,11449,300713,96723,2021-02-17,1613516400.0
19637,84,0,2021-02-18,7109,11583,307822,108306,2021-02-18,1613602800.0
19638,84,0,2021-02-19,6647,9179,314469,117485,2021-02-19,1613689200.0
19639,84,0,2021-02-20,1838,3236,316307,120721,2021-02-20,1613775600.0
19640,84,0,2021-02-21,180,504,316487,121225,2021-02-21,1613862000.0
19641,84,0,2021-02-22,4287,8737,320774,129962,2021-02-22,1613948400.0
19642,84,0,2021-02-23,7287,11233,328061,141195,2021-02-23,1614034800.0
19643,84,0,2021-02-24,7805,11834,335866,153029,2021-02-24,1614121200.0
19644,84,0,2021-02-25,12734,13392,348600,166421,2021-02-25,1614207600.0
19645,84,0,2021-02-26,14880,9984,363480,176405,2021-02-26,1614294000.0
19646,84,0,2021-02-27,5563,2812,369043,179217,2021-02-27,1614380400.0
19647,84,0,2021-02-28,501,498,369544,179715,2021-02-28,1614466800.0
19648,84,0,2021-03-01,9294,6266,378838,185981,2021-03-01,1614553200.0
19649,84,0,2021-03-02,14973,8477,393811,194458,2021-03-02,1614639600.0
19650,84,0,2021-03-03,14804,8319,408615,202777,2021-03-03,1614726000.0
19651,84,0,2021-03-04,21039,7919,429654,210696,2021-03-04,1614812400.0
19652,84,0,2021-03-05,25781,7066,455435,217762,2021-03-05,1614898800.0
19653,84,0,2021-03-06,19500,2080,474935,219842,2021-03-06,1614985200.0
19654,84,0,2021-03-07,8417,330,483352,220172,2021-03-07,1615071600.0
19655,84,0,2021-03-08,12215,6566,495567,226738,2021-03-08,1615158000.0
19656,84,0,2021-03-09,20686,7304,516253,234042,2021-03-09,1615244400.0
19657,84,0,2021-03-10,20241,7135,536494,241177,2021-03-10,1615330800.0
19658,84,0,2021-03-11,29483,7491,565977,248668,2021-03-11,1615417200.0
19659,84,0,2021-03-12,36192,6909,602169,255577,2021-03-12,1615503600.0
19660,84,0,2021-03-13,21438,1520,623607,257097,2021-03-13,1615590000.0
19661,84,0,2021-03-14,4688,392,628295,257489,2021-03-14,1615676400.0
19662,84,0,2021-03-15,18877,4363,647172,261852,2021-03-15,1615762800.0
19663,84,0,2021-03-16,17060,5712,664232,267564,2021-03-16,1615849200.0
19664,84,0,2021-03-17,17584,5996,681816,273560,2021-03-17,1615935600.0
19665,84,0,2021-03-18,21510,6255,703326,279815,2021-03-18,1616022000.0
19666,84,0,2021-03-19,29003,4734,732329,284549,2021-03-19,1616108400.0
19667,84,0,2021-03-20,14537,1047,746866,285596,2021-03-20,1616194800.0
19668,84,0,2021-03-21,3240,171,750106,285767,2021-03-21,1616281200.0
19669,84,0,2021-03-22,19738,4620,769844,290387,2021-03-22,1616367600.0
19670,84,0,2021-03-23,30804,5072,800648,295459,2021-03-23,1616454000.0
19671,84,0,2021-03-24,29976,4962,830624,300421,2021-03-24,1616540400.0
19672,84,0,2021-03-25,41566,5156,872190,305577,2021-03-25,1616626800.0
19673,84,0,2021-03-26,42982,5327,915172,310904,2021-03-26,1616713200.0
19674,84,0,2021-03-27,18220,2328,933392,313232,2021-03-27,1616799600.0
19675,84,0,2021-03-28,6509,375,939901,313607,2021-03-28,1616886000.0
19676,84,0,2021-03-29,22952,7146,962853,320753,2021-03-29,1616972400.0
19677,84,0,2021-03-30,34971,8918,997824,329671,2021-03-30,1617058800.0
19678,84,0,2021-03-31,29592,9773,1027416,339444,2021-03-31,1617145200.0
19679,84,0,2021-04-01,37281,9760,1064697,349204,2021-04-01,1617231600.0
19680,84,0,2021-04-02,34902,9808,1099599,359012,2021-04-02,1617318000.0
19681,84,0,2021-04-03,14800,5625,1114399,364637,2021-04-03,1617404400.0
19682,84,0,2021-04-04,9930,1539,1124329,366176,2021-04-04,1617490800.0
19683,84,0,2021-04-05,13537,1001,1137866,367177,2021-04-05,1617577200.0
19684,84,0,2021-04-06,26309,12043,1164175,379220,2021-04-06,1617663600.0
19685,84,0,2021-04-07,29503,13303,1193678,392523,2021-04-07,1617750000.0
19686,84,0,2021-04-08,39721,13487,1233399,406010,2021-04-08,1617836400.0
19687,84,0,2021-04-09,49504,12894,1282903,418904,2021-04-09,1617922800.0
19688,84,0,2021-04-10,20479,7192,1303382,426096,2021-04-10,1618009200.0
19689,84,0,2021-04-11,7232,2252,1310614,428348,2021-04-11,1618095600.0
19690,84,0,2021-04-12,27325,14246,1337939,442594,2021-04-12,1618185600.0
19691,84,0,2021-04-13,36156,17519,1374095,460113,2021-04-13,1618272000.0
19692,84,0,2021-04-14,34649,16418,1408744,476531,2021-04-14,1618358400.0
19693,84,0,2021-04-15,40130,17474,1448874,494005,2021-04-15,1618444800.0
19694,84,0,2021-04-16,38237,18066,1487111,512071,2021-04-16,1618531200.0
19695,84,0,2021-04-17,20473,7972,1507584,520043,2021-04-17,1618617600.0
19696,84,0,2021-04-18,6839,2376,1514423,522419,2021-04-18,1618704000.0
19697,84,0,2021-04-19,26234,17082,1540657,539501,2021-04-19,1618790400.0
19698,84,0,2021-04-20,31212,20649,1571869,560150,2021-04-20,1618876800.0
19699,84,0,2021-04-21,28052,19751,1599921,579901,2021-04-21,1618963200.0
19700,84,0,2021-04-22,32250,20537,1632171,600438,2021-04-22,1619049600.0
19701,84,0,2021-04-23,32706,20872,1664877,621310,2021-04-23,1619136000.0
19702,84,0,2021-04-24,17864,10735,1682741,632045,2021-04-24,1619222400.0
19703,84,0,2021-04-25,7136,3824,1689877,635869,2021-04-25,1619308800.0
19704,84,0,2021-04-26,23721,18299,1713598,654168,2021-04-26,1619395200.0
19705,84,0,2021-04-27,31769,22266,1745367,676434,2021-04-27,1619481600.0
19706,84,0,2021-04-28,32472,21639,1777839,698073,2021-04-28,1619568000.0
19707,84,0,2021-04-29,39643,22166,1817482,720239,2021-04-29,1619654400.0
19708,84,0,2021-04-30,38131,22555,1855613,742794,2021-04-30,1619740800.0
19709,84,0,2021-05-01,17174,4073,1872787,746867,2021-05-01,1619827200.0
19710,84,0,2021-05-02,7985,7989,1880772,754856,2021-05-02,1619913600.0
19711,84,0,2021-05-03,30376,24712,1911148,779568,2021-05-03,1620000000.0
19712,84,0,2021-05-04,37151,29879,1948299,809447,2021-05-04,1620086400.0
19713,84,0,2021-05-05,40248,26313,1988547,835760,2021-05-05,1620172800.0
19714,84,0,2021-05-06,46639,27561,2035186,863321,2021-05-06,1620259200.0
19715,84,0,2021-05-07,47064,30916,2082250,894237,2021-05-07,1620345600.0
19716,84,0,2021-05-08,22459,5896,2104709,900133,2021-05-08,1620432000.0
19717,84,0,2021-05-09,15923,7620,2120632,907753,2021-05-09,1620518400.0
19718,84,0,2021-05-10,36091,28384,2156723,936137,2021-05-10,1620604800.0
19719,84,0,2021-05-11,52642,30404,2209365,966541,2021-05-11,1620691200.0
19720,84,0,2021-05-12,56950,26550,2266315,993091,2021-05-12,1620777600.0
19721,84,0,2021-05-13,47429,6912,2313744,1000003,2021-05-13,1620864000.0
19722,84,0,2021-05-14,57516,19520,2371260,1019523,2021-05-14,1620950400.0
19723,84,0,2021-05-15,44357,10003,2415617,1029526,2021-05-15,1621036800.0
19724,84,0,2021-05-16,30625,2564,2446242,1032090,2021-05-16,1621123200.0
19725,84,0,2021-05-17,48471,20191,2494713,1052281,2021-05-17,1621206000.0
19726,84,0,2021-05-18,59409,21419,2554122,1073700,2021-05-18,1621292400.0
19727,84,0,2021-05-19,58664,17734,2612786,1091434,2021-05-19,1621378800.0
19728,84,0,2021-05-20,62006,20751,2674792,1112185,2021-05-20,1621465200.0
19729,84,0,2021-05-21,61305,22791,2736097,1134976,2021-05-21,1621551600.0
19730,84,0,2021-05-22,40639,9169,2776736,1144145,2021-05-22,1621638000.0
19731,84,0,2021-05-23,21510,2067,2798246,1146212,2021-05-23,1621724400.0
19732,84,0,2021-05-24,40141,4900,2838387,1151112,2021-05-24,1621810800.0
19733,84,0,2021-05-25,50567,26182,2888954,1177294,2021-05-25,1621897200.0
19734,84,0,2021-05-26,50187,23525,2939141,1200819,2021-05-26,1621983600.0
19735,84,0,2021-05-27,55882,25382,2995023,1226201,2021-05-27,1622070000.0
19736,84,0,2021-05-28,54984,32635,3050007,1258836,2021-05-28,1622156400.0
19737,84,0,2021-05-29,37730,18202,3087737,1277038,2021-05-29,1622242800.0
19738,84,0,2021-05-30,16151,5672,3103888,1282710,2021-05-30,1622329200.0
19739,84,0,2021-05-31,44401,23865,3148289,1306575,2021-05-31,1622415600.0
19740,84,0,2021-06-01,48482,29574,3196771,1336149,2021-06-01,1622502000.0
19741,84,0,2021-06-02,47888,24901,3244659,1361050,2021-06-02,1622588400.0
19742,84,0,2021-06-03,56175,28742,3300834,1389792,2021-06-03,1622674800.0
19743,84,0,2021-06-04,54766,34489,3355600,1424281,2021-06-04,1622761200.0
19744,84,0,2021-06-05,38140,17126,3393740,1441407,2021-06-05,1622847600.0
19745,84,0,2021-06-06,15932,4663,3409672,1446070,2021-06-06,1622934000.0
19746,84,0,2021-06-07,41374,29580,3451046,1475650,2021-06-07,1623020400.0
19747,84,0,2021-06-08,45094,31463,3496140,1507113,2021-06-08,1623106800.0
19748,84,0,2021-06-09,40616,28287,3536756,1535400,2021-06-09,1623193200.0
19749,84,0,2021-06-10,41311,27739,3578067,1563139,2021-06-10,1623279600.0
19750,84,0,2021-06-11,43319,39619,3621386,1602758,2021-06-11,1623366000.0
19751,84,0,2021-06-12,28129,19366,3649515,1622124,2021-06-12,1623452400.0
19752,84,0,2021-06-13,8608,6131,3658123,1628255,2021-06-13,1623538800.0
19753,84,0,2021-06-14,25520,40735,3683643,1668990,2021-06-14,1623625200.0
19754,84,0,2021-06-15,31595,44455,3715238,1713445,2021-06-15,1623711600.0
19755,84,0,2021-06-16,33289,40679,3748527,1754124,2021-06-16,1623798000.0
19756,84,0,2021-06-17,30477,42171,3779004,1796295,2021-06-17,1623884400.0
19757,84,0,2021-06-18,34866,54311,3813870,1850606,2021-06-18,1623970800.0
19758,84,0,2021-06-19,22754,32555,3836624,1883161,2021-06-19,1624057200.0
19759,84,0,2021-06-20,8675,13076,3845299,1896237,2021-06-20,1624143600.0
19760,84,0,2021-06-21,19933,52839,3865232,1949076,2021-06-21,1624230000.0
19761,84,0,2021-06-22,20993,58952,3886225,2008028,2021-06-22,1624316400.0
19762,84,0,2021-06-23,22253,53449,3908478,2061477,2021-06-23,1624402800.0
19763,84,0,2021-06-24,23126,50853,3931604,2112330,2021-06-24,1624489200.0
19764,84,0,2021-06-25,23523,65268,3955127,2177598,2021-06-25,1624575600.0
19765,84,0,2021-06-26,14034,43727,3969161,2221325,2021-06-26,1624662000.0
19766,84,0,2021-06-27,6844,22276,3976005,2243601,2021-06-27,1624748400.0
19767,84,0,2021-06-28,15640,61612,3991645,2305213,2021-06-28,1624834800.0
19768,84,0,2021-06-29,18782,63294,4010427,2368507,2021-06-29,1624921200.0
19769,84,0,2021-06-30,21485,58414,4031912,2426921,2021-06-30,1625007600.0
19770,84,0,2021-07-01,22490,53493,4054402,2480414,2021-07-01,1625094000.0
19771,84,0,2021-07-02,22451,63763,4076853,2544177,2021-07-02,1625180400.0
19772,84,0,2021-07-03,15517,41822,4092370,2585999,2021-07-03,1625266800.0
19773,84,0,2021-07-04,7703,15801,4100073,2601800,2021-07-04,1625353200.0
19774,84,0,2021-07-05,18543,58116,4118616,2659916,2021-07-05,1625439600.0
19775,84,0,2021-07-06,20572,57343,4139188,2717259,2021-07-06,1625526000.0
19776,93,0,2020-12-27,1,0,1,0,2020-12-27,1609023600.0
19777,93,0,2020-12-28,2,0,3,0,2020-12-28,1609110000.0
19778,93,0,2020-12-29,1,0,4,0,2020-12-29,1609196400.0
19779,93,0,2020-12-30,3,0,7,0,2020-12-30,1609282800.0
19780,93,0,2020-12-31,19,0,26,0,2020-12-31,1609369200.0
19781,93,0,2021-01-01,13,0,39,0,2021-01-01,1609455600.0
19782,93,0,2021-01-02,3,0,42,0,2021-01-02,1609542000.0
19783,93,0,2021-01-03,3,0,45,0,2021-01-03,1609628400.0
19784,93,0,2021-01-04,133,0,178,0,2021-01-04,1609714800.0
19785,93,0,2021-01-05,251,0,429,0,2021-01-05,1609801200.0
19786,93,0,2021-01-06,412,0,841,0,2021-01-06,1609887600.0
19787,93,0,2021-01-07,1245,0,2086,0,2021-01-07,1609974000.0
19788,93,0,2021-01-08,1566,0,3652,0,2021-01-08,1610060400.0
19789,93,0,2021-01-09,542,0,4194,0,2021-01-09,1610146800.0
19790,93,0,2021-01-10,74,0,4268,0,2021-01-10,1610233200.0
19791,93,0,2021-01-11,2414,0,6682,0,2021-01-11,1610319600.0
19792,93,0,2021-01-12,5094,0,11776,0,2021-01-12,1610406000.0
19793,93,0,2021-01-13,4473,0,16249,0,2021-01-13,1610492400.0
19794,93,0,2021-01-14,5582,0,21831,0,2021-01-14,1610578800.0
19795,93,0,2021-01-15,4940,0,26771,0,2021-01-15,1610665200.0
19796,93,0,2021-01-16,1681,2,28452,2,2021-01-16,1610751600.0
19797,93,0,2021-01-17,302,1,28754,3,2021-01-17,1610838000.0
19798,93,0,2021-01-18,7161,22,35915,25,2021-01-18,1610924400.0
19799,93,0,2021-01-19,13539,15,49454,40,2021-01-19,1611010800.0
19800,93,0,2021-01-20,12278,13,61732,53,2021-01-20,1611097200.0
19801,93,0,2021-01-21,12321,19,74053,72,2021-01-21,1611183600.0
19802,93,0,2021-01-22,10226,8,84279,80,2021-01-22,1611270000.0
19803,93,0,2021-01-23,3330,1,87609,81,2021-01-23,1611356400.0
19804,93,0,2021-01-24,537,0,88146,81,2021-01-24,1611442800.0
19805,93,0,2021-01-25,7261,17,95407,98,2021-01-25,1611529200.0
19806,93,0,2021-01-26,10081,114,105488,212,2021-01-26,1611615600.0
19807,93,0,2021-01-27,9695,267,115183,479,2021-01-27,1611702000.0
19808,93,0,2021-01-28,13678,776,128861,1255,2021-01-28,1611788400.0
19809,93,0,2021-01-29,9849,942,138710,2197,2021-01-29,1611874800.0
19810,93,0,2021-01-30,2240,151,140950,2348,2021-01-30,1611961200.0
19811,93,0,2021-01-31,304,5,141254,2353,2021-01-31,1612047600.0
19812,93,0,2021-02-01,5169,1505,146423,3858,2021-02-01,1612134000.0
19813,93,0,2021-02-02,6648,2356,153071,6214,2021-02-02,1612220400.0
19814,93,0,2021-02-03,5027,1803,158098,8017,2021-02-03,1612306800.0
19815,93,0,2021-02-04,5535,3150,163633,11167,2021-02-04,1612393200.0
19816,93,0,2021-02-05,6113,4107,169746,15274,2021-02-05,1612479600.0
19817,93,0,2021-02-06,1247,969,170993,16243,2021-02-06,1612566000.0
19818,93,0,2021-02-07,280,81,171273,16324,2021-02-07,1612652400.0
19819,93,0,2021-02-08,4309,3727,175582,20051,2021-02-08,1612738800.0
19820,93,0,2021-02-09,5890,7079,181472,27130,2021-02-09,1612825200.0
19821,93,0,2021-02-10,5958,5858,187430,32988,2021-02-10,1612911600.0
19822,93,0,2021-02-11,6603,6674,194033,39662,2021-02-11,1612998000.0
19823,93,0,2021-02-12,5729,6448,199762,46110,2021-02-12,1613084400.0
19824,93,0,2021-02-13,1128,1444,200890,47554,2021-02-13,1613170800.0
19825,93,0,2021-02-14,73,384,200963,47938,2021-02-14,1613257200.0
19826,93,0,2021-02-15,2415,5622,203378,53560,2021-02-15,1613343600.0
19827,93,0,2021-02-16,3194,7665,206572,61225,2021-02-16,1613430000.0
19828,93,0,2021-02-17,3605,8475,210177,69700,2021-02-17,1613516400.0
19829,93,0,2021-02-18,6006,11347,216183,81047,2021-02-18,1613602800.0
19830,93,0,2021-02-19,5648,8605,221831,89652,2021-02-19,1613689200.0
19831,93,0,2021-02-20,881,1790,222712,91442,2021-02-20,1613775600.0
19832,93,0,2021-02-21,70,416,222782,91858,2021-02-21,1613862000.0
19833,93,0,2021-02-22,3030,6967,225812,98825,2021-02-22,1613948400.0
19834,93,0,2021-02-23,3967,7204,229779,106029,2021-02-23,1614034800.0
19835,93,0,2021-02-24,4749,6765,234528,112794,2021-02-24,1614121200.0
19836,93,0,2021-02-25,8258,6542,242786,119336,2021-02-25,1614207600.0
19837,93,0,2021-02-26,8281,6084,251067,125420,2021-02-26,1614294000.0
19838,93,0,2021-02-27,3295,1453,254362,126873,2021-02-27,1614380400.0
19839,93,0,2021-02-28,306,236,254668,127109,2021-02-28,1614466800.0
19840,93,0,2021-03-01,5659,4426,260327,131535,2021-03-01,1614553200.0
19841,93,0,2021-03-02,7241,5833,267568,137368,2021-03-02,1614639600.0
19842,93,0,2021-03-03,8991,6409,276559,143777,2021-03-03,1614726000.0
19843,93,0,2021-03-04,12092,6281,288651,150058,2021-03-04,1614812400.0
19844,93,0,2021-03-05,12211,5964,300862,156022,2021-03-05,1614898800.0
19845,93,0,2021-03-06,22947,1099,323809,157121,2021-03-06,1614985200.0
19846,93,0,2021-03-07,18023,434,341832,157555,2021-03-07,1615071600.0
19847,93,0,2021-03-08,10255,5125,352087,162680,2021-03-08,1615158000.0
19848,93,0,2021-03-09,13970,5374,366057,168054,2021-03-09,1615244400.0
19849,93,0,2021-03-10,14500,5116,380557,173170,2021-03-10,1615330800.0
19850,93,0,2021-03-11,20426,5845,400983,179015,2021-03-11,1615417200.0
19851,93,0,2021-03-12,21937,4970,422920,183985,2021-03-12,1615503600.0
19852,93,0,2021-03-13,24626,1010,447546,184995,2021-03-13,1615590000.0
19853,93,0,2021-03-14,6477,204,454023,185199,2021-03-14,1615676400.0
19854,93,0,2021-03-15,15952,2892,469975,188091,2021-03-15,1615762800.0
19855,93,0,2021-03-16,12726,3481,482701,191572,2021-03-16,1615849200.0
19856,93,0,2021-03-17,16000,4446,498701,196018,2021-03-17,1615935600.0
19857,93,0,2021-03-18,17048,4573,515749,200591,2021-03-18,1616022000.0
19858,93,0,2021-03-19,21034,4325,536783,204916,2021-03-19,1616108400.0
19859,93,0,2021-03-20,10992,1149,547775,206065,2021-03-20,1616194800.0
19860,93,0,2021-03-21,3258,81,551033,206146,2021-03-21,1616281200.0
19861,93,0,2021-03-22,17111,3245,568144,209391,2021-03-22,1616367600.0
19862,93,0,2021-03-23,22678,3480,590822,212871,2021-03-23,1616454000.0
19863,93,0,2021-03-24,21988,6191,612810,219062,2021-03-24,1616540400.0
19864,93,0,2021-03-25,29047,5964,641857,225026,2021-03-25,1616626800.0
19865,93,0,2021-03-26,29933,4479,671790,229505,2021-03-26,1616713200.0
19866,93,0,2021-03-27,12461,1384,684251,230889,2021-03-27,1616799600.0
19867,93,0,2021-03-28,3578,49,687829,230938,2021-03-28,1616886000.0
19868,93,0,2021-03-29,18541,4930,706370,235868,2021-03-29,1616972400.0
19869,93,0,2021-03-30,28532,5985,734902,241853,2021-03-30,1617058800.0
19870,93,0,2021-03-31,28810,5980,763712,247833,2021-03-31,1617145200.0
19871,93,0,2021-04-01,30783,6641,794495,254474,2021-04-01,1617231600.0
19872,93,0,2021-04-02,26949,7738,821444,262212,2021-04-02,1617318000.0
19873,93,0,2021-04-03,9779,4746,831223,266958,2021-04-03,1617404400.0
19874,93,0,2021-04-04,2123,1206,833346,268164,2021-04-04,1617490800.0
19875,93,0,2021-04-05,6067,1331,839413,269495,2021-04-05,1617577200.0
19876,93,0,2021-04-06,23453,9352,862866,278847,2021-04-06,1617663600.0
19877,93,0,2021-04-07,26092,10953,888958,289800,2021-04-07,1617750000.0
19878,93,0,2021-04-08,28886,13933,917844,303733,2021-04-08,1617836400.0
19879,93,0,2021-04-09,33679,13500,951523,317233,2021-04-09,1617922800.0
19880,93,0,2021-04-10,14839,7674,966362,324907,2021-04-10,1618009200.0
19881,93,0,2021-04-11,3637,2864,969999,327771,2021-04-11,1618095600.0
19882,93,0,2021-04-12,20622,11525,990621,339296,2021-04-12,1618185600.0
19883,93,0,2021-04-13,25638,14346,1016259,353642,2021-04-13,1618272000.0
19884,93,0,2021-04-14,25222,14339,1041481,367981,2021-04-14,1618358400.0
19885,93,0,2021-04-15,27030,14625,1068511,382606,2021-04-15,1618444800.0
19886,93,0,2021-04-16,27941,15449,1096452,398055,2021-04-16,1618531200.0
19887,93,0,2021-04-17,12850,7279,1109302,405334,2021-04-17,1618617600.0
19888,93,0,2021-04-18,5264,2737,1114566,408071,2021-04-18,1618704000.0
19889,93,0,2021-04-19,19108,15176,1133674,423247,2021-04-19,1618790400.0
19890,93,0,2021-04-20,21369,17717,1155043,440964,2021-04-20,1618876800.0
19891,93,0,2021-04-21,23960,17350,1179003,458314,2021-04-21,1618963200.0
19892,93,0,2021-04-22,25897,18160,1204900,476474,2021-04-22,1619049600.0
19893,93,0,2021-04-23,25471,17049,1230371,493523,2021-04-23,1619136000.0
19894,93,0,2021-04-24,11556,8134,1241927,501657,2021-04-24,1619222400.0
19895,93,0,2021-04-25,3210,2032,1245137,503689,2021-04-25,1619308800.0
19896,93,0,2021-04-26,16477,15013,1261614,518702,2021-04-26,1619395200.0
19897,93,0,2021-04-27,19470,18636,1281084,537338,2021-04-27,1619481600.0
19898,93,0,2021-04-28,21513,18404,1302597,555742,2021-04-28,1619568000.0
19899,93,0,2021-04-29,27926,19258,1330523,575000,2021-04-29,1619654400.0
19900,93,0,2021-04-30,27344,17918,1357867,592918,2021-04-30,1619740800.0
19901,93,0,2021-05-01,11760,4618,1369627,597536,2021-05-01,1619827200.0
19902,93,0,2021-05-02,4074,1647,1373701,599183,2021-05-02,1619913600.0
19903,93,0,2021-05-03,20543,16667,1394244,615850,2021-05-03,1620000000.0
19904,93,0,2021-05-04,20829,21090,1415073,636940,2021-05-04,1620086400.0
19905,93,0,2021-05-05,19566,19991,1434639,656931,2021-05-05,1620172800.0
19906,93,0,2021-05-06,24863,19444,1459502,676375,2021-05-06,1620259200.0
19907,93,0,2021-05-07,22460,22441,1481962,698816,2021-05-07,1620345600.0
19908,93,0,2021-05-08,13690,6054,1495652,704870,2021-05-08,1620432000.0
19909,93,0,2021-05-09,3473,2127,1499125,706997,2021-05-09,1620518400.0
19910,93,0,2021-05-10,18706,20865,1517831,727862,2021-05-10,1620604800.0
19911,93,0,2021-05-11,25431,22969,1543262,750831,2021-05-11,1620691200.0
19912,93,0,2021-05-12,32650,19943,1575912,770774,2021-05-12,1620777600.0
19913,93,0,2021-05-13,28334,6336,1604246,777110,2021-05-13,1620864000.0
19914,93,0,2021-05-14,35516,13539,1639762,790649,2021-05-14,1620950400.0
19915,93,0,2021-05-15,29909,8085,1669671,798734,2021-05-15,1621036800.0
19916,93,0,2021-05-16,12793,1729,1682464,800463,2021-05-16,1621123200.0
19917,93,0,2021-05-17,25869,15130,1708333,815593,2021-05-17,1621206000.0
19918,93,0,2021-05-18,30605,13855,1738938,829448,2021-05-18,1621292400.0
19919,93,0,2021-05-19,30471,12453,1769409,841901,2021-05-19,1621378800.0
19920,93,0,2021-05-20,33134,13587,1802543,855488,2021-05-20,1621465200.0
19921,93,0,2021-05-21,34246,14492,1836789,869980,2021-05-21,1621551600.0
19922,93,0,2021-05-22,18860,5986,1855649,875966,2021-05-22,1621638000.0
19923,93,0,2021-05-23,5930,1593,1861579,877559,2021-05-23,1621724400.0
19924,93,0,2021-05-24,17909,3503,1879488,881062,2021-05-24,1621810800.0
19925,93,0,2021-05-25,23803,17841,1903291,898903,2021-05-25,1621897200.0
19926,93,0,2021-05-26,24933,19154,1928224,918057,2021-05-26,1621983600.0
19927,93,0,2021-05-27,26633,19967,1954857,938024,2021-05-27,1622070000.0
19928,93,0,2021-05-28,23029,23144,1977886,961168,2021-05-28,1622156400.0
19929,93,0,2021-05-29,13175,12638,1991061,973806,2021-05-29,1622242800.0
19930,93,0,2021-05-30,2600,2931,1993661,976737,2021-05-30,1622329200.0
19931,93,0,2021-05-31,20962,18727,2014623,995464,2021-05-31,1622415600.0
19932,93,0,2021-06-01,24580,22401,2039203,1017865,2021-06-01,1622502000.0
19933,93,0,2021-06-02,22325,22828,2061528,1040693,2021-06-02,1622588400.0
19934,93,0,2021-06-03,27734,23125,2089262,1063818,2021-06-03,1622674800.0
19935,93,0,2021-06-04,28043,24000,2117305,1087818,2021-06-04,1622761200.0
19936,93,0,2021-06-05,16385,12244,2133690,1100062,2021-06-05,1622847600.0
19937,93,0,2021-06-06,4898,2344,2138588,1102406,2021-06-06,1622934000.0
19938,93,0,2021-06-07,17725,21741,2156313,1124147,2021-06-07,1623020400.0
19939,93,0,2021-06-08,21071,20977,2177384,1145124,2021-06-08,1623106800.0
19940,93,0,2021-06-09,20705,22522,2198089,1167646,2021-06-09,1623193200.0
19941,93,0,2021-06-10,21694,21287,2219783,1188933,2021-06-10,1623279600.0
19942,93,0,2021-06-11,19779,27308,2239562,1216241,2021-06-11,1623366000.0
19943,93,0,2021-06-12,12983,13426,2252545,1229667,2021-06-12,1623452400.0
19944,93,0,2021-06-13,2554,3003,2255099,1232670,2021-06-13,1623538800.0
19945,93,0,2021-06-14,13536,27230,2268635,1259900,2021-06-14,1623625200.0
19946,93,0,2021-06-15,16517,28095,2285152,1287995,2021-06-15,1623711600.0
19947,93,0,2021-06-16,17092,23016,2302244,1311011,2021-06-16,1623798000.0
19948,93,0,2021-06-17,17143,25254,2319387,1336265,2021-06-17,1623884400.0
19949,93,0,2021-06-18,16240,24910,2335627,1361175,2021-06-18,1623970800.0
19950,93,0,2021-06-19,9687,13979,2345314,1375154,2021-06-19,1624057200.0
19951,93,0,2021-06-20,2390,3387,2347704,1378541,2021-06-20,1624143600.0
19952,93,0,2021-06-21,9923,28683,2357627,1407224,2021-06-21,1624230000.0
19953,93,0,2021-06-22,11538,32130,2369165,1439354,2021-06-22,1624316400.0
19954,93,0,2021-06-23,11459,30033,2380624,1469387,2021-06-23,1624402800.0
19955,93,0,2021-06-24,12191,31504,2392815,1500891,2021-06-24,1624489200.0
19956,93,0,2021-06-25,11418,35230,2404233,1536121,2021-06-25,1624575600.0
19957,93,0,2021-06-26,6688,20404,2410921,1556525,2021-06-26,1624662000.0
19958,93,0,2021-06-27,1993,5474,2412914,1561999,2021-06-27,1624748400.0
19959,93,0,2021-06-28,8226,30900,2421140,1592899,2021-06-28,1624834800.0
19960,93,0,2021-06-29,9915,31646,2431055,1624545,2021-06-29,1624921200.0
19961,93,0,2021-06-30,10633,30930,2441688,1655475,2021-06-30,1625007600.0
19962,93,0,2021-07-01,12470,28267,2454158,1683742,2021-07-01,1625094000.0
19963,93,0,2021-07-02,12543,30829,2466701,1714571,2021-07-02,1625180400.0
19964,93,0,2021-07-03,7370,20481,2474071,1735052,2021-07-03,1625266800.0
19965,93,0,2021-07-04,1843,4220,2475914,1739272,2021-07-04,1625353200.0
19966,93,0,2021-07-05,9363,26394,2485277,1765666,2021-07-05,1625439600.0
19967,93,0,2021-07-06,11950,26921,2497227,1792587,2021-07-06,1625526000.0
19968,94,0,2020-12-27,0,0,0,0,2020-12-27,1609023600.0
19969,94,0,2020-12-28,0,0,0,0,2020-12-28,1609110000.0
19970,94,0,2020-12-29,0,0,0,0,2020-12-29,1609196400.0
19971,94,0,2020-12-30,0,0,0,0,2020-12-30,1609282800.0
19972,94,0,2020-12-31,0,0,0,0,2020-12-31,1609369200.0
19973,94,0,2021-01-01,0,0,0,0,2021-01-01,1609455600.0
19974,94,0,2021-01-02,0,0,0,0,2021-01-02,1609542000.0
19975,94,0,2021-01-03,0,0,0,0,2021-01-03,1609628400.0
19976,94,0,2021-01-04,2,0,2,0,2021-01-04,1609714800.0
19977,94,0,2021-01-05,0,0,2,0,2021-01-05,1609801200.0
19978,94,0,2021-01-06,53,0,55,0,2021-01-06,1609887600.0
19979,94,0,2021-01-07,333,0,388,0,2021-01-07,1609974000.0
19980,94,0,2021-01-08,310,0,698,0,2021-01-08,1610060400.0
19981,94,0,2021-01-09,78,0,776,0,2021-01-09,1610146800.0
19982,94,0,2021-01-10,34,0,810,0,2021-01-10,1610233200.0
19983,94,0,2021-01-11,151,0,961,0,2021-01-11,1610319600.0
19984,94,0,2021-01-12,209,0,1170,0,2021-01-12,1610406000.0
19985,94,0,2021-01-13,203,0,1373,0,2021-01-13,1610492400.0
19986,94,0,2021-01-14,264,0,1637,0,2021-01-14,1610578800.0
19987,94,0,2021-01-15,406,0,2043,0,2021-01-15,1610665200.0
19988,94,0,2021-01-16,200,1,2243,1,2021-01-16,1610751600.0
19989,94,0,2021-01-17,91,1,2334,2,2021-01-17,1610838000.0
19990,94,0,2021-01-18,471,2,2805,4,2021-01-18,1610924400.0
19991,94,0,2021-01-19,982,0,3787,4,2021-01-19,1611010800.0
19992,94,0,2021-01-20,812,0,4599,4,2021-01-20,1611097200.0
19993,94,0,2021-01-21,808,1,5407,5,2021-01-21,1611183600.0
19994,94,0,2021-01-22,728,0,6135,5,2021-01-22,1611270000.0
19995,94,0,2021-01-23,243,0,6378,5,2021-01-23,1611356400.0
19996,94,0,2021-01-24,147,0,6525,5,2021-01-24,1611442800.0
19997,94,0,2021-01-25,422,2,6947,7,2021-01-25,1611529200.0
19998,94,0,2021-01-26,790,7,7737,14,2021-01-26,1611615600.0
19999,94,0,2021-01-27,663,55,8400,69,2021-01-27,1611702000.0
20000,94,0,2021-01-28,699,230,9099,299,2021-01-28,1611788400.0
20001,94,0,2021-01-29,627,229,9726,528,2021-01-29,1611874800.0
20002,94,0,2021-01-30,204,74,9930,602,2021-01-30,1611961200.0
20003,94,0,2021-01-31,150,11,10080,613,2021-01-31,1612047600.0
20004,94,0,2021-02-01,458,147,10538,760,2021-02-01,1612134000.0
20005,94,0,2021-02-02,643,195,11181,955,2021-02-02,1612220400.0
20006,94,0,2021-02-03,783,166,11964,1121,2021-02-03,1612306800.0
20007,94,0,2021-02-04,714,298,12678,1419,2021-02-04,1612393200.0
20008,94,0,2021-02-05,659,201,13337,1620,2021-02-05,1612479600.0
20009,94,0,2021-02-06,207,75,13544,1695,2021-02-06,1612566000.0
20010,94,0,2021-02-07,126,58,13670,1753,2021-02-07,1612652400.0
20011,94,0,2021-02-08,322,366,13992,2119,2021-02-08,1612738800.0
20012,94,0,2021-02-09,712,612,14704,2731,2021-02-09,1612825200.0
20013,94,0,2021-02-10,643,429,15347,3160,2021-02-10,1612911600.0
20014,94,0,2021-02-11,678,496,16025,3656,2021-02-11,1612998000.0
20015,94,0,2021-02-12,641,428,16666,4084,2021-02-12,1613084400.0
20016,94,0,2021-02-13,301,72,16967,4156,2021-02-13,1613170800.0
20017,94,0,2021-02-14,195,78,17162,4234,2021-02-14,1613257200.0
20018,94,0,2021-02-15,380,308,17542,4542,2021-02-15,1613343600.0
20019,94,0,2021-02-16,634,602,18176,5144,2021-02-16,1613430000.0
20020,94,0,2021-02-17,592,482,18768,5626,2021-02-17,1613516400.0
20021,94,0,2021-02-18,550,544,19318,6170,2021-02-18,1613602800.0
20022,94,0,2021-02-19,309,609,19627,6779,2021-02-19,1613689200.0
20023,94,0,2021-02-20,275,199,19902,6978,2021-02-20,1613775600.0
20024,94,0,2021-02-21,84,84,19986,7062,2021-02-21,1613862000.0
20025,94,0,2021-02-22,211,404,20197,7466,2021-02-22,1613948400.0
20026,94,0,2021-02-23,352,646,20549,8112,2021-02-23,1614034800.0
20027,94,0,2021-02-24,299,608,20848,8720,2021-02-24,1614121200.0
20028,94,0,2021-02-25,348,605,21196,9325,2021-02-25,1614207600.0
20029,94,0,2021-02-26,420,554,21616,9879,2021-02-26,1614294000.0
20030,94,0,2021-02-27,368,151,21984,10030,2021-02-27,1614380400.0
20031,94,0,2021-02-28,70,123,22054,10153,2021-02-28,1614466800.0
20032,94,0,2021-03-01,361,410,22415,10563,2021-03-01,1614553200.0
20033,94,0,2021-03-02,549,651,22964,11214,2021-03-02,1614639600.0
20034,94,0,2021-03-03,532,687,23496,11901,2021-03-03,1614726000.0
20035,94,0,2021-03-04,952,626,24448,12527,2021-03-04,1614812400.0
20036,94,0,2021-03-05,1584,663,26032,13190,2021-03-05,1614898800.0
20037,94,0,2021-03-06,1843,159,27875,13349,2021-03-06,1614985200.0
20038,94,0,2021-03-07,1381,97,29256,13446,2021-03-07,1615071600.0
20039,94,0,2021-03-08,1228,318,30484,13764,2021-03-08,1615158000.0
20040,94,0,2021-03-09,1313,649,31797,14413,2021-03-09,1615244400.0
20041,94,0,2021-03-10,1259,566,33056,14979,2021-03-10,1615330800.0
20042,94,0,2021-03-11,1307,623,34363,15602,2021-03-11,1615417200.0
20043,94,0,2021-03-12,1517,529,35880,16131,2021-03-12,1615503600.0
20044,94,0,2021-03-13,1118,296,36998,16427,2021-03-13,1615590000.0
20045,94,0,2021-03-14,537,183,37535,16610,2021-03-14,1615676400.0
20046,94,0,2021-03-15,886,392,38421,17002,2021-03-15,1615762800.0
20047,94,0,2021-03-16,1065,629,39486,17631,2021-03-16,1615849200.0
20048,94,0,2021-03-17,1225,516,40711,18147,2021-03-17,1615935600.0
20049,94,0,2021-03-18,995,522,41706,18669,2021-03-18,1616022000.0
20050,94,0,2021-03-19,1286,326,42992,18995,2021-03-19,1616108400.0
20051,94,0,2021-03-20,1732,283,44724,19278,2021-03-20,1616194800.0
20052,94,0,2021-03-21,1126,74,45850,19352,2021-03-21,1616281200.0
20053,94,0,2021-03-22,889,181,46739,19533,2021-03-22,1616367600.0
20054,94,0,2021-03-23,1302,310,48041,19843,2021-03-23,1616454000.0
20055,94,0,2021-03-24,1688,292,49729,20135,2021-03-24,1616540400.0
20056,94,0,2021-03-25,1753,263,51482,20398,2021-03-25,1616626800.0
20057,94,0,2021-03-26,2031,321,53513,20719,2021-03-26,1616713200.0
20058,94,0,2021-03-27,2273,206,55786,20925,2021-03-27,1616799600.0
20059,94,0,2021-03-28,1070,208,56856,21133,2021-03-28,1616886000.0
20060,94,0,2021-03-29,1025,295,57881,21428,2021-03-29,1616972400.0
20061,94,0,2021-03-30,1352,543,59233,21971,2021-03-30,1617058800.0
20062,94,0,2021-03-31,1427,465,60660,22436,2021-03-31,1617145200.0
20063,94,0,2021-04-01,1638,661,62298,23097,2021-04-01,1617231600.0
20064,94,0,2021-04-02,1863,1172,64161,24269,2021-04-02,1617318000.0
20065,94,0,2021-04-03,1890,1109,66051,25378,2021-04-03,1617404400.0
20066,94,0,2021-04-04,771,833,66822,26211,2021-04-04,1617490800.0
20067,94,0,2021-04-05,629,797,67451,27008,2021-04-05,1617577200.0
20068,94,0,2021-04-06,1579,876,69030,27884,2021-04-06,1617663600.0
20069,94,0,2021-04-07,2010,827,71040,28711,2021-04-07,1617750000.0
20070,94,0,2021-04-08,2174,723,73214,29434,2021-04-08,1617836400.0
20071,94,0,2021-04-09,2100,900,75314,30334,2021-04-09,1617922800.0
20072,94,0,2021-04-10,2402,580,77716,30914,2021-04-10,1618009200.0
20073,94,0,2021-04-11,1173,297,78889,31211,2021-04-11,1618095600.0
20074,94,0,2021-04-12,1517,871,80406,32082,2021-04-12,1618185600.0
20075,94,0,2021-04-13,1384,985,81790,33067,2021-04-13,1618272000.0
20076,94,0,2021-04-14,2088,1045,83878,34112,2021-04-14,1618358400.0
20077,94,0,2021-04-15,1922,990,85800,35102,2021-04-15,1618444800.0
20078,94,0,2021-04-16,1777,992,87577,36094,2021-04-16,1618531200.0
20079,94,0,2021-04-17,1750,1344,89327,37438,2021-04-17,1618617600.0
20080,94,0,2021-04-18,1234,1268,90561,38706,2021-04-18,1618704000.0
20081,94,0,2021-04-19,1091,744,91652,39450,2021-04-19,1618790400.0
20082,94,0,2021-04-20,1249,1150,92901,40600,2021-04-20,1618876800.0
20083,94,0,2021-04-21,1781,1293,94682,41893,2021-04-21,1618963200.0
20084,94,0,2021-04-22,1832,1339,96514,43232,2021-04-22,1619049600.0
20085,94,0,2021-04-23,1647,1361,98161,44593,2021-04-23,1619136000.0
20086,94,0,2021-04-24,2030,1709,100191,46302,2021-04-24,1619222400.0
20087,94,0,2021-04-25,1261,759,101452,47061,2021-04-25,1619308800.0
20088,94,0,2021-04-26,1015,1120,102467,48181,2021-04-26,1619395200.0
20089,94,0,2021-04-27,1308,1186,103775,49367,2021-04-27,1619481600.0
20090,94,0,2021-04-28,2588,1199,106363,50566,2021-04-28,1619568000.0
20091,94,0,2021-04-29,1969,1142,108332,51708,2021-04-29,1619654400.0
20092,94,0,2021-04-30,2262,1776,110594,53484,2021-04-30,1619740800.0
20093,94,0,2021-05-01,1423,1658,112017,55142,2021-05-01,1619827200.0
20094,94,0,2021-05-02,1009,923,113026,56065,2021-05-02,1619913600.0
20095,94,0,2021-05-03,1600,1017,114626,57082,2021-05-03,1620000000.0
20096,94,0,2021-05-04,1557,1622,116183,58704,2021-05-04,1620086400.0
20097,94,0,2021-05-05,1810,2275,117993,60979,2021-05-05,1620172800.0
20098,94,0,2021-05-06,2187,1741,120180,62720,2021-05-06,1620259200.0
20099,94,0,2021-05-07,2212,1728,122392,64448,2021-05-07,1620345600.0
20100,94,0,2021-05-08,873,1331,123265,65779,2021-05-08,1620432000.0
20101,94,0,2021-05-09,1175,1289,124440,67068,2021-05-09,1620518400.0
20102,94,0,2021-05-10,1373,1480,125813,68548,2021-05-10,1620604800.0
20103,94,0,2021-05-11,1581,1482,127394,70030,2021-05-11,1620691200.0
20104,94,0,2021-05-12,1770,1298,129164,71328,2021-05-12,1620777600.0
20105,94,0,2021-05-13,1940,436,131104,71764,2021-05-13,1620864000.0
20106,94,0,2021-05-14,1513,1172,132617,72936,2021-05-14,1620950400.0
20107,94,0,2021-05-15,1479,945,134096,73881,2021-05-15,1621036800.0
20108,94,0,2021-05-16,1032,624,135128,74505,2021-05-16,1621123200.0
20109,94,0,2021-05-17,1581,912,136709,75417,2021-05-17,1621206000.0
20110,94,0,2021-05-18,1602,784,138311,76201,2021-05-18,1621292400.0
20111,94,0,2021-05-19,1551,835,139862,77036,2021-05-19,1621378800.0
20112,94,0,2021-05-20,1355,829,141217,77865,2021-05-20,1621465200.0
20113,94,0,2021-05-21,1236,902,142453,78767,2021-05-21,1621551600.0
20114,94,0,2021-05-22,1015,638,143468,79405,2021-05-22,1621638000.0
20115,94,0,2021-05-23,696,306,144164,79711,2021-05-23,1621724400.0
20116,94,0,2021-05-24,165,127,144329,79838,2021-05-24,1621810800.0
20117,94,0,2021-05-25,962,777,145291,80615,2021-05-25,1621897200.0
20118,94,0,2021-05-26,954,1890,146245,82505,2021-05-26,1621983600.0
20119,94,0,2021-05-27,836,2187,147081,84692,2021-05-27,1622070000.0
20120,94,0,2021-05-28,838,1745,147919,86437,2021-05-28,1622156400.0
20121,94,0,2021-05-29,646,1213,148565,87650,2021-05-29,1622242800.0
20122,94,0,2021-05-30,226,540,148791,88190,2021-05-30,1622329200.0
20123,94,0,2021-05-31,560,1202,149351,89392,2021-05-31,1622415600.0
20124,94,0,2021-06-01,737,1692,150088,91084,2021-06-01,1622502000.0
20125,94,0,2021-06-02,628,1866,150716,92950,2021-06-02,1622588400.0
20126,94,0,2021-06-03,787,1595,151503,94545,2021-06-03,1622674800.0
20127,94,0,2021-06-04,609,2290,152112,96835,2021-06-04,1622761200.0
20128,94,0,2021-06-05,564,1865,152676,98700,2021-06-05,1622847600.0
20129,94,0,2021-06-06,220,1025,152896,99725,2021-06-06,1622934000.0
20130,94,0,2021-06-07,438,1556,153334,101281,2021-06-07,1623020400.0
20131,94,0,2021-06-08,696,1804,154030,103085,2021-06-08,1623106800.0
20132,94,0,2021-06-09,796,2410,154826,105495,2021-06-09,1623193200.0
20133,94,0,2021-06-10,671,1705,155497,107200,2021-06-10,1623279600.0
20134,94,0,2021-06-11,691,2213,156188,109413,2021-06-11,1623366000.0
20135,94,0,2021-06-12,354,1150,156542,110563,2021-06-12,1623452400.0
20136,94,0,2021-06-13,204,838,156746,111401,2021-06-13,1623538800.0
20137,94,0,2021-06-14,421,1986,157167,113387,2021-06-14,1623625200.0
20138,94,0,2021-06-15,546,1641,157713,115028,2021-06-15,1623711600.0
20139,94,0,2021-06-16,577,1628,158290,116656,2021-06-16,1623798000.0
20140,94,0,2021-06-17,612,1557,158902,118213,2021-06-17,1623884400.0
20141,94,0,2021-06-18,575,1814,159477,120027,2021-06-18,1623970800.0
20142,94,0,2021-06-19,342,976,159819,121003,2021-06-19,1624057200.0
20143,94,0,2021-06-20,188,870,160007,121873,2021-06-20,1624143600.0
20144,94,0,2021-06-21,435,1715,160442,123588,2021-06-21,1624230000.0
20145,94,0,2021-06-22,542,1897,160984,125485,2021-06-22,1624316400.0
20146,94,0,2021-06-23,401,1395,161385,126880,2021-06-23,1624402800.0
20147,94,0,2021-06-24,463,1077,161848,127957,2021-06-24,1624489200.0
20148,94,0,2021-06-25,368,1486,162216,129443,2021-06-25,1624575600.0
20149,94,0,2021-06-26,300,1381,162516,130824,2021-06-26,1624662000.0
20150,94,0,2021-06-27,201,984,162717,131808,2021-06-27,1624748400.0
20151,94,0,2021-06-28,511,1588,163228,133396,2021-06-28,1624834800.0
20152,94,0,2021-06-29,471,1617,163699,135013,2021-06-29,1624921200.0
20153,94,0,2021-06-30,604,1358,164303,136371,2021-06-30,1625007600.0
20154,94,0,2021-07-01,410,916,164713,137287,2021-07-01,1625094000.0
20155,94,0,2021-07-02,359,847,165072,138134,2021-07-02,1625180400.0
20156,94,0,2021-07-03,289,965,165361,139099,2021-07-03,1625266800.0
20157,94,0,2021-07-04,168,656,165529,139755,2021-07-04,1625353200.0
20158,94,0,2021-07-05,414,845,165943,140600,2021-07-05,1625439600.0
20159,94,0,2021-07-06,689,988,166632,141588,2021-07-06,1625526000.0
